Cannot open file
Attempt to begin transcript failed.

You can annotate the transcript by prefixing your comment with *

Your friends are arriving soon, and you need to bake a batch of cookies! Now where is that recipe card...?

Baking with Lizzie
A sweet story by Adri
Release 2 / Serial number 170924 / Inform 7 build 6M62 (I6/v6.33 lib 6/12N) SD

Kitchen
You are standing in your kitchen. There is a small oven, a single hot plate, and a mini refrigerator. There is also a low, raccoon-sized table, under which are a set of cabinets. A small stream runs through one end of the room. A lamp, about the same height as you, illuminates the room. There is a colorful rug on the floor.

On the table is a timer.

You can also see a stool here.

>test getall
(Testing.)

>[1] look under rug
You look under the rug and find a recipe card.

>[2] get card
Taken.

>[3] open fridge
You open the mini refrigerator, revealing a carton of milk, a stick of butter, and an egg.

>[4] open cabinet
You open the cabinets, revealing a bag of brown sugar, a box of white sugar, a bottle of vanilla extract, a bag of chocolate chips, a bag of flour, a carton of baking soda, and a container of salt.

>[5] take all
timer: Taken.
bag of brown sugar: Taken.
box of white sugar: Taken.
bottle of vanilla extract: Taken.
bag of chocolate chips: Taken.
bag of flour: Taken.
carton of baking soda: Taken.
container of salt: Taken.
carton of milk: Taken.
stick of butter: Taken.
egg: Taken.
crate: You can't reach that from down here.
apron: Taken.
potholder: Taken.
towel: Taken.

>[6] push stool to fridge
You place the stool in front of the refrigerator.

>[7] up
Kitchen (on the stool)
You are standing on a small stool in the kitchen. From here you can clearly see the top of the refrigerator.

>[8] take crate
Taken.

>[9] down
You get off the stool.

Kitchen
You are standing in your kitchen. There is a small oven, a single hot plate, and a mini refrigerator. There is also a low, raccoon-sized table, under which are a set of cabinets. A small stream runs through one end of the room. A lamp, about the same height as you, illuminates the room. There is a colorful rug on the floor.

You can see a stool here.

>[10] open oven
You open the oven, revealing a baking sheet.

>[11] take sheet
Taken.

>test ingredients
(Testing.)

>[1] put butter in mug
You put the stick of butter into the coffee mug.

>[2] melt butter on lamp
The butter melts.

>[3] break egg
You crack the egg into the bowl.

>[4] put egg in bowl
(first taking the cracked egg)
It would be difficult to take that back.

>[5] put butter in bowl
You put the pool of melted butter into the mixing bowl.

>[6] put white in bowl
You put the handful of white sugar into the mixing bowl.

>[7] put brown in bowl
You put the handful of brown sugar into the mixing bowl.

>[8] put flour in bowl
You put the double handful of flour into the mixing bowl.

>[9] put salt in bowl
You put the pinch of salt into the mixing bowl.

>[10] put soda in bowl
You put the pinch of baking soda into the mixing bowl.

>[11] put chips in bowl
You put the entire bag of chocolate chips into the mixing bowl.

>[12] put vanilla in bowl
You put the dash of vanilla extract into the mixing bowl.

You mix the ingredients with your hands until you have a good dough.

>put dough on pan
You roll out balls of dough and place them on the baking sheet.

>put pan in oven
You put the pan of cookies into the oven and close the door.

(first taking the baking sheet)
The oven isn't open.

>open oven
You open the oven, revealing a baking sheet.

* * *

>put dough on pan
You roll out balls of dough and place them on the baking sheet.

>preheat oven
You switch the oven on.

>put cookies in oven
You put the pan of cookies into the oven and close the door.

>i
You are carrying:
  a crate
    a coffee mug
    a mixing bowl
  a towel
  a potholder
  an apron
  a carton of milk
  a timer
  a recipe card

>set timer
You set the timer for 15 minutes.

>wait 15
You whistle a happy tune while you wait.

The timer dings! Your whiskers twitch excitedly!

>open oven
You open the oven, revealing a baking sheet.

>take cookie
You can't see any such thing.

>take pan
You carefully pick up the baking sheet with the potholder.

>i
You are carrying:
  a baking sheet
    some cookies
  a crate
    a coffee mug
    a mixing bowl
  a towel
  a potholder
  an apron
  a carton of milk
  a timer
  a recipe card

>take cookie
You can't see any such thing.

>x cookies
Homemade chocolate chip cookies!

>take cookie
You can't see any such thing.

* * *

>put dough on pan
You roll out balls of dough and place them on the baking sheet.

>x pan
A baking sheet.

On the baking sheet are some balls of dough.

>wash pan
You can't wash that while the cookies are on it!

* * *

>i
You are carrying:
  a baking sheet
  a crate
    a coffee mug
    a mixing bowl
      a dough
  a towel
  a potholder
  an apron
  a carton of milk
  a timer
  a recipe card

>put dough on sheet
You roll out balls of dough and place them on the baking sheet.

>put cookies in oven
You put the pan of cookies into the oven and close the door.

(first taking the baking sheet)
The oven isn't open.

* * *

>test baking
(Testing.)

>[1] roll dough into balls
You roll out balls of dough and place them on the baking sheet.

>[2] preheat oven
You switch the oven on.

>[3] put cookies in oven
You put the pan of cookies into the oven and close the door.

>[4] set timer
You set the timer for 15 minutes.

>wait 15
You whistle a happy tune while you wait.

The timer dings! Your whiskers twitch excitedly!

* * *

>open oven
You open the oven, revealing a baking sheet.

>take cookie
You take a single cookie, leaving the rest to cool.

* * *

>open oven
You open the oven, revealing a baking sheet.

>take cookies
You carefully pick up the baking sheet with the potholder.

>i
You are carrying:
  a baking sheet
    some cookies
  a crate
    a coffee mug
    a mixing bowl
  a towel
  a potholder
  an apron
  a carton of milk
  a timer
  a recipe card

>wait 20
You whistle a happy tune while you wait.

>wait 10
You whistle a happy tune while you wait.

>wait 10
You whistle a happy tune while you wait.

* * *

>take cookies
You carefully pick up the baking sheet with the potholder.

>wait 5
You whistle a happy tune while you wait.

Suddenly a duck and a rat on a lily pad come floating through on the stream.

    *** Yay! Your friends have arrived, and there are cookies and milk for everyone! ***

Would you like to RESTART, RESTORE a saved game, QUIT, or UNDO the last command?

* * *

>wait 15
You whistle a happy tune while you wait.

The timer dings! Your whiskers twitch excitedly!

>z
You whistle a happy tune while you wait.

>z
You whistle a happy tune while you wait.

>restart
Cannot open file
Attempt to begin transcript failed.

You can annotate the transcript by prefixing your comment with *

Your friends are arriving soon, and you need to bake a batch of cookies! Now where is that recipe card...?

Baking with Lizzie
A sweet story by Adri
Release 1 / Serial number 170819 / Inform 7 build 6M62 (I6/v6.33 lib 6/12N) SD

Kitchen
You are standing in the kitchen area of your burrow. There is a small oven, a single hot plate, and a mini refrigerator. There is also a low, raccoon-sized table, under which are a set of cabinets. A small stream runs through one end of the room. A lamp, about the same height as you, illuminates the room. There is a colorful rug on the floor, but you can't reach it.

On the table is a timer.

You can also see a stool here.

>up
Kitchen (on the stool)
You are standing on a small stool in the kitchen room of your burrow. From here you can clearly see the top of the refrigerator, but you can't reach it.

On the table is a timer.

>up
You get off the stool.

Kitchen
You are standing in the kitchen area of your burrow. There is a small oven, a single hot plate, and a mini refrigerator. There is also a low, raccoon-sized table, under which are a set of cabinets. A small stream runs through one end of the room. A lamp, about the same height as you, illuminates the room. There is a colorful rug on the floor, but you can't reach it.

On the table is a timer.

You can also see a stool here.

* * *

>z
You whistle a happy tune while you wait.

>z
You whistle a happy tune while you wait.

Oh no! The cookies are burning!

>open oven
You open the oven, revealing a baking sheet.

>take sheet
You carefully pick up the baking sheet with the potholder.

>z
You whistle a happy tune while you wait.

>z
You whistle a happy tune while you wait.

Suddenly a duck and a rat on a lily pad come floating through on the stream.

    *** Yay! Your friends have arrived, and there are cookies and milk for everyone! ***

Would you like to RESTART, RESTORE a saved game, QUIT, or UNDO the last command?

* * *

>wait 15
You whistle a happy tune while you wait.

The timer dings! Your whiskers twitch excitedly!

>put cookies on table
You can't see any such thing.

>open oven
You open the oven, revealing a baking sheet.

* * *

>take sheet
You carefully pick up the baking sheet with the potholder.

>put cookies on table
You put the cookies on the table.

>i
You are carrying:
  a baking sheet
  a crate
    a coffee mug
    a mixing bowl
  a towel
  a potholder
  an apron
  a carton of milk
  a timer
  a recipe card

Suddenly a duck and a rat on a lily pad come floating through on the stream.

    *** Yay! Your friends have arrived, and there are cookies and milk for everyone! ***

Would you like to RESTART, RESTORE a saved game, QUIT, or UNDO the last command?

* * *

>wait 15
You whistle a happy tune while you wait.

The timer dings! Your whiskers twitch excitedly!

>smell cookies
You can't see any such thing.

>open oven
You open the oven, revealing a baking sheet.

>smell cookies
Mmm, the cookies smell amazing.

>smell cookie
Mmm, the cookies smell amazing.

>take pan
You carefully pick up the baking sheet with the potholder.

>put pan on table
You should put something under the pan to protect the table.

>put towel on table
You put the towel on the table.

>put pan on towel
Putting things on the towel would achieve nothing.

>put pan on table
You put the baking sheet on the table.

* * *

>wait 15
You whistle a happy tune while you wait.

The timer dings! Your whiskers twitch excitedly!

>open oven. take cookies
You open the oven, revealing a baking sheet.

You carefully pick up the baking sheet with the potholder.

>drop potholder
You are holding the pan with the potholder.

>i
You are carrying:
  a baking sheet
    some cookies
  a crate
    a coffee mug
    a mixing bowl
  a towel
  a potholder
  an apron
  a carton of milk
  a timer
  a recipe card

>put potholder on table
You put the potholder on the table.

* * *

>wait 15
You whistle a happy tune while you wait.

The timer dings! Your whiskers twitch excitedly!

>open oven.take pan
You open the oven, revealing a baking sheet.

You carefully pick up the baking sheet with the potholder.

>put potholder on table
You are holding the pan with the potholder.

* * *

>test baking
(Testing.)

>[1] roll dough into balls
You roll out balls of dough and place them on the baking sheet.

>[2] preheat oven
You switch the oven on.

>[3] put cookies in oven
You put the pan of cookies into the oven and close the door.

>[4] set timer
You set the timer for 15 minutes.

>smell
Mmm, you smell the cookies baking in the oven.

>wait 15
The timer dings! Your whiskers twitch excitedly!

You whistle a happy tune while you wait.

>smell cookies
You can't see any such thing.

>smell
Mmm, you smell freshly-baked cookies.

>open oven
You open the oven, revealing a baking sheet.

>smell
Mmm, you smell freshly-baked cookies.

Uh oh! The cookies are burning.

Suddenly a duck and a rat on a lily pad come floating through on the stream.

    *** Yay! Your friends have arrived, and there are cookies and milk for everyone! ***

Would you like to RESTART, RESTORE a saved game, QUIT, or UNDO the last command?

* * *

>test baking
(Testing.)

>[1] roll dough into balls
You roll out balls of dough and place them on the baking sheet.

>[2] preheat oven
You switch the oven on.

>[3] put cookies in oven
You put the pan of cookies into the oven and close the door.

>[4] set timer
You set the timer for 15 minutes.

>put towel on table
You put the towel on the table.

>wait 15
The timer dings! Your whiskers twitch excitedly!

You whistle a happy tune while you wait.

>take cookies
You can't see any such thing.

>open oven
You open the oven, revealing a baking sheet.

* * *

>take cookies
You carefully pick up the baking sheet with the potholder.

>put pan on towel
You put the baking sheet on the table.

* * *

>test baking
(Testing.)

>[1] roll dough into balls
You roll out balls of dough and place them on the baking sheet.

>[2] preheat oven
You switch the oven on.

>[3] put cookies in oven
You put the pan of cookies into the oven and close the door.

>[4] set timer
You set the timer for 15 minutes.

>z
You whistle a happy tune while you wait.

>z
You whistle a happy tune while you wait.

While you wait for the cookies, you can clean up.

>undo
Kitchen
[Previous turn undone.]

>undo
Kitchen
[Previous turn undone.]

>unod
That's not a verb I recognize.

>undo
Kitchen
[Previous turn undone.]

>i
You are carrying:
  a crate
    a coffee mug
    a mixing bowl
  a towel
  a potholder
  an apron
  a carton of milk
  a timer
  a recipe card

>wait 15
While you wait for the cookies, you can clean up.

The timer dings! Your whiskers twitch excitedly!

You whistle a happy tune while you wait.

* * *

>test baking
(Testing.)

>[1] roll dough into balls
You roll out balls of dough and place them on the baking sheet.

>[2] preheat oven
You switch the oven on.

>[3] put cookies in oven
You put the pan of cookies into the oven and close the door.

>[4] set timer
You set the timer for 15 minutes.

>wait 20
The timer dings! Your whiskers twitch excitedly!

Oh no! The cookies are burning!

You whistle a happy tune while you wait.

>l
Kitchen
You are standing in the kitchen area of your burrow. There is a small oven, a single hot plate, and a mini refrigerator. There is also a low, raccoon-sized table, under which are a set of cabinets. A small stream runs through one end of the room. A lamp, about the same height as you, illuminates the room. There is a colorful rug on the floor.

You can see a stool here.

>smell
Mmm, you smell freshly-baked cookies.

* * *

>test baking
(Testing.)

>[1] roll dough into balls
You roll out balls of dough and place them on the baking sheet.

>[2] preheat oven
You switch the oven on.

>[3] put cookies in oven
You put the pan of cookies into the oven and close the door.

>[4] set timer
You set the timer for 15 minutes.

>open oven
The cookies aren't ready yet!

>wait 15
The timer dings! Your whiskers twitch excitedly!

You whistle a happy tune while you wait.

>open oven
You open the oven, revealing a baking sheet.

* * *

>take cookies
You carefully pick up the baking sheet with the potholder.

>put sheet on potholder
You can't hold the pan with the potholder and place the pan on it.

* * *

>test baking
(Testing.)

>[1] roll dough into balls
You roll out balls of dough and place them on the baking sheet.

>[2] preheat oven
You switch the oven on.

>[3] put cookies in oven
You put the pan of cookies into the oven and close the door.

>[4] set timer
You set the timer for 15 minutes.

>wait 15.open oven.put towel on table.take tray
You whistle a happy tune while you wait.

The timer dings! Your whiskers twitch excitedly!

You open the oven, revealing a baking sheet.

You put the towel on the table.

You carefully pick up the baking sheet with the potholder.

>put tray on table
You put the baking sheet on the table.

>take towel
The towel is underneath the baking sheet.

>restart
Are you sure you want to restart?

>y
Cannot open file
Attempt to begin transcript failed.

You can annotate the transcript by prefixing your comment with *

Your friends are arriving soon, and you need to bake a batch of cookies! Now where is that recipe card...?

Baking with Lizzie
A sweet story by Adri
Release 1 / Serial number 170822 / Inform 7 build 6M62 (I6/v6.33 lib 6/12N) SD

Kitchen
You are standing in your kitchen. There is a small oven, a single hot plate, and a mini refrigerator. There is also a low, raccoon-sized table, under which are a set of cabinets. A small stream runs through one end of the room. A lamp, about the same height as you, illuminates the room. There is a colorful rug on the floor.

On the table is a timer.

You can also see a stool here.

>test getall
(Testing.)

>[1] look under rug
You look under the rug and find a recipe card.

>[2] get card
Taken.

>[3] open fridge
You open the mini refrigerator, revealing a carton of milk, a stick of butter, and an egg.

>[4] open cabinet
You open the cabinets, revealing a bag of brown sugar, a box of white sugar, a bottle of vanilla extract, a bag of chocolate chips, a bag of flour, a carton of baking soda, and a container of salt.

>[5] take all
timer: Taken.
bag of brown sugar: Taken.
box of white sugar: Taken.
bottle of vanilla extract: Taken.
bag of chocolate chips: Taken.
bag of flour: Taken.
carton of baking soda: Taken.
container of salt: Taken.
carton of milk: Taken.
stick of butter: Taken.
egg: Taken.
crate: You can't reach that from down here.
apron: Taken.
potholder: Taken.
towel: Taken.

>[6] push stool to fridge
You place the stool in front of the refrigerator.

>[7] up
Kitchen (on the stool)
You are standing on a small stool in the kitchen. From here you can clearly see the top of the refrigerator.

>[8] take crate
Taken.

>[9] down
You get off the stool.

Kitchen
You are standing in your kitchen. There is a small oven, a single hot plate, and a mini refrigerator. There is also a low, raccoon-sized table, under which are a set of cabinets. A small stream runs through one end of the room. A lamp, about the same height as you, illuminates the room. There is a colorful rug on the floor.

You can see a stool here.

>[10] open oven
You open the oven, revealing a baking sheet.

>[11] take sheet
Taken.

* * *

>put dough in oven
(first taking dough)
You put dough into the oven.

* * *

>x bowl
A large blue plastic bowl.

In the mixing bowl is dough.

>i
You are carrying:
  a baking sheet
  a crate
    a coffee mug
    a mixing bowl
      dough
  a towel
  a potholder
  an apron
  a carton of milk
  a timer
  a recipe card

* * *

>x bowl
A large blue plastic bowl.

In the mixing bowl is dough.

>undo
Kitchen
[Previous turn undone.]

>x bowl
A large blue plastic bowl.

In the mixing bowl are an entire bag of chocolate chips, a pinch of baking soda, a pinch of salt, a scoop of flour, a scoop of brown sugar, a scoop of white sugar, a stick of melted butter, and an egg.

* * *

>undo
Kitchen
[Previous turn undone.]

>x bowl
A large blue plastic bowl.

In the mixing bowl are an entire bag of chocolate chips, a pinch of baking soda, a pinch of salt, a double handful of flour, a handful of brown sugar, a handful of white sugar, a pool of melted butter, and an egg.

>put vanilla into bowl
You put the tablespoon of vanilla extract into the mixing bowl.

You mix the ingredients with your hands until you have a good dough.

* * *

>put dough in oven
You need to place the dough on a baking sheet first.

>i
You are carrying:
  a baking sheet
  a crate
    a coffee mug
    a mixing bowl
      dough
  a towel
  a potholder
  an apron
  a carton of milk
  a timer
  a recipe card

>put dough on sheet
You roll out balls of dough and place them on the baking sheet.

>put dough in oven
You put the pan of cookies into the oven and close the door.

>i
You are carrying:
  a crate
    a coffee mug
    a mixing bowl
  a towel
  a potholder
  an apron
  a carton of milk
  a timer
  a recipe card

>undo
Kitchen
[Previous turn undone.]

>take dough
Taken.

>i
You are carrying:
  some balls of dough
  a baking sheet
  a crate
    a coffee mug
    a mixing bowl
  a towel
  a potholder
  an apron
  a carton of milk
  a timer
  a recipe card

* * *

>mix flour
That is not in the mixing bowl yet.

>put flour in bowl
You put the scoop of flour into the mixing bowl.

>mix flour
You don't know how to do that.

>mix bowl
You don't know how to do that.

* * *

>mix flour
That is not in the mixing bowl yet.

>mix bowl
There is nothing in the bowl yet.

>put flour in bowl
You put the scoop of flour into the mixing bowl.

>mix flour
You mix the ingredients together with your hands.

* * *

>mix bowl
You mix the ingredients together with your hands.

* * *

>i
You are carrying:
  a baking sheet
  a crate
    a coffee mug
    a mixing bowl
  a towel
  a potholder
  an apron
  an egg
  a stick of butter
  a carton of milk
  a container of salt
  a carton of baking soda
  a bag of flour
  a bag of chocolate chips
  a bottle of vanilla extract
  a box of white sugar
  a bag of brown sugar
  a timer
  a recipe card

>read card
Lizzie's Chocolate Chip Cookies

 melted stick of butter
 brown sugar
 white sugar
 an egg
 vanilla extract
 bag of chocolate chips
 flour
 baking soda
 salt

 Preheat oven.
 Mix ingredients together in a large bowl.
 Roll dough into balls and place on pan.
 Place pan in oven.
 Set the timer to 15 minutes.

>read timer
There's nothing to read.

* * *

>put butter on baking sheet
The butter would just melt into a puddle all over the baking sheet.

* * *

>put butter on pan
You put the stick of butter on the baking sheet.

>put pan in oven
The butter would just melt into a puddle all over the baking sheet.

* * *

>put water in mug
(first taking the water)
That seems to be a part of the stream.

* * *

>wait 15
You whistle a happy tune while you wait.

>wait 15
You whistle a happy tune while you wait.

>i
You are carrying:
  a crate
    a coffee mug
    a mixing bowl
  a towel
  a potholder
  an apron
  an egg
  a stick of butter
  a carton of milk
  a container of salt
  a carton of baking soda
  a bag of flour
  a bag of chocolate chips
  a bottle of vanilla extract
  a box of white sugar
  a bag of brown sugar
  a timer
  a recipe card

>open oven
That's already open.

>look in oven
In the oven is a baking sheet.

>preheat oven
You switch the oven on.

>wait 15
You whistle a happy tune while you wait.

>close oven
You close the oven.

>wait 15
You whistle a happy tune while you wait.

>open oven
You open the oven, revealing a baking sheet.

* * *

>taste flour
You put a handful of flour in your mouth and immediately spit it back out.

* * *

>put crate on floor
Dropped.

>hang mug on hooks
That's not a verb I recognize.

>put mug on hooks
(first taking the coffee mug)
You put the coffee mug on the hooks.

* * *

>hang mug on hooks
(first taking the coffee mug)
You put the coffee mug on the hooks.

* * *

>wash apron
Now the apron is damp!

>wash potholder
Now the potholder is damp!

>wash me
You need soap to wash up with.

>take soap
You can't see any such thing.

>x pocket
The pocket is trimmed in blue ric rac.

>take soap
You can't see any such thing.

* * *

>x pocket
The pocket is trimmed in blue ric rac.

>look in pocket
You can't see inside, since the pocket is closed.

>x apron
A frilly pink apron. It goes over the neck and ties behind your back. It has a single pocket on the front.

>x pocket
The pocket is trimmed in blue ric rac.

In the pocket is a bar of soap.

>take soap
Taken.

>wash me
You scrub yourself with soap and water until it is clean.

>wash pan
You scrub the baking sheet with soap and water until it is clean.

>test ingredients
(Testing.)

>[1] put butter in mug
You put the stick of butter into the coffee mug.

>[2] melt butter on lamp
The butter melts into a puddle.

>[3] break egg
You crack the egg in your hands.

>[4] put egg in bowl
You put the cracked egg into the mixing bowl.

>[5] put butter in bowl
You put the stick of melted butter into the mixing bowl.

>[6] put white in bowl
You put the scoop of white sugar into the mixing bowl.

>[7] put brown in bowl
You put the scoop of brown sugar into the mixing bowl.

>[8] put flour in bowl
You put the scoop of flour into the mixing bowl.

>[9] put salt in bowl
You put the pinch of salt into the mixing bowl.

>[10] put soda in bowl
You put the pinch of baking soda into the mixing bowl.

>[11] put chips in bowl
You put the entire bag of chocolate chips into the mixing bowl.

>[12] put vanilla in bowl
You put the tablespoon of vanilla extract into the mixing bowl.

You mix the ingredients with your hands until you have a good dough.

>put dough on pan
You roll out balls of dough and place them on the baking sheet.

>wash pan
You scrub the baking sheet with soap and water until it is clean.

* * *

>up
Kitchen (on the stool)
You are standing on a small stool in the kitchen room of your burrow. From here you can clearly see the top of the refrigerator.

>put crate on fridge
You put the crate on the top of the refrigerator.

>test baking
(Testing.)

>[1] roll dough into balls
You can't see any such thing.

>[2] preheat oven
You switch the oven on.

>[3] put cookies in oven
You can't see any such thing.

>[4] set timer
You set the timer for 15 minutes.

>test ingredients
(Testing.)

>[1] put butter in mug
You can't reach that from here.

>[2] melt butter on lamp
You can't melt that in your hands!

>[3] break egg
You crack the egg in your hands.

>[4] put egg in bowl
You can't reach that from here.

>[5] put butter in bowl
You need to melt the butter first.

>[6] put white in bowl
You can't reach that from here.

>[7] put brown in bowl
You can't reach that from here.

>[8] put flour in bowl
You can't reach that from here.

>[9] put salt in bowl
You can't reach that from here.

>[10] put soda in bowl
You can't reach that from here.

>[11] put chips in bowl
You can't reach that from here.

>[12] put vanilla in bowl
You can't reach that from here.

>restart
Are you sure you want to restart?

>y
Cannot open file
Attempt to begin transcript failed.

You can annotate the transcript by prefixing your comment with *

Your friends are arriving soon, and you need to bake a batch of cookies! Now where is that recipe card...?

Baking with Lizzie
A sweet story by Adri
Release 1 / Serial number 170819 / Inform 7 build 6M62 (I6/v6.33 lib 6/12N) SD

Kitchen
You are standing in the kitchen area of your burrow. There is a small oven, a single hot plate, and a mini refrigerator. There is also a low, raccoon-sized table, under which are a set of cabinets. A small stream runs through one end of the room. A lamp, about the same height as you, illuminates the room. There is a colorful rug on the floor, but you can't reach it.

On the table is a timer.

You can also see a stool here.

>test getall
(Testing.)

>[1] look under rug
You look under the rug and find a recipe card.

>[2] get card
Taken.

>[3] open fridge
You open the mini refrigerator, revealing a carton of milk, a stick of butter, and an egg.

>[4] open cabinet
You open the cabinets, revealing a bag of brown sugar, a box of white sugar, a bottle of vanilla extract, a bag of chocolate chips, a bag of flour, a carton of baking soda, and a container of salt.

>[5] take all
timer: Taken.
bag of brown sugar: Taken.
box of white sugar: Taken.
bottle of vanilla extract: Taken.
bag of chocolate chips: Taken.
bag of flour: Taken.
carton of baking soda: Taken.
container of salt: Taken.
carton of milk: Taken.
stick of butter: Taken.
egg: Taken.
crate: You can't reach that from down here.
coffee mug: You can't reach that from down here.
mixing bowl: You can't reach that from down here.
apron: Taken.
potholder: Taken.
towel: Taken.

>[6] push stool to fridge
You place the stool in front of the refrigerator.

>[7] up
Kitchen (on the stool)
You are standing on a small stool in the kitchen room of your burrow. From here you can clearly see the top of the refrigerator.

>[8] take crate
Taken.

>[9] down
You get off the stool.

Kitchen
You are standing in the kitchen area of your burrow. There is a small oven, a single hot plate, and a mini refrigerator. There is also a low, raccoon-sized table, under which are a set of cabinets. A small stream runs through one end of the room. A lamp, about the same height as you, illuminates the room. There is a colorful rug on the floor.

You can see a stool here.

>[10] open oven
You open the oven, revealing a baking sheet.

>[11] take sheet
Taken.

>test ingredients
(Testing.)

>[1] put butter in mug
You put the stick of butter into the coffee mug.

>[2] melt butter on lamp
The butter melts into a puddle.

>[3] break egg
You crack the egg in your hands.

>[4] put egg in bowl
You put the cracked egg into the mixing bowl.

>[5] put butter in bowl
You put the stick of melted butter into the mixing bowl.

>[6] put white in bowl
You put the scoop of white sugar into the mixing bowl.

>[7] put brown in bowl
You put the scoop of brown sugar into the mixing bowl.

>[8] put flour in bowl
You put the scoop of flour into the mixing bowl.

>[9] put salt in bowl
You put the pinch of salt into the mixing bowl.

>[10] put soda in bowl
You put the pinch of baking soda into the mixing bowl.

>[11] put chips in bowl
You put the entire bag of chocolate chips into the mixing bowl.

>[12] put vanilla in bowl
You put the tablespoon of vanilla extract into the mixing bowl.

You mix the ingredients with your hands until you have a good dough.

>test getall
(Testing.)

>[1] look under rug
You look under the rug again. There is nothing there.

>[2] get card
You already have that.

>[3] open fridge
The stool is blocking the door.

>[4] open cabinet
That's already open.

>[5] take all
There are none at all available!

>[6] push stool to fridge
The stool is already in front of the refrigerator.

>[7] up
Kitchen (on the stool)
You are standing on a small stool in the kitchen room of your burrow. From here you can clearly see the top of the refrigerator.

>[8] take crate
You already have that.

>[9] down
You get off the stool.

Kitchen
You are standing in the kitchen area of your burrow. There is a small oven, a single hot plate, and a mini refrigerator. There is also a low, raccoon-sized table, under which are a set of cabinets. A small stream runs through one end of the room. A lamp, about the same height as you, illuminates the room. There is a colorful rug on the floor.

You can see a stool here.

>[10] open oven
That's already open.

>[11] take sheet
You already have that.

>test baking
(Testing.)

>[1] roll dough into balls
You roll out balls of dough and place them on the baking sheet.

>[2] preheat oven
You switch the oven on.

>[3] put cookies in oven
You put the pan of cookies into the oven and close the door.

>[4] set timer
You set the timer for 15 minutes.

* * *

>open oven
You open the oven, revealing a baking sheet.

>take cookies
You take a cookie, leaving the rest to cool.

* * *

>drink milk
You pour milk into the coffee mug and drink it all down.

>put butter in mug
You put the stick of butter into the coffee mug.

>drink milk
The mug isn't empty.

>drop mug
You haven't got that.

>take mug
Taken.

>drop mug
Dropped.

>drink milk
You'll need a cup of some sort first.

>pour milk
You can't do that.

* * *

>pour milk
You pour milk into the coffee mug and drink it all down.

>pour milk into mug
You pour milk into the coffee mug and drink it all down.

* * *

>rink water
That's not a verb I recognize.

>drink water
You scoop up water into the coffee mug and drink it all down.

>put milk in mug
You put the carton of milk into the coffee mug.

* * *

>put milk in mug
You pour milk into the coffee mug and drink it all down.

>put water in mug
(first taking the water)
That seems to be a part of the stream.

* * *

>crack egg
You crack the egg into the bowl.

>undo
Kitchen
[Previous turn undone.]

>abstract bowl to top
[Abstracted.]

>i
You are carrying:
  a baking sheet
  a crate
    a coffee mug
  a towel
  a potholder
  an apron
  an egg
  a stick of butter
  a carton of milk
  a container of salt
  a carton of baking soda
  a bag of flour
  a bag of chocolate chips
  a bottle of vanilla extract
  a box of white sugar
  a bag of brown sugar
  a timer
  a recipe card

>crack egg
You crack the egg into the coffee mug

>put egg in bowl
You can't reach that from here.

>abstract bowl to me
[Abstracted.]

>put egg in bowl
(first taking the egg)
You put the cracked egg into the mixing bowl.

>undo
Kitchen
[Previous turn undone.]

>pour egg into bowl
(first taking the egg)
You pour a cracked egg into the mixing bowl.

>undo
Kitchen
[Previous turn undone.]

>pour mug into bowl
You can't do that.

* * *

>undo
Kitchen
[Previous turn undone.]

>crack egg into mug
You crack the egg into the coffee mug.

>i
You are carrying:
  a baking sheet
  a crate
    a coffee mug
      an egg
    a mixing bowl
  a towel
  a potholder
  an apron
  a stick of butter
  a carton of milk
  a container of salt
  a carton of baking soda
  a bag of flour
  a bag of chocolate chips
  a bottle of vanilla extract
  a box of white sugar
  a bag of brown sugar
  a timer
  a recipe card

>x mug
A ceramic coffee mug with a butterfly on it.

In the coffee mug is an egg.

* * *

>open milk
You open the carton of milk.

>open flour
You open the bag of flour.

* * *

>wash flour
You wash the bag of flour quickly in the water.

* * *

>mix ingredients
There is nothing in the bowl yet.

>mix bowl
There is nothing in the bowl yet.

* * *

>mix ingredients
There is nothing in the bowl yet.

>mix flour
That is not in the mixing bowl yet.

* * *

>put flour in bowl
You put the scoop of flour into the mixing bowl.

>mix bowl
You mix the ingredients together with your hands.

>mix ingredients
You mix the ingredients together with your hands.

>mix flour
You mix the ingredients together with your hands.

* * *

>pour sugar into bowl
Which do you mean, the box of white sugar or the bag of brown sugar?

>both
Sorry, you can only have one item here. Which exactly?

>pour milk into bol
You can't see any such thing.

>pour milk into bowl
You can't do that.

* * *

>pour milk into bowl
That's not part of the recipe.

* * *

>melt bowl
You can't melt that. Or rather, you can, but you shouldn't.

>melt bowl over lamp
You can't melt that. Or rather, you can, but you shouldn't.

>melt bowl over hot
You can't melt that. Or rather, you can, but you shouldn't.

>drink out of extract
There's nothing suitable to drink there.

* * *

>melt butter in mug
I only understood you as far as wanting to melt the stick of butter.

>put butter in mug
You put the stick of butter into the coffee mug.

>melt butter on lamp
The butter melts.

>put butter in bowl
You put the pool of melted butter into the mixing bowl.

>put butter in bowl
You put the pool of melted butter into the mixing bowl.

>put white in bowl
You put the handful of white sugar into the mixing bowl.

>put white in bowl
(first taking the handful of white sugar)
It would be difficult to take that back.

>break egg into bowl
You crack the egg into the bowl.

>break egg
You crack the egg into the bowl.

* * *

>put butter in mug
You put the stick of butter into the coffee mug.

>melt butter on light
(the lamp)
The butter melts.

>put butter in bowl
You put the pool of melted butter into the mixing bowl.

>put butter in bowl
(first taking the pool of melted butter)
It would be difficult to take that back.

* * *

>break egg
You crack the egg into the bowl.

>break egg
The egg has already been cracked open.

>undo
Kitchen
[Previous turn undone.]

>break egg into mug
You crack the egg into the bowl.

* * *

>crack egg into table
You'll need something else to crack that into.

>crack egg into mug
You crack the egg into the coffee mug.

>i
You are carrying:
  a baking sheet
  a crate
    a coffee mug
      a cracked egg
    a mixing bowl
  a towel
  a potholder
  an apron
  a stick of butter
  a carton of milk
  a container of salt
  a carton of baking soda
  a bag of flour
  a bag of chocolate chips
  a bottle of vanilla extract
  a box of white sugar
  a bag of brown sugar
  a timer
  a recipe card

>x mug
A ceramic coffee mug with a butterfly on it.

In the coffee mug is a cracked egg.

>put egg in bowl
(first taking the cracked egg)
You put the cracked egg into the mixing bowl.

* * *

>crack egg into mug
You crack the egg into the coffee mug.

>put egg into bowl
You put the cracked egg into the mixing bowl.

>undo
Kitchen
[Previous turn undone.]

* * *

>undo
Kitchen
[Previous turn undone.]

* * *

>test ingredientes
(Testing.)

>[1] put butter in mug
You put the stick of butter into the coffee mug.

>[2] melt butter on lamp
The butter melts.

>[3] break egg
You crack the egg into the bowl.

>[4] put egg in bowl
(first taking the cracked egg)
It would be difficult to take that back.

>[5] put butter in bowl
You put the pool of melted butter into the mixing bowl.

>[6] put white in bowl
You put the handful of white sugar into the mixing bowl.

>[7] put brown in bowl
You put the handful of brown sugar into the mixing bowl.

>[8] put flour in bowl
You put the double handful of flour into the mixing bowl.

>[9] put salt in bowl
You put the pinch of salt into the mixing bowl.

>[10] put soda in bowl
You put the pinch of baking soda into the mixing bowl.

>[11] put chips in bowl
You put the entire bag of chocolate chips into the mixing bowl.

>[12] put vanilla in bowl
You put the dash of vanilla extract into the mixing bowl.

You mix the ingredients with your hands until you have a good dough.

>put dough in oven
You need to place the dough on a baking sheet first.

>bake dough
You need to place the dough on a baking sheet first.

>put dough on sheet
You roll out balls of dough and place them on the baking sheet.

* * *

>put pan in oven
You put the baking sheet into the oven.

>undo
Kitchen
[Previous turn undone.]

>put potholder in oven
That doesn't belong in the oven.

>test ingredients
(Testing.)

>[1] put butter in mug
You put the stick of butter into the coffee mug.

>[2] melt butter on lamp
The butter melts.

>[3] break egg
You crack the egg into the bowl.

>[4] put egg in bowl
(first taking the cracked egg)
It would be difficult to take that back.

>[5] put butter in bowl
You put the pool of melted butter into the mixing bowl.

>[6] put white in bowl
You put the handful of white sugar into the mixing bowl.

>[7] put brown in bowl
You put the handful of brown sugar into the mixing bowl.

>[8] put flour in bowl
You put the double handful of flour into the mixing bowl.

>[9] put salt in bowl
You put the pinch of salt into the mixing bowl.

>[10] put soda in bowl
You put the pinch of baking soda into the mixing bowl.

>[11] put chips in bowl
You put the entire bag of chocolate chips into the mixing bowl.

>[12] put vanilla in bowl
You put the dash of vanilla extract into the mixing bowl.

You mix the ingredients with your hands until you have a good dough.

* * *

>test baking
(Testing.)

>[1] roll dough into balls
You roll out balls of dough and place them on the baking sheet.

>[2] preheat oven
You switch the oven on.

>[3] put cookies in oven
You put the pan of cookies into the oven and close the door.

>[4] set timer
You set the timer for 15 minutes.

>i
You are carrying:
  a crate
    a coffee mug
    a mixing bowl
  a towel
  a potholder
  an apron
  a carton of milk
  a timer
  a recipe card

* * *

>take all
timer: Taken.
crate: You can't reach that from down here.
apron: Taken.
potholder: Taken.
towel: Taken.

>open cabinet
You open the cabinets, revealing a bag of brown sugar, a box of white sugar, a bottle of vanilla extract, a bag of chocolate chips, a bag of flour, a carton of baking soda, and a container of salt.

>take all
bag of brown sugar: Taken.
box of white sugar: Taken.
bottle of vanilla extract: Taken.
bag of chocolate chips: Taken.
bag of flour: Taken.
carton of baking soda: Taken.
container of salt: Taken.
crate: You can't reach that from down here.

>open fridge
You open the mini refrigerator, revealing a carton of milk, a stick of butter, and an egg.

>take all
carton of milk: Taken.
stick of butter: Taken.
egg: Taken.
crate: You can't reach that from down here.
coffee mug: You can't reach that from down here.
mixing bowl: You can't reach that from down here.

>close fridge
You close the mini refrigerator.

>push stool to fridge
You place the stool in front of the refrigerator.

>up
Kitchen (on the stool)
You are standing on a small stool in the kitchen room of your burrow. From here you can clearly see the top of the refrigerator.

>take all
crate: Taken.

>put all in bowl
crate: That's not an ingredient!

You can't put something inside itself.
egg: You need to break the egg first.
stick of butter: You need to melt the butter first.
carton of milk: That's not part of the recipe.

That's not an ingredient!

Done.
container of salt: Done.
carton of baking soda: Done.
bag of flour: Done.
bag of chocolate chips: Done.
bottle of vanilla extract: Done.
box of white sugar: Done.
bag of brown sugar: Done.
towel: That's not an ingredient!

Done.
potholder: That's not an ingredient!

Done.
apron: That's not an ingredient!

Done.
timer: That's not an ingredient!

Done.

>break egg
You crack the egg in your hands.

>put butter in cup
You put the stick of butter into the coffee mug.

>melt butter on lamp
The butter melts into a puddle.

>put butter in bowl
You put the stick of melted butter into the mixing bowl.

>put egg in bowl
You put the cracked egg into the mixing bowl.

You mix the ingredients with your hands until you have a good dough.

>make dough
That's not a verb I recognize.

>put dough on pan
You can't see any such thing.

>open oven. get pan
You open the oven, revealing a baking sheet.

You can't reach that from up here.

>down
You get off the stool.

Kitchen
You are standing in the kitchen area of your burrow. There is a small oven, a single hot plate, and a mini refrigerator. There is also a low, raccoon-sized table, under which are a set of cabinets. A small stream runs through one end of the room. A lamp, about the same height as you, illuminates the room. There is a colorful rug on the floor.

You can see a stool here.

>get pan
Taken.

>put dough on pan
You roll out balls of dough and place them on the baking sheet.

>put cookies in oven
You put the pan of cookies into the oven.

(first taking the baking sheet)
You put the baking sheet into the oven.

>i
You are carrying:
  a crate
    a coffee mug
    a mixing bowl
      a timer
      an apron
      a potholder
      a towel
      a carton of milk

* * *

>open cabints
You can't see any such thing.

>open cabinet
You open the cabinets, revealing a bag of brown sugar, a box of white sugar, a bottle of vanilla extract, a bag of chocolate chips, a bag of flour, a carton of baking soda, and a container of salt.

>take brown sugar, white sugar, extract, chips, flour, soda and salt
bag of brown sugar: Taken.
box of white sugar: Taken.
bottle of vanilla extract: Taken.
bag of chocolate chips: Taken.
bag of flour: Taken.
carton of baking soda: Taken.
stool: Taken.

>i
You are carrying:
  a stool
  a carton of baking soda
  a bag of flour
  a bag of chocolate chips
  a bottle of vanilla extract
  a box of white sugar
  a bag of brown sugar

>undo
Kitchen
[Previous turn undone.]

>i
You are carrying nothing.

>rules on
Rules tracing now switched on. Type "rules off" to switch it off again, or "rules all" to include even rules which do not apply.

* * *

>i
[Rule "declare everything initially unmentioned rule" applies.]
[Rule "announce items from multiple object lists rule" applies.]
[Rule "set pronouns from items from multiple object lists rule" applies.]
[Rule "before stage rule" applies.]
[Rule "instead stage rule" applies.]
[Rule "investigate player's awareness before action rule" applies.]
[Rule "player aware of his own actions rule" applies.]
[Rule "check stage rule" applies.]
[Rule "carry out stage rule" applies.]
[Rule "print empty inventory rule" applies.]
[Rule "print standard inventory rule" applies.]
You are carrying:
  a stool
  a carton of baking soda
  a bag of flour
  a bag of chocolate chips
  a bottle of vanilla extract
  a box of white sugar
  a bag of brown sugar
[Rule "after stage rule" applies.]

[Rule "investigate player's awareness after action rule" applies.]
[Rule "report stage rule" applies.]
[Rule "report other people taking inventory rule" applies.]
[Rule "last specific action-processing rule" applies.]
[Rule "A first turn sequence rule" applies.]
[Rule "every turn stage rule" applies.]
[Rule "A last turn sequence rule" applies.]
[Rule "notify score changes rule" applies.]

>rules off
[Rule "declare everything initially unmentioned rule" applies.]
Rules tracing now switched off. Type "rules" to switch it on again.

>undo
Kitchen
[Previous turn undone.]

* * *

>i
You are carrying nothing.

>open caibnets
You can't see any such thing.

>open cabinets
That's already open.

>i
You are carrying nothing.

>l
Kitchen
You are standing in the kitchen area of your burrow. There is a small oven, a single hot plate, and a mini refrigerator. There is also a low, raccoon-sized table, under which are a set of cabinets. A small stream runs through one end of the room. A lamp, about the same height as you, illuminates the room. There is a colorful rug on the floor, but you can't reach it.

On the table is a timer.

You can also see a stool here.

>look in cabinets
In the cabinets are a bag of brown sugar, a box of white sugar, a bottle of vanilla extract, a bag of chocolate chips, a bag of flour, a carton of baking soda, and a container of salt.

>take brown, white, extract, chips, flour, soda, salt
bag of brown sugar: Taken.
box of white sugar: Taken.
bottle of vanilla extract: Taken.
bag of chocolate chips: Taken.
bag of flour: Taken.
carton of baking soda: Taken.
container of salt: Taken.

>undo
Kitchen
[Previous turn undone.]

>take brown, white, extract, chips, flour, soda and salt
bag of brown sugar: Taken.
box of white sugar: Taken.
bottle of vanilla extract: Taken.
bag of chocolate chips: Taken.
bag of flour: Taken.
carton of baking soda: Taken.
container of salt: Taken.

>undo
Kitchen
[Previous turn undone.]

>take brown sugar, white sugar, extract, chips, flour, soda, salt
bag of brown sugar: Taken.
box of white sugar: Taken.
bottle of vanilla extract: Taken.
bag of chocolate chips: Taken.
bag of flour: Taken.
carton of baking soda: Taken.
stool: Taken.

>mix flour
You mix the ingredients together with your hands.

* * *

>open cabinets
You open the cabinets, revealing a bag of brown sugar, a box of white sugar, a bottle of vanilla extract, a bag of chocolate chips, a bag of flour, a carton of baking soda, and a container of salt.

>take flour
Taken.

>mix flour
You can't reach that from here.

* * *

>x coat
You are a raccoon. You have large expressive eyes, hidden behind a mask of black on a white face; short, pointed ears tipped with white; and a long, bushy tail ringed in black. Your long coat is grey, almost silver, grizzled with black.

* * *

>up
Kitchen (on the stool)
You are standing on a small stool in the kitchen. From here you can clearly see the top of the refrigerator, but you can't reach it.

On the table is a timer.

>up
You can't go any higher.

>up
You can't go any higher.

>down
(first getting off the stool)
You can't go that way.

* * *

>up
You can't go any higher.

>down
You get off the stool.

Kitchen
You are standing in the kitchen area of your burrow. There is a small oven, a single hot plate, and a mini refrigerator. There is also a low, raccoon-sized table, under which are a set of cabinets. A small stream runs through one end of the room. A lamp, about the same height as you, illuminates the room. There is a colorful rug on the floor, but you can't reach it.

On the table is a timer.

You can also see a stool here.

>down
You can't go that way.

* * *

>up
Kitchen (on the stool)
You are standing on a small stool in the kitchen. From here you can clearly see the top of the refrigerator, but you can't reach it.

On the table is a timer.

>down
You get off the stool.

Kitchen
You are standing in your kitchen. There is a small oven, a single hot plate, and a mini refrigerator. There is also a low, raccoon-sized table, under which are a set of cabinets. A small stream runs through one end of the room. A lamp, about the same height as you, illuminates the room. There is a colorful rug on the floor.

On the table is a timer.

You can also see a stool here.

>push stool to fridge
You place the stool in front of the refrigerator.

>up
Kitchen (on the stool)
You are standing on a small stool in the kitchen. From here you can clearly see the top of the refrigerator.

On the table is a timer.

>push stool
You move the stool out of the way.

>i
You are carrying nothing.

>l
Kitchen (on the stool)
You are standing on a small stool in the kitchen. From here you can clearly see the top of the refrigerator, but you can't reach it.

On the table is a timer.

* * *

>up
Kitchen (on the stool)
You are standing on a small stool in the kitchen. From here you can clearly see the top of the refrigerator, but you can't reach it.

On the table is a timer.

>push stool to fridge
You place the stool in front of the refrigerator.

>up
You can't go any higher.

>down
You get off the stool.

Kitchen
You are standing in the kitchen area of your burrow. There is a small oven, a single hot plate, and a mini refrigerator. There is also a low, raccoon-sized table, under which are a set of cabinets. A small stream runs through one end of the room. A lamp, about the same height as you, illuminates the room. There is a colorful rug on the floor.

On the table is a timer.

You can also see a stool here.

>up
You are standing on a small stool in the kitchen of your burrow. From here you can clearly see the top of the refrigerator.

* * *

>up
Kitchen (on the stool)
You are standing on a small stool in the kitchen. From here you can clearly see the top of the refrigerator, but you can't reach it.

On the table is a timer.

>l
You are standing on a small stool in the kitchen of your burrow. From here you can clearly see the top of the refrigerator, but you can't reach it.

* * *

>up
Kitchen (on the stool)
You are standing on a small stool in the kitchen. From here you can clearly see the top of the refrigerator, but you can't reach it.

On the table is a timer.

>x fridge
It's a mini refrigerator, such as one might find in a dorm room. There is a magnet on the front. On the right side is glued a set of hooks, on which are an apron, a potholder, and a towel. There is a crate on top of the refrigerator.

>x crate
It's a plastic crate containing assorted cooking implements.

In the crate are a coffee mug and a mixing bowl.

* * *

>up
Kitchen (on the stool)
You are standing on a small stool in the kitchen. From here you can clearly see the top of the refrigerator, but you can't reach it.

On the table is a timer.

>push stool
You move the stool out of the way.

* * *

>up
Kitchen (on the stool)
You are standing on a small stool in the kitchen. From here you can clearly see the top of the refrigerator, but you can't reach it.

On the table is a timer.

>move stool
You can't move that while you're on it.

>push stool to fridge
You can't move that while you're on it.

* * *

>put stool under crate
You place the stool in front of the refrigerator.

>sit on stool
Kitchen (on the stool)
You are standing on a small stool in the kitchen room of your burrow. From here you can clearly see the top of the refrigerator.

On the table is a timer.

* * *

>sit on stool
You sit on the stool.

>stand on stool
Kitchen (on the stool)
You are standing on a small stool in the kitchen room of your burrow. From here you can clearly see the top of the refrigerator, but you can't reach it.

On the table is a timer.

* * *

>sit
You sit on the stool.

Kitchen (on the stool)
You are standing on a small stool in the kitchen room of your burrow. From here you can clearly see the top of the refrigerator, but you can't reach it.

On the table is a timer.

>stand on stool
Kitchen (on the stool)
You are standing on a small stool in the kitchen room of your burrow. From here you can clearly see the top of the refrigerator, but you can't reach it.

On the table is a timer.

* * *

>sit
You sit on the floor.

>stand on stool
Kitchen (on the stool)
You are standing on a small stool in the kitchen room of your burrow. From here you can clearly see the top of the refrigerator, but you can't reach it.

On the table is a timer.

* * *

>jump
You jump as high as you can, but you can't quite reach the top of the refrigerator.

>stand on tiptoe
Try as you might, you still can't reach the crate.

* * *

>stand on table
That's not something you can stand on.

* * *

>rules on
Rules tracing now switched on. Type "rules off" to switch it off again, or "rules all" to include even rules which do not apply.

>climb fridge
[Rule "declare everything initially unmentioned rule" applies.]
[Rule "announce items from multiple object lists rule" applies.]
[Rule "set pronouns from items from multiple object lists rule" applies.]
[Rule "before stage rule" applies.]
[Rule "instead stage rule" applies.]
[Rule "investigate player's awareness before action rule" applies.]
[Rule "player aware of his own actions rule" applies.]
[Rule "check stage rule" applies.]
[Rule "block climbing rule" applies.]
Little is to be achieved by that.

[Rule "A first turn sequence rule" applies.]
[Rule "every turn stage rule" applies.]
[Rule "A last turn sequence rule" applies.]
[Rule "notify score changes rule" applies.]

* * *

>rules on
Rules tracing now switched on. Type "rules off" to switch it off again, or "rules all" to include even rules which do not apply.

>clean hands
[Rule "declare everything initially unmentioned rule" applies.]
[Rule "announce items from multiple object lists rule" applies.]
[Rule "set pronouns from items from multiple object lists rule" applies.]
[Rule "before stage rule" applies.]
[Rule "instead stage rule" applies.]
[Rule "investigate player's awareness before action rule" applies.]
[Rule "player aware of his own actions rule" applies.]
[Rule "check stage rule" applies.]
[Rule "can't rub another person rule" applies.]
[Rule "carry out stage rule" applies.]
[Rule "after stage rule" applies.]
[Rule "investigate player's awareness after action rule" applies.]
[Rule "report stage rule" applies.]
[Rule "report rubbing rule" applies.]
You rub your hands.
[Rule "last specific action-processing rule" applies.]

[Rule "A first turn sequence rule" applies.]
[Rule "every turn stage rule" applies.]
[Rule "A last turn sequence rule" applies.]
[Rule "notify score changes rule" applies.]

* * *

>touch water
You feel nothing unexpected.

>touch stream
It's wet.

* * *

>push switch
That's already off.

>push switch
That's already off.

>rotate dial
Nothing obvious happens.

* * *

>rotate dial
The red light flickers on, but the plate doesn't appear to be emitting any heat. You turn it back off.

* * *

>turn timer
You set the timer for 15 minutes.

>twist dial
The red light flickers on, but the plate doesn't appear to be emitting any heat. You turn it back off.

* * *

>push stool
You move the stool out of the way.

>pull stool
You move the stool out of the way.

>move stool
You move the stool out of the way.

>rules on
Rules tracing now switched on. Type "rules off" to switch it off again, or "rules all" to include even rules which do not apply.

>move
[Rule "Does the player mean doing anything with the top of the refrigerator" applies.]
(the stool)
[Rule "declare everything initially unmentioned rule" applies.]
[Rule "announce items from multiple object lists rule" applies.]
[Rule "set pronouns from items from multiple object lists rule" applies.]
[Rule "before stage rule" applies.]
[Rule "instead stage rule" applies.]
[Rule "Instead of pushing the stool" applies.]
You move the stool out of the way.

[Rule "A first turn sequence rule" applies.]
[Rule "every turn stage rule" applies.]
[Rule "A last turn sequence rule" applies.]
[Rule "notify score changes rule" applies.]

* * *

>move stool to stream
You move the stool to the stream.

>move stool to fridge
You place the stool in front of the refrigerator.

* * *

>count e
You must name something more substantial.

* * *

>count me
There is just one of those.

>count cookies
You can't see any such thing.

>count flour
You can't see any such thing.

>count timer
There is just one of those.

* * *

>clean
(the stool)
You rub the stool.

* * *

>clean hands
You need soap to wash up with.

>wash hands
You need soap to wash up with.

* * *

>preheat oven
You switch the oven on.

>take potholder
Taken.

>open oven
You open the oven, revealing a baking sheet.

>take pan
You carefully pick up the baking sheet with the potholder.

>put pan on table
You should put something insulating under the pan to protect the table.

You put the baking sheet on the table.

>put pan on oven
You should put something insulating under the pan to protect the oven.

(first taking the baking sheet)
You carefully pick up the baking sheet with the potholder.

Putting things on the oven would achieve nothing.

>put towel on table
(first taking the towel)
You put the towel on the table.

>put pan on towel
You should put something insulating under the pan to protect the towel.

Putting things on the towel would achieve nothing.

>put pan on table
You put the baking sheet on the table.

* * *

>open fridge.get egg
You open the mini refrigerator, revealing a carton of milk, a stick of butter, and an egg.

Taken.

>crack egg
You crack the egg into the bowl
You can't reach that from here.

* * *

>abstract coffee mug to me
[Abstracted.]

>abstract egg to me
[Abstracted.]

>break egg
You crack the egg into the coffee mug.

>abstract bowl to me
[Abstracted.]

>pour egg into bowl
(first taking the egg)
You pour the cracked egg into the mixing bowl.

>undo
Kitchen
[Previous turn undone.]

>pour  mug into bowl
(first taking the egg)
You pour the cracked egg into the mixing bowl.

>restart
Are you sure you want to restart?

* * *

>abstract egg to me
[Abstracted.]

>break egg
You'll need something to crack that into.

* * *

>crack egg into hair
You can't see any such thing.

* * *

>take water
That seems to be a part of the stream.

>take water with mug
I only understood you as far as wanting to take the water.

>abstract mug to me
[Abstracted.]

>put water in cup
(first taking the water)
That seems to be a part of the stream.

>drink water
You scoop up water into the coffee mug and drink it all down.

>put mug in water
That can't contain things.

>put mug ins tream
You can't see any such thing.

>put mug in stream
Careful! You might lose that if you put it in the water.

>wash flour
You can't see any such thing.

* * *

>put water in mug
You can't reach that from here.

>abstract mug to me
[Abstracted.]

>put water in mug
(first taking the water)
That seems to be a part of the stream.

>put water in bowl
That's not an ingredient!

You can't reach that from here.

>eat mug
That's plainly inedible.

* * *

>abstract bowl and mug to me
[Abstracted.]
[Abstracted.]

>put water in bowl
You don't need water for this recipe.

>drink water
You scoop up water into the coffee mug and drink it all down.

>eat water
You scoop up water into the coffee mug and drink it all down.

* * *

>put water in bowl
You don't need water for this recipe.

>put water in mug
(first taking the water)
That seems to be a part of the stream.

* * *

>sniff
You smell nothing unexpected.

>smell
You smell nothing unexpected.

* * *

>abstract cup to me
[Abstracted.]

>put egg in cup
You can't see any such thing.

>abstract egg to me
[Abstracted.]

>put egg in cup
You put the egg into the coffee mug.

>abstract butter to me
[Abstracted.]

>put butter in cup
The coffee mug isn't empty.

>take egg
Taken.

>put butter in cup
You put the stick of butter into the coffee mug.

>crack egg in cup
I only understood you as far as wanting to crack the egg.

>crack egg into cup
I only understood you as far as wanting to crack the egg.

>crack egg
You can crack that into the coffee mug, but it needs to be empty first.

* * *

>about
Baking with Lizzie was created for the Short and Sweet Jam.

Beta testers: Brett Witty, Angela Chang, Seth Alter, Tim Adan, Dan Barton, Chester Kwan

* * *

>items
That's not a verb I recognize.

>things
That's not a verb I recognize.

>showall
That's not a verb I recognize.

>showme
Kitchen - room
    yourself - person
        your hands (part of yourself)
    floor
        rug (part of floor)
            corner (part of rug)
    ceiling
    walls
    lamp
    table - supporter
        cabinets (part of table) - closed container
            *bag of brown sugar - ingredient
            *box of white sugar - ingredient
            *bottle of vanilla extract - ingredient
            *bag of chocolate chips - ingredient
            *bag of flour - ingredient
            *carton of baking soda - ingredient
            *container of salt - ingredient
        timer
    mini refrigerator - closed container
        top of the refrigerator (part of mini refrigerator) - supporter
        hooks (part of mini refrigerator) - supporter
            apron
                pocket (part of apron) - closed container
                    *bar of soap
            potholder
            towel
            crate - open container
                coffee mug - open container
                mixing bowl - open container
        *carton of milk
        *stick of butter - ingredient
        *egg - ingredient
    stream
        water (part of stream)
    stool - supporter
    oven - closed container
        switch (part of oven)
        *baking sheet - supporter
    hot plate - supporter
        red light (part of hot plate)
        dial (part of hot plate)
* denotes things which are not in scope

* * *

>look under table
There are cabinets underneath the table.

>look under fridge
You find nothing of interest.

>smell
You smell nothing unexpected.

* * *

>smell
You smell nothing in particular.

>test getall
(Testing.)

>[1] look under rug
You look under the rug and find a recipe card.

>[2] get card
Taken.

>[3] open fridge
You open the mini refrigerator, revealing a carton of milk, a stick of butter, and an egg.

>[4] open cabinet
You open the cabinets, revealing a bag of brown sugar, a box of white sugar, a bottle of vanilla extract, a bag of chocolate chips, a bag of flour, a carton of baking soda, and a container of salt.

>[5] take all
timer: Taken.
bag of brown sugar: Taken.
box of white sugar: Taken.
bottle of vanilla extract: Taken.
bag of chocolate chips: Taken.
bag of flour: Taken.
carton of baking soda: Taken.
container of salt: Taken.
carton of milk: Taken.
stick of butter: Taken.
egg: Taken.
crate: You can't reach that from down here.
coffee mug: You can't reach that from down here.
mixing bowl: You can't reach that from down here.
apron: Taken.
potholder: Taken.
towel: Taken.

>[6] push stool to fridge
You place the stool in front of the refrigerator.

>[7] up
Kitchen (on the stool)
You are standing on a small stool in the kitchen room of your burrow. From here you can clearly see the top of the refrigerator.

>[8] take crate
Taken.

>[9] down
You get off the stool.

Kitchen
You are standing in the kitchen area of your burrow. There is a small oven, a single hot plate, and a mini refrigerator. There is also a low, raccoon-sized table, under which are a set of cabinets. A small stream runs through one end of the room. A lamp, about the same height as you, illuminates the room. There is a colorful rug on the floor.

You can see a stool here.

>[10] open oven
You open the oven, revealing a baking sheet.

>[11] take sheet
Taken.

>test ingredients
(Testing.)

>[1] put butter in mug
You put the stick of butter into the coffee mug.

>[2] melt butter on lamp
The butter melts into a puddle.

>[3] break egg
You crack the egg into the bowl.

>[4] put egg in bowl
(first taking the egg)
It would be difficult to take that back.

>[5] put butter in bowl
You put the stick of melted butter into the mixing bowl.

>[6] put white in bowl
You put the scoop of white sugar into the mixing bowl.

>[7] put brown in bowl
You put the scoop of brown sugar into the mixing bowl.

>[8] put flour in bowl
You put the scoop of flour into the mixing bowl.

>[9] put salt in bowl
You put the pinch of salt into the mixing bowl.

>[10] put soda in bowl
You put the pinch of baking soda into the mixing bowl.

>[11] put chips in bowl
You put the entire bag of chocolate chips into the mixing bowl.

>[12] put vanilla in bowl
You put the tablespoon of vanilla extract into the mixing bowl.

You mix the ingredients with your hands until you have a good dough.

>test baking
(Testing.)

>[1] roll dough into balls
You roll out balls of dough and place them on the baking sheet.

>[2] preheat oven
You switch the oven on.

>[3] put cookies in oven
You put the pan of cookies into the oven and close the door.

>[4] set timer
You set the timer for 15 minutes.

* * *

>wait 15
The timer dings! Your whiskers twitch excitedly!

You whistle a happy tune while you wait.

>smell
You smell nothing in particular.

* * *

>take stool
It's too heavy to carry, but it can be pushed around.

* * *

>abstract bowl to me
[Abstracted.]

>wash bowl
You need soap to wash up with.

>open cabinet.take flour
You open the cabinets, revealing a bag of brown sugar, a box of white sugar, a bottle of vanilla extract, a bag of chocolate chips, a bag of flour, a carton of baking soda, and a container of salt.

Taken.

>put flour in bowl
You put the scoop of flour into the mixing bowl.

>wash bowl
You can't wash that until it's empty!

* * *

>x corner
Something seems to be tucked under the rug here.

>look under rug
You look under the rug and find a recipe card.

>take card
Taken.

>read card
Lizzie's Chocolate Chip Cookies

 melted stick of butter
 brown sugar
 white sugar
 an egg
 vanilla extract
 bag of chocolate chips
 flour
 baking soda
 salt

 Preheat oven.
 Mix ingredients together in a large bowl.
 Roll dough into balls and place on pan.
 Place pan in oven.
 Set the timer to 15 minutes.

 Don't forget to wash up afterwards!

* * *

>x corner
Something seems to be tucked under the rug here.

>x rug
It's a very colorful woven rug. One corner is flipped up.

>flip corner
You flip the corner back.

>x rug
It's a very colorful woven rug.

>x corner
Something seems to be tucked under the rug here.

>lift corner
You look under the rug and find a recipe card.

>x corner
The rug has four corners.

>x rug
It's a very colorful woven rug.

* * *

>look on top of fridge
You can't see any such thing.

>look at top of fridge
There is a crate on top of the refrigerator.

On the top of the refrigerator is a crate (in which are a coffee mug (empty) and a mixing bowl (empty)).

>look on fridge
You can't see any such thing.

* * *

>x fridge
It's a mini refrigerator, such as one might find in a dorm room. There is a magnet on the front. On the right side is glued a set of hooks, on which are an apron, a potholder, and a towel. There is a crate on top of the refrigerator.

>x magnet
It says "I <3 baking!"

>take magnet
It looks good where it is.

>take hooks
Those seem to be a part of the mini refrigerator.

* * *

>x fridge
It's a mini refrigerator, such as one might find in a dorm room. There is a magnet on the front. On the right side is glued a set of hooks, on which are an apron, a potholder, and a towel. There is a crate on top of the refrigerator.

>abstract crate to me
[Abstracted.]

>x fridge
It's a mini refrigerator, such as one might find in a dorm room. There is a magnet on the front. On the right side is glued a set of hooks, on which are an apron, a potholder, and a towel.

>undo
Kitchen
[Previous turn undone.]

>x top of fridge
Thereis nothing on top of the refrigerator.

* * *

>x fridge
It's a mini refrigerator, such as one might find in a dorm room. There is a magnet on the front. On the right side is glued a set of hooks, on which are an apron, a potholder, and a towel.

>abstract mug to top of fridge
[Abstracted.]

>x fridge
It's a mini refrigerator, such as one might find in a dorm room. There is a magnet on the front. On the right side is glued a set of hooks, on which are an apron, a potholder, and a towel. There is a coffee mug on top of the refrigerator.

>take apron
Taken.

>take potholder
Taken.

>x hooks
A set of white plastic hooks, glued to the side of the refrigerator.

On the hooks is a towel.

>x fridge
It's a mini refrigerator, such as one might find in a dorm room. There is a magnet on the front. On the right side is glued a set of hooks, on which are a towel. There is a coffee mug on top of the refrigerator.

* * *

>x fridge
It's a mini refrigerator, such as one might find in a dorm room. There is a magnet on the front. On the right side is glued a set of hooks, on which are an apron, a potholder, and a towel. There is a crate on top of the refrigerator.

>take apron
Taken.

>take towel
Taken.

>x fridge
It's a mini refrigerator, such as one might find in a dorm room. There is a magnet on the front. On the right side is glued a set of hooks, on which is a potholder. There is a crate on top of the refrigerator.

>take potholder
Taken.

>x fridge
It's a mini refrigerator, such as one might find in a dorm room. There is a magnet on the front. On the right side is glued a set of hooks, which currently hold nothing. There is a crate on top of the refrigerator.

>x hooks
A set of white plastic hooks, glued to the side of the refrigerator.

* * *

>x fridge
It's a mini refrigerator, such as one might find in a dorm room. There is a magnet on the front. On the right side is glued a set of hooks, on which are an apron, a potholder, and a towel. There is a crate on top of the refrigerator.

>open fridge
You open the mini refrigerator, revealing a carton of milk, a stick of butter, and an egg.

>open refrigerator
(the mini refrigerator)
That's already open.

>x top of fridge
On the top of the refrigerator is a crate (in which are a coffee mug (empty) and a mixing bowl (empty)).

>x refrigerator
(the mini refrigerator)
It's a mini refrigerator, such as one might find in a dorm room. There is a magnet on the front. On the right side is glued a set of hooks, on which are an apron, a potholder, and a towel. There is a crate on top of the refrigerator.

In the mini refrigerator are a carton of milk, a stick of butter, and an egg.

* * *

>x fridge
It's a mini refrigerator, such as one might find in a dorm room. There is a magnet on the front. On the right side is glued a set of hooks, on which are an apron, a potholder, and a towel. There is a crate on top of the refrigerator.

>x refrigerator
It's a mini refrigerator, such as one might find in a dorm room. There is a magnet on the front. On the right side is glued a set of hooks, on which are an apron, a potholder, and a towel. There is a crate on top of the refrigerator.

>x top
On the top of the fridge is a crate (empty).

>x top of the fridge
On the top of the fridge is a crate (empty).

* * *

>x fridge
It's a mini refrigerator, such as one might find in a dorm room. There is a magnet on the front. On the right side is glued a set of hooks, on which are an apron, a potholder, and a towel. There is a crate on top of the refrigerator.

>x top of fridge
On the top of the icebox is a crate (empty).

* * *

>take hooks
They're glued pretty well to the side of the refrigerator.

>take fridge
That's hardly portable.

>take top of fridge
That seems to be a part of the mini refrigerator.

>rules on
Rules tracing now switched on. Type "rules off" to switch it off again, or "rules all" to include even rules which do not apply.

>look on fridge
You can't see any such thing.

>look on top of fridge
You can't see any such thing.

>look top of fridge
[Rule "declare everything initially unmentioned rule" applies.]
[Rule "announce items from multiple object lists rule" applies.]
[Rule "set pronouns from items from multiple object lists rule" applies.]
[Rule "before stage rule" applies.]
[Rule "can't act in the dark rule" applies.]
[Rule "instead stage rule" applies.]
[Rule "investigate player's awareness before action rule" applies.]
[Rule "player aware of his own actions rule" applies.]
[Rule "check stage rule" applies.]
[Rule "carry out stage rule" applies.]
[Rule "standard examining rule" applies.]
There is a crate on top of the refrigerator.

[Rule "examine directions rule" applies.]
[Rule "examine containers rule" applies.]
[Rule "examine supporters rule" applies.]
On the top of the refrigerator is a crate (in which are a coffee mug (empty) and a mixing bowl (empty)).

[Rule "examine devices rule" applies.]
[Rule "examine undescribed things rule" applies.]
[Rule "after stage rule" applies.]
[Rule "investigate player's awareness after action rule" applies.]
[Rule "report stage rule" applies.]
[Rule "report other people examining rule" applies.]
[Rule "last specific action-processing rule" applies.]
[Rule "A first turn sequence rule" applies.]
[Rule "every turn stage rule" applies.]
[Rule "A last turn sequence rule" applies.]
[Rule "notify score changes rule" applies.]

* * *

>x top of fridge
On the top of the refrigerator is a crate (in which are a coffee mug (empty) and a mixing bowl (empty)).

>abstract crate to me
[Abstracted.]

>x top of fridge
You see nothing special about the top of the refrigerator.

>abstract mug to top of fridge
[Abstracted.]

>x top of fridge
On the top of the refrigerator is a coffee mug (empty).

* * *

>abstract butter to me
[Abstracted.]

>open oven
You open the oven, revealing a baking sheet.

>put butter on sheet
The butter would just melt into a puddle all over the baking sheet.

* * *

>abstract butter to me
[Abstracted.]

>put butter in oven
It would melt all over the inside of the oven!

>put butter on hot plate
It would melt all over!

>put butter on lamp
You can't melt that in your hands!

* * *

>move corner
You look under the rug and find a recipe card.

>undo
Kitchen
[Previous turn undone.]

>push corner
You look under the rug and find a recipe card.

>undo
Kitchen
[Previous turn undone.]

>pull corner
You look under the rug and find a recipe card.

* * *

>push stool away
You move the stool out of the way.

>move stool away
You move the stool out of the way.

* * *

>push stool away from fridge
You move the stool out of the way.

* * *

>x refrigerator
(the mini refrigerator)
It's a mini refrigerator, such as one might find in a dorm room. There is a magnet on the front. On the right side is glued a set of hooks, on which are an apron, a potholder, and a towel. There is a crate on top of the refrigerator.

* * *

>mix
(the mixing bowl)
There is nothing in the bowl yet.

* * *

>take timer
Taken.

>place timer on table
You can't see any such thing.

>place
(the stool in front of the timer)
You move the stool to the timer.

* * *

>place
That's not a verb I recognize.

* * *

>stand
You are not sitting down.

>sit
You sit on the floor.

>stand
You stand up.

>sit
You sit on the floor.

>sit
You sit on the floor.

* * *

>stand
You stand up.

>sit on stool
You sit on the stool.

>stand
You stand up.

* * *

>extract salt to me
That's not a verb I recognize.

>abstract salt to me
[Abstracted.]

>pour salt in bowl
You can't reach that from here.

* * *

>x crate
It's a wooden crate.

>x mug
A ceramic coffee mug with a butterfly on it.

* * *

>x crate
It's a wooden crate.

>up
Kitchen (on the stool)
You are standing on a small stool in the kitchen. From here you can clearly see the top of the refrigerator, but you can't reach it.

On the table is a timer.

>x crate
It's a wooden crate.

In the crate are a coffee mug and a mixing bowl.

>look in crate
The crate is empty.

* * *

>x crate
It's a wooden crate.

In the crate are a coffee mug and a mixing bowl.

>i
You are carrying nothing.

>test getall
(Testing.)

>[1] look under rug
You look under the rug and find a recipe card.

>[2] get card
You can't reach that from up here.

>[3] open fridge
You open the mini refrigerator, revealing a carton of milk, a stick of butter, and an egg.

>[4] open cabinet
You open the cabinets, revealing a bag of brown sugar, a box of white sugar, a bottle of vanilla extract, a bag of chocolate chips, a bag of flour, a carton of baking soda, and a container of salt.

>[5] take all
recipe card: You can't reach that from up here.
timer: You can't reach that from up here.
bag of brown sugar: You can't reach that from up here.
box of white sugar: You can't reach that from up here.
bottle of vanilla extract: You can't reach that from up here.
bag of chocolate chips: You can't reach that from up here.
bag of flour: You can't reach that from up here.
carton of baking soda: You can't reach that from up here.
container of salt: You can't reach that from up here.
carton of milk: You can't reach that from up here.
stick of butter: You can't reach that from up here.
egg: You can't reach that from up here.
crate: You can't quite reach that from here. Maybe if you got closer?
coffee mug: You can't quite reach that from here. Maybe if you got closer?
mixing bowl: You can't quite reach that from here. Maybe if you got closer?
apron: You can't reach that from up here.
potholder: You can't reach that from up here.
towel: You can't reach that from up here.

>[6] push stool to fridge
You can't move the stool while you're on it.

>[7] up
You can't go any higher.

>[8] take crate
You can't quite reach that from here. Maybe if you got closer?

>[9] down
You get off the stool.

Kitchen
You are standing in your kitchen. There is a small oven, a single hot plate, and a mini refrigerator. There is also a low, raccoon-sized table, under which are a set of cabinets. A small stream runs through one end of the room. A lamp, about the same height as you, illuminates the room. There is a colorful rug on the floor.

On the table is a timer.

You can also see a recipe card and a stool here.

>[10] open oven
You open the oven, revealing a baking sheet.

>[11] take sheet
Taken.

>i
You are carrying:
  a baking sheet

>restart
Are you sure you want to restart?

>y
Cannot open file
Attempt to begin transcript failed.

You can annotate the transcript by prefixing your comment with *

Your friends are arriving soon, and you need to bake a batch of cookies! Now where is that recipe card...?

Baking with Lizzie
A sweet story by Adri
Release 1 / Serial number 170821 / Inform 7 build 6M62 (I6/v6.33 lib 6/12N) SD

Kitchen
You are standing in your kitchen. There is a small oven, a single hot plate, and a mini refrigerator. There is also a low, raccoon-sized table, under which are a set of cabinets. A small stream runs through one end of the room. A lamp, about the same height as you, illuminates the room. There is a colorful rug on the floor.

On the table is a timer.

You can also see a stool here.

>test getall
(Testing.)

>[1] look under rug
You look under the rug and find a recipe card.

>[2] get card
Taken.

>[3] open fridge
You open the mini refrigerator, revealing a carton of milk, a stick of butter, and an egg.

>[4] open cabinet
You open the cabinets, revealing a bag of brown sugar, a box of white sugar, a bottle of vanilla extract, a bag of chocolate chips, a bag of flour, a carton of baking soda, and a container of salt.

>[5] take all
timer: Taken.
bag of brown sugar: Taken.
box of white sugar: Taken.
bottle of vanilla extract: Taken.
bag of chocolate chips: Taken.
bag of flour: Taken.
carton of baking soda: Taken.
container of salt: Taken.
carton of milk: Taken.
stick of butter: Taken.
egg: Taken.
crate: You can't reach that from down here.
apron: Taken.
potholder: Taken.
towel: Taken.

>[6] push stool to fridge
You place the stool in front of the refrigerator.

>[7] up
Kitchen (on the stool)
You are standing on a small stool in the kitchen. From here you can clearly see the top of the refrigerator.

>[8] take crate
Taken.

>[9] down
You get off the stool.

Kitchen
You are standing in your kitchen. There is a small oven, a single hot plate, and a mini refrigerator. There is also a low, raccoon-sized table, under which are a set of cabinets. A small stream runs through one end of the room. A lamp, about the same height as you, illuminates the room. There is a colorful rug on the floor.

You can see a stool here.

>[10] open oven
You open the oven, revealing a baking sheet.

>[11] take sheet
Taken.

* * *

>i
You are carrying:
  a baking sheet
  a crate
    a coffee mug
    a mixing bowl
  a towel
  a potholder
  an apron
  an egg
  a stick of butter
  a carton of milk
  a container of salt
  a carton of baking soda
  a bag of flour
  a bag of chocolate chips
  a bottle of vanilla extract
  a box of white sugar
  a bag of brown sugar
  a timer
  a recipe card

>x crate
It's a wooden crate containing assorted cooking implements.

>look in crate
In the crate are a coffee mug and a mixing bowl.

>test ingredients
(Testing.)

>[1] put butter in mug
You put the stick of butter into the coffee mug.

>[2] melt butter on lamp
The butter melts.

>[3] break egg
You crack the egg into the bowl.

>[4] put egg in bowl
(first taking the egg)
It would be difficult to take that back.

>[5] put butter in bowl
You put the stick of melted butter into the mixing bowl.

>[6] put white in bowl
You put the scoop of white sugar into the mixing bowl.

>[7] put brown in bowl
You put the scoop of brown sugar into the mixing bowl.

>[8] put flour in bowl
You put the scoop of flour into the mixing bowl.

>[9] put salt in bowl
You put the pinch of salt into the mixing bowl.

>[10] put soda in bowl
You put the pinch of baking soda into the mixing bowl.

>[11] put chips in bowl
You put the entire bag of chocolate chips into the mixing bowl.

>[12] put vanilla in bowl
You put the tablespoon of vanilla extract into the mixing bowl.

You mix the ingredients with your hands until you have a good dough.

* * *

>up
Kitchen (on the stool)
You are standing on a small stool in the kitchen. From here you can clearly see the top of the refrigerator, but you can't reach it.

On the table is a timer.

>look in crate
In the crate are a coffee mug and a mixing bowl.

>x crate
It's a plastic crate containing assorted cooking implements.

In the crate are a coffee mug and a mixing bowl.

>push stool
You move the stool out of the way.

* * *

>x crate
It's a wooden crate.

>x top
On the top of the icebox is a crate (closed).

* * *

>x crate
It's a wooden crate.

>look in crate
The crate is empty.

>search crate
The crate is empty.

* * *

>x mug
You can't see any such thing.

>take all
timer: Taken.
crate: You can't reach that from down here.
apron: Taken.
potholder: Taken.
towel: Taken.

>x crate
It's a plastic crate containing assorted cooking implements.

>climb stool
You are standing on a small stool in the kitchen. From here you can clearly see the top of the refrigerator, but you can't reach it.

>x crate
It's a plastic crate containing assorted cooking implements.

>down
You get off the stool.

Kitchen
You are standing in your kitchen. There is a small oven, a single hot plate, and a mini refrigerator. There is also a low, raccoon-sized table, under which are a set of cabinets. A small stream runs through one end of the room. A lamp, about the same height as you, illuminates the room. There is a colorful rug on the floor.

You can see a stool here.

>push stool to fridge
You place the stool in front of the refrigerator.

>up
You are standing on a small stool in the kitchen. From here you can clearly see the top of the refrigerator.

>x crate
It's a plastic crate containing assorted cooking implements.

>look in crate
The crate is empty.

* * *

>x mug
You can't see any such thing.

>x crate
It's a plastic crate containing assorted cooking implements.

>up
You are standing on a small stool in the kitchen. From here you can clearly see the top of the refrigerator, but you can't reach it.

>x crate
It's a plastic crate containing assorted cooking implements.

In the crate are a coffee mug and a mixing bowl.

>x mug
A ceramic coffee mug with a butterfly on it.

>down
You get off the stool.

Kitchen
You are standing in your kitchen. There is a small oven, a single hot plate, and a mini refrigerator. There is also a low, raccoon-sized table, under which are a set of cabinets. A small stream runs through one end of the room. A lamp, about the same height as you, illuminates the room. There is a colorful rug on the floor.

On the table is a timer.

You can also see a stool here.

>x mug
A ceramic coffee mug with a butterfly on it.

>x crate
It's a plastic crate containing assorted cooking implements.

* * *

>up
You are standing on a small stool in the kitchen. From here you can clearly see the top of the refrigerator, but you can't reach it.

>push crate
Nothing obvious happens.

>push stool
You move the stool out of the way.

* * *

>x crate
It's a plastic crate containing assorted cooking implements.

* * *

>up
You are standing on a small stool in the kitchen. From here you can clearly see the top of the refrigerator, but you can't reach it.

>x crate
It's a plastic crate containing assorted cooking implements.

* * *

>look in crate
The crate is empty.

>rules on
Rules tracing now switched on. Type "rules off" to switch it off again, or "rules all" to include even rules which do not apply.

>up
[Rule "declare everything initially unmentioned rule" applies.]
[Rule "standard set going variables rule" applies.]
[Rule "announce items from multiple object lists rule" applies.]
[Rule "set pronouns from items from multiple object lists rule" applies.]
[Rule "before stage rule" applies.]
[Rule "instead stage rule" applies.]
[Rule "investigate player's awareness before action rule" applies.]
[Rule "player aware of his own actions rule" applies.]
[Rule "check stage rule" applies.]
[Rule "Check going up when the player is on the stool" applies.]
You can't go any higher.

[Rule "A first turn sequence rule" applies.]
[Rule "every turn stage rule" applies.]
[Rule "A last turn sequence rule" applies.]
[Rule "notify score changes rule" applies.]

* * *

>up
[Rule "declare everything initially unmentioned rule" applies.]
[Rule "standard set going variables rule" applies.]
[Rule "announce items from multiple object lists rule" applies.]
[Rule "set pronouns from items from multiple object lists rule" applies.]
[Rule "before stage rule" applies.]
[Rule "Before going up when the player is not on the stool" applies.]
[Rule "announce items from multiple object lists rule" applies.]
[Rule "set pronouns from items from multiple object lists rule" applies.]
[Rule "before stage rule" applies.]
[Rule "Before climbing the stool" applies.]
[Rule "instead stage rule" applies.]
[Rule "Instead of climbing the stool" applies.]
[Rule "determine visibility ceiling rule" applies.]
[Rule "announce items from multiple object lists rule" applies.]
[Rule "set pronouns from items from multiple object lists rule" applies.]
[Rule "before stage rule" applies.]
[Rule "instead stage rule" applies.]
[Rule "investigate player's awareness before action rule" applies.]
[Rule "player aware of his own actions rule" applies.]
[Rule "check stage rule" applies.]
[Rule "Check looking" applies.]
You are standing on a small stool in the kitchen. From here you can clearly see the top of the refrigerator, but you can't reach it.

[Rule "A first turn sequence rule" applies.]
[Rule "every turn stage rule" applies.]
[Rule "A last turn sequence rule" applies.]
[Rule "notify score changes rule" applies.]

>x crate
[Rule "declare everything initially unmentioned rule" applies.]
[Rule "announce items from multiple object lists rule" applies.]
[Rule "set pronouns from items from multiple object lists rule" applies.]
[Rule "before stage rule" applies.]
[Rule "can't act in the dark rule" applies.]
[Rule "instead stage rule" applies.]
[Rule "investigate player's awareness before action rule" applies.]
[Rule "player aware of his own actions rule" applies.]
[Rule "check stage rule" applies.]
[Rule "carry out stage rule" applies.]
[Rule "standard examining rule" applies.]
It's a plastic crate containing assorted cooking implements.

[Rule "examine directions rule" applies.]
[Rule "examine containers rule" applies.]
[Rule "examine supporters rule" applies.]
[Rule "examine devices rule" applies.]
[Rule "examine undescribed things rule" applies.]
[Rule "after stage rule" applies.]
[Rule "investigate player's awareness after action rule" applies.]
[Rule "report stage rule" applies.]
[Rule "report other people examining rule" applies.]
[Rule "last specific action-processing rule" applies.]
[Rule "A first turn sequence rule" applies.]
[Rule "every turn stage rule" applies.]
[Rule "A last turn sequence rule" applies.]
[Rule "notify score changes rule" applies.]

>look in crate
[Rule "declare everything initially unmentioned rule" applies.]
[Rule "announce items from multiple object lists rule" applies.]
[Rule "set pronouns from items from multiple object lists rule" applies.]
[Rule "before stage rule" applies.]
[Rule "can't act in the dark rule" applies.]
[Rule "instead stage rule" applies.]
[Rule "investigate player's awareness before action rule" applies.]
[Rule "player aware of his own actions rule" applies.]
[Rule "check stage rule" applies.]
[Rule "can't search unless container or supporter rule" applies.]
[Rule "can't search closed opaque containers rule" applies.]
[Rule "carry out stage rule" applies.]
[Rule "after stage rule" applies.]
[Rule "investigate player's awareness after action rule" applies.]
[Rule "report stage rule" applies.]
[Rule "standard search containers rule" applies.]
The crate is empty.

[Rule "report other people searching rule" applies.]
[Rule "last specific action-processing rule" applies.]
[Rule "A first turn sequence rule" applies.]
[Rule "every turn stage rule" applies.]
[Rule "A last turn sequence rule" applies.]
[Rule "notify score changes rule" applies.]

* * *

>use timer
You set the timer for 15 minutes.

* * *

>drink out of cup
You can't see any such thing.

>abstract mug to me
[Abstracted.]

>drink mug
There's nothing suitable to drink here.

>drink out of mug
You can't see any such thing.

>drink out of carton
You can't see any such thing.

>abstract milk to me
[Abstracted.]

>drink out of carton
Were you raised in a barn?

* * *

>abstract mug and milk to me
[Abstracted.]
[Abstracted.]

>drink milk
You pour milk into the coffee mug and drink it all down.

>drink out of carton
Were you raised in a barn?

>drink out of mug
The mug is empty.

* * *

>drink
(the stool)
There's nothing suitable to drink here.

* * *

>test all
>--> The following tests are available:
'test getall'
'test ingredients'
'test baking'

>test getall
(Testing.)

>[1] look under rug
You look under the rug and find a recipe card.

>[2] get card
Taken.

>[3] open fridge
You open the mini refrigerator, revealing a carton of milk, a stick of butter, and an egg.

>[4] open cabinet
You open the cabinets, revealing a bag of brown sugar, a box of white sugar, a bottle of vanilla extract, a bag of chocolate chips, a bag of flour, a carton of baking soda, and a container of salt.

>[5] take all
timer: Taken.
bag of brown sugar: Taken.
box of white sugar: Taken.
bottle of vanilla extract: Taken.
bag of chocolate chips: Taken.
bag of flour: Taken.
carton of baking soda: Taken.
container of salt: Taken.
carton of milk: Taken.
stick of butter: Taken.
egg: Taken.
crate: You can't reach that from down here.
apron: Taken.
potholder: Taken.
towel: Taken.

>[6] push stool to fridge
You place the stool in front of the refrigerator.

>[7] up
Kitchen (on the stool)
You are standing on a small stool in the kitchen. From here you can clearly see the top of the refrigerator.

>[8] take crate
Taken.

>[9] down
You get off the stool.

Kitchen
You are standing in your kitchen. There is a small oven, a single hot plate, and a mini refrigerator. There is also a low, raccoon-sized table, under which are a set of cabinets. A small stream runs through one end of the room. A lamp, about the same height as you, illuminates the room. There is a colorful rug on the floor.

You can see a stool here.

>[10] open oven
You open the oven, revealing a baking sheet.

>[11] take sheet
Taken.

>test ingredients
(Testing.)

>[1] put butter in mug
You put the stick of butter into the coffee mug.

>[2] melt butter on lamp
The butter melts into a puddle.

>[3] break egg
You crack the egg into the bowl.

>[4] put egg in bowl
(first taking the egg)
It would be difficult to take that back.

>[5] put butter in bowl
You put the stick of melted butter into the mixing bowl.

>[6] put white in bowl
You put the scoop of white sugar into the mixing bowl.

>[7] put brown in bowl
You put the scoop of brown sugar into the mixing bowl.

>[8] put flour in bowl
You put the scoop of flour into the mixing bowl.

>[9] put salt in bowl
You put the pinch of salt into the mixing bowl.

>[10] put soda in bowl
You put the pinch of baking soda into the mixing bowl.

>[11] put chips in bowl
You put the entire bag of chocolate chips into the mixing bowl.

>[12] put vanilla in bowl
You put the tablespoon of vanilla extract into the mixing bowl.

You mix the ingredients with your hands until you have a good dough.

* * *

>test baking
(Testing.)

>[1] roll dough into balls
You roll out balls of dough and place them on the baking sheet.

>[2] preheat oven
You switch the oven on.

>[3] put cookies in oven
You put the pan of cookies into the oven and close the door.

>[4] set timer
You set the timer for 15 minutes.

>open oven
You open the oven, revealing a baking sheet.

* * *

>take sheet
You carefully pick up the baking sheet with the potholder.

>x sheet
A baking sheet.

On the baking sheet are some balls of dough.

>wait 15
The timer dings! Your whiskers twitch excitedly!

You whistle a happy tune while you wait.

>x sheet
A baking sheet.

On the baking sheet are some cookies.

* * *

>x dial
A small dial on the front of the hot plate. It is switched off.

>x switch
An on/off switch on the front. It is turned off.

* * *

>turn on hot plate
The red light flickers on, but the plate doesn't appear to be emitting any heat. You turn it back off.

>g
The red light flickers on, but the plate doesn't appear to be emitting any heat. You turn it back off.

>g
The red light flickers on, but the plate doesn't appear to be emitting any heat. You turn it back off.

>g
It is clearly broken.

* * *

>x sleep
You can't see any such thing.

I beg your pardon?

>sleep
You had a lot of coffee this morning. You aren't feeling particularly drowsy.

* * *

>go
You'll have to say which compass direction to go in.

>n
You can't go that way.

>e
You can't go that way.

>s
You can't go that way.

>w
You can't go that way.

>up
Kitchen (on the stool)
You are standing on a small stool in the kitchen. From here you can clearly see the top of the refrigerator, but you can't reach it.

On the table is a timer.

* * *

>down
You get off the stool.

Kitchen
You are standing in your kitchen. There is a small oven, a single hot plate, and a mini refrigerator. There is also a low, raccoon-sized table, under which are a set of cabinets. A small stream runs through one end of the room. A lamp, about the same height as you, illuminates the room. There is a colorful rug on the floor.

On the table is a timer.

You can also see a stool here.

>down
You can't go that way.

>exit
But you aren't in anything at the moment.

>out
But you aren't in anything at the moment.

>leave
But you aren't in anything at the moment.

>leave room
I only understood you as far as wanting to leave.

* * *

>x rug
It's a very colorful woven rug. One corner is flipped up.

>x corner
Something seems to be tucked under the rug here.

>flip rug
You flip the corner back.

>x corner
The rug has four corners.

>l
Kitchen
You are standing in your kitchen. There is a small oven, a single hot plate, and a mini refrigerator. There is also a low, raccoon-sized table, under which are a set of cabinets. A small stream runs through one end of the room. A lamp, about the same height as you, illuminates the room. There is a colorful rug on the floor.

On the table is a timer.

You can also see a stool here.

>x rug
It's a very colorful woven rug.

>x corner
The rug has four corners.

* * *

>x magnet
It says "I  baking!"

* * *

>x top
On the top of the icebox is a crate (empty).

>up
Kitchen (on the stool)
You are standing on a small stool in the kitchen. From here you can clearly see the top of the refrigerator, but you can't reach it.

On the table is a timer.

>x top
On the top of the icebox is a crate.

>x crate
It's a wooden crate containing assorted cooking implements.

In the crate are a coffee mug and a mixing bowl.

* * *

>x top
On the top of the icebox is a crate (empty).

>test getall
(Testing.)

>[1] look under rug
You look under the rug and find a recipe card.

>[2] get card
Taken.

>[3] open fridge
You open the mini refrigerator, revealing a carton of milk, a stick of butter, and an egg.

>[4] open cabinet
You open the cabinets, revealing a bag of brown sugar, a box of white sugar, a bottle of vanilla extract, a bag of chocolate chips, a bag of flour, a carton of baking soda, and a container of salt.

>[5] take all
timer: Taken.
bag of brown sugar: Taken.
box of white sugar: Taken.
bottle of vanilla extract: Taken.
bag of chocolate chips: Taken.
bag of flour: Taken.
carton of baking soda: Taken.
container of salt: Taken.
carton of milk: Taken.
stick of butter: Taken.
egg: Taken.
crate: You can't reach that from down here.
apron: Taken.
potholder: Taken.
towel: Taken.

>[6] push stool to fridge
You place the stool in front of the refrigerator.

>[7] up
Kitchen (on the stool)
You are standing on a small stool in the kitchen. From here you can clearly see the top of the refrigerator.

>[8] take crate
Taken.

>[9] down
You get off the stool.

Kitchen
You are standing in your kitchen. There is a small oven, a single hot plate, and a mini refrigerator. There is also a low, raccoon-sized table, under which are a set of cabinets. A small stream runs through one end of the room. A lamp, about the same height as you, illuminates the room. There is a colorful rug on the floor.

You can see a stool here.

>[10] open oven
You open the oven, revealing a baking sheet.

>[11] take sheet
Taken.

* * *

>flip switch
You switch the oven on.

>abstract butter to me
[Abstracted.]

* * *

>put butter in oven
It would melt all over the inside of the oven!

>undo
Kitchen
[Previous turn undone.]

>put butter on hot plate
It would melt all over!

>put butter on tray
You can't see any such thing.

>put butter on sheet
You can't see any such thing.

>abstract sheet to me
[Abstracted.]

>put butter on sheet
You put the stick of butter on the baking sheet.

>put sheet in oven
The butter would just melt into a puddle all over the baking sheet.

>undo
Kitchen
[Previous turn undone.]

>open oven
You open the oven.

>put butter on sheet
You put the stick of butter on the baking sheet.

>i
You are carrying:
  a baking sheet
    a stick of butter

>undo
Kitchen
[Previous turn undone.]

>i
You are carrying:
  a stick of butter

>open oven
You open the oven, revealing a baking sheet.

* * *

>put butter on sheet
The butter would just melt into a puddle all over the baking sheet.

>put butter on plate
It would melt all over!

>abstract bowl to me
[Abstracted.]

>melt bowl
You can't melt that.

* * *

>drink out of bottle
You can't see any such thing.

>test getall
(Testing.)

>[1] look under rug
You look under the rug and find a recipe card.

>[2] get card
Taken.

>[3] open fridge
You open the mini refrigerator, revealing a carton of milk, a stick of butter, and an egg.

>[4] open cabinet
You open the cabinets, revealing a bag of brown sugar, a box of white sugar, a bottle of vanilla extract, a bag of chocolate chips, a bag of flour, a carton of baking soda, and a container of salt.

>[5] take all
timer: Taken.
bag of brown sugar: Taken.
box of white sugar: Taken.
bottle of vanilla extract: Taken.
bag of chocolate chips: Taken.
bag of flour: Taken.
carton of baking soda: Taken.
container of salt: Taken.
carton of milk: Taken.
stick of butter: Taken.
egg: Taken.
crate: You can't reach that from down here.
apron: Taken.
potholder: Taken.
towel: Taken.

>[6] push stool to fridge
You place the stool in front of the refrigerator.

>[7] up
Kitchen (on the stool)
You are standing on a small stool in the kitchen. From here you can clearly see the top of the refrigerator.

>[8] take crate
Taken.

>[9] down
You get off the stool.

Kitchen
You are standing in your kitchen. There is a small oven, a single hot plate, and a mini refrigerator. There is also a low, raccoon-sized table, under which are a set of cabinets. A small stream runs through one end of the room. A lamp, about the same height as you, illuminates the room. There is a colorful rug on the floor.

You can see a stool here.

>[10] open oven
You open the oven, revealing a baking sheet.

>[11] take sheet
Taken.

>drink out of bottle
You gulp down a mouthful of vanilla extract. It burns.

>clear
What do you want to clear?

>screen
You can't see any such thing.

>restart
Are you sure you want to restart?

* * *

>i
You are carrying:
  a baking sheet
  a crate
  a towel
  a potholder
  an apron
  an egg
  a stick of butter
  a carton of milk
  a container of salt
  a carton of baking soda
  a bag of flour
  a bag of chocolate chips
  a bottle of vanilla extract
  a box of white sugar
  a bag of brown sugar
  a timer
  a recipe card

>x crate
It's a wooden crate containing assorted cooking implements.

* * *

>look in crate
In the crate are a coffee mug and a mixing bowl.

>x crate
It's a wooden crate containing assorted cooking implements.

>i
You are carrying:
  a baking sheet
  a crate
  a towel
  a potholder
  an apron
  an egg
  a stick of butter
  a carton of milk
  a container of salt
  a carton of baking soda
  a bag of flour
  a bag of chocolate chips
  a bottle of vanilla extract
  a box of white sugar
  a bag of brown sugar
  a timer
  a recipe card

* * *

>abstract sheet to me. open oven
[Abstracted.]
You open the oven.

>put sheet in oven
You put the baking sheet into the oven.

>put butter in oven
You can't see any such thing.

>abstract butter to me
[Abstracted.]

* * *

>put butter in oven
It would melt all over the inside of the oven!

>put potholder in oven
(first taking the potholder)
You put the potholder into the oven.

>restart
Are you sure you want to restart?

* * *

>i
You are carrying:
  a crate
    a coffee mug
    a mixing bowl
  a towel
  a potholder
  an apron
  a carton of milk
  a timer
  a recipe card

>open oven
The cookies aren't ready yet!

* * *

>x me
You are a raccoon. You have large expressive eyes, hidden behind a mask of black on a white face; short, pointed ears tipped with white; and a long, bushy tail ringed in black. Your long coat is grey, almost silver, grizzled with black.

>wear apron
(first taking the apron)
You put on the apron.

>x me
You are a raccoon. You have large expressive eyes, hidden behind a mask of black on a white face; short, pointed ears tipped with white; and a long, bushy tail ringed in black. Your long coat is grey, almost silver, grizzled with blackYou are wearing a frilly pink apron.

* * *

>twist timer
You set the timer for 15 minutes.

>twist timer to 15
I only understood you as far as wanting to twist the timer.

* * *

>twist timer to 15
You set the timer for 15 minutes.

* * *

>look in crate
You can't see inside the crate from here.

>rules on
Rules tracing now switched on. Type "rules off" to switch it off again, or "rules all" to include even rules which do not apply.

>look in crate
[Rule "declare everything initially unmentioned rule" applies.]
[Rule "announce items from multiple object lists rule" applies.]
[Rule "set pronouns from items from multiple object lists rule" applies.]
[Rule "before stage rule" applies.]
[Rule "can't act in the dark rule" applies.]
[Rule "instead stage rule" applies.]
[Rule "investigate player's awareness before action rule" applies.]
[Rule "player aware of his own actions rule" applies.]
[Rule "check stage rule" applies.]
[Rule "can't search unless container or supporter rule" applies.]
[Rule "can't search closed opaque containers rule" applies.]
[Rule "carry out stage rule" applies.]
[Rule "after stage rule" applies.]
[Rule "investigate player's awareness after action rule" applies.]
[Rule "report stage rule" applies.]
[Rule "standard search containers rule" applies.]
The crate is empty.

[Rule "report other people searching rule" applies.]
[Rule "last specific action-processing rule" applies.]
[Rule "A first turn sequence rule" applies.]
[Rule "every turn stage rule" applies.]
[Rule "A last turn sequence rule" applies.]
[Rule "notify score changes rule" applies.]

* * *

>climb crate
Little is to be achieved by that.

>climb stool
Kitchen (on the stool)
You are standing on a small stool in the kitchen. From here you can clearly see the top of the refrigerator, but you can't reach it.

On the table is a timer.

>x crate
A wooden crate with a painted nectarine on the side.

>look in crate
The crate is empty.

* * *

>climb stool
Kitchen (on the stool)
You are standing on a small stool in the kitchen. From here you can clearly see the top of the refrigerator, but you can't reach it.

On the table is a timer.

>look in crate
In the crate are a coffee mug and a mixing bowl.

* * *

>push stool to fridge
You place the stool in front of the refrigerator.

>take crate
You can't reach that from down here.

* * *

>abstract mug to me
[Abstracted.]

>open oven
You open the oven, revealing a baking sheet.

>put mug on tray
You put the coffee mug on the baking sheet.

* * *

>open oven
You open the oven, revealing a baking sheet.

>abstract mug to me
[Abstracted.]

>put mug in oven
The coffee mug is too tall for the oven.

>put mug on tray
The coffee mug is too tall for the oven.

>abstract bowl to me
[Abstracted.]

>put bowl on tray
You put the mixing bowl on the baking sheet.