I found a new friend underneath my pillow.

Fingertips: I Found a New Friend
A heart-warming story of friendship by Adri
Release 2 / Serial number 120514 / Inform 7 build 6G60 (I6/v6.32 lib 6/12N) SD

Bedroom
You've had a long day. All you want to do is climb into bed. But why is your pillow quivering like that?

>throw pillow
You pick up the pillow and throw it at the wall. Underneath it is a creature unlike anything you've ever seen before. It seems more afraid of you than you are of it, but you're so freaked out that you squash it.

*** You did not make a new friend. ***

Bedroom
You've had a long day. All you want to do is climb into bed. But why is your pillow quivering like that?

>throw me
That's an odd thing to do.

>stand on bed
I only understood you as far as wanting to stand.

>up
You decide to sleep on the sofa tonight. You look under the pillow in the morning, but find nothing.

*** You did not make a new friend. ***

>j
bedroom
You've had a long day. All you want to do is climb into bed. But why is your pillow quivering like that?

* * *

I found a new friend underneath my pillow.

Fingertips: I Found a New Friend
A heart-warming story of friendship by Adri
Release 2 / Serial number 120514 / Inform 7 build 6G60 (I6/v6.32 lib 6/12N) SD

Bedroom
You've had a long day. All you want to do is climb into bed. But why is your pillow quivering like that?

>make friend
You pick up the pillow. Underneath it is a creature unlike anything you've ever seen before, but it seems to be friendly. It smiles and waves at you.

    *** You made a new friend. ***

Would you like to RESTART, see some suggestions for AMUSING things to do, view available ENDINGS, or QUIT?

>amusing
Have you tried...
- counting sheep?
- looking at the sheep?
- looking under the bed?
- interacting with the dust bunnies?
- examining your surroundings?
- vocalizing?
- throwing yourself?
- finding all fifteen endings?

Would you like to RESTART, see some suggestions for AMUSING things to do, view available ENDINGS, or QUIT?

* * *

>make friend
You pick up the pillow. Underneath it is a creature unlike anything you've ever seen before, but it seems to be friendly. It smiles and waves at you.

    *** You made a new friend. ***

Would you like to RESTART, see some suggestions for AMUSING things to do, view available ENDINGS, or QUIT?

>restart
I found a new friend underneath my pillow.

Fingertips: I Found a New Friend
A heart-warming story of friendship by Adri
Release 1 / Serial number 120219 / Inform 7 build 6G60 (I6/v6.32 lib 6/12N) SD

Bedroom
You've had a long day. All you want to do is climb into bed. But why is your pillow quivering like that?

* * *

>make friend
You pick up the pillow. Underneath it is a creature unlike anything you've ever seen before, but it seems to be friendly. It smiles and waves at you.

    *** You made a new friend. ***

Would you like to RESTART, see some suggestions for AMUSING things to do, view available ENDINGS, or QUIT?

>endings
- Making a new friend
- Hugging the pillow
- Petting the pillow
- Cleaning under the bed
- Going to bed
- Waiting four times
- Counting sheep seven times
- Examining sheep eight times
- Throwing the pillow at something
- Crawling under the bed
- Running away
- Leaving the room
- Jumping on the bed
- Poking the pillow
- Attacking the pillow

Would you like to RESTART, see some suggestions for AMUSING things to do, view available ENDINGS, or QUIT?

>amusing
Have you tried...
- making a new friend?
- casting xyzzy?
- sleeping?
- counting sheep? Multiple times?
- looking at the sheep? Multiple times?
- looking at your pajamas?
- jumping on the bed?
- making the bed?
- looking under the bed?
- looking at the dust bunnies?
- counting the dust bunnies?
- hugging or petting the dust bunnies?
- cleaning under the bed?
- counting yourself?
- eating the pillow?
- attacking the pillow?
- throwing the pillow?
- singing and dancing?
- crying and screaming?
- crawling underneath the bed?
- jumping on the bed?
- throwing yourself?
- running away?
- hugging or petting the pillow?
- finding all the TMBG references?
- finding all fifteen endings?

Would you like to RESTART, see some suggestions for AMUSING things to do, view available ENDINGS, or QUIT?

>restart
I found a new friend underneath my pillow.

Fingertips: I Found a New Friend
A heart-warming story of friendship by Adri
Release 1 / Serial number 120514 / Inform 7 build 6G60 (I6/v6.32 lib 6/12N) SD

Bedroom
You've had a long day. All you want to do is climb into bed. But why is your pillow quivering like that?

>xyzzy
A tired voice says, "Zzzzy".

>counting sheep
That's not a verb I recognize.

>count sheep
You close your eyes and envision a fluffy white sheep jumping over a fence. One.

>x me
You are tired and ready for bed.

>x pajamas
The dinosaurs are a little childish, but nobody is here to see them. You wanted to be a paleontologist when you grew up. This is probably the closest you're going to get.

>i
Your pajamas don't have any pockets.

* * *

I found a new friend underneath my pillow.

Fingertips: I Found a New Friend
A heart-warming story of friendship by Adri
Release 2 / Serial number 120514 / Inform 7 build 6G60 (I6/v6.32 lib 6/12N) SD

Bedroom
You've had a long day. All you want to do is climb into bed. But why is your pillow quivering like that?

>take
(the pillow)
You pick up the pillow. Underneath it is a creature unlike anything you've ever seen before, but it seems to be friendly. It smiles and waves at you.

    *** You made a new friend. ***

Would you like to RESTART, see some suggestions for AMUSING things to do, or QUIT?

>x friend
You can't see any such thing.

>find friend
You pick up the pillow. Underneath it is a creature unlike anything you've ever seen before, but it seems to be friendly. It smiles and waves at you.

    *** You made a new friend. ***

Would you like to RESTART, or QUIT?

>restart
I found a new friend underneath my pillow.

Fingertips: I Found a New Friend
A heart-warming story of friendship by Adri
Release 1 / Serial number 120213 / Inform 7 build 6G60 (I6/v6.32 lib 6/12N) SD

bedroom
You've had a long day. All you want to do is climb into bed. But why is your pillow quivering like that?

* * *

>take
(the pillow)
You pick up the pillow. Underneath it is a creature unlike anything you've ever seen before, but it seems to be friendly. It smiles and waves at you.

    *** You made a new friend. ***

Would you like to RESTART, see some suggestions for AMUSING things to do, or QUIT?

>restart
I found a new friend underneath my pillow.

Fingertips: I Found a New Friend
A heart-warming story of friendship by Adri
Release 1 / Serial number 120219 / Inform 7 build 6G60 (I6/v6.32 lib 6/12N) SD

Bedroom
You've had a long day. All you want to do is climb into bed. But why is your pillow quivering like that?

>hug
(the pillow)
You pick up the pillow and give it a gentle squeeze.  When you go to put it back, you see a small creature standing there with its arms raised. It doesn't look like anything you've ever seen before, but it seems friendly enough. You scoop it up and give it a hug.

    *** You made a new friend. ***

Would you like to RESTART, see some suggestions for AMUSING things to do, or QUIT?

>restart
I found a new friend underneath my pillow.

Fingertips: I Found a New Friend
A heart-warming story of friendship by Adri
Release 1 / Serial number 120219 / Inform 7 build 6G60 (I6/v6.32 lib 6/12N) SD

Bedroom
You've had a long day. All you want to do is climb into bed. But why is your pillow quivering like that?

>give
(the pillow to the pillow)
That's an odd thing to do.

>give bed
(to the pillow)
That's an odd thing to do.

>attack
(the pillow)
You press down on the pillow. You hear a muffled scream, and the pillow stops moving.

*** You did not make a new friend. ***

Bedroom
You've had a long day. All you want to do is climb into bed. But why is your pillow quivering like that?

>clean
(the dust bunnies)
You feel a pang of regret as you vacuum up the dust bunnies. You decide to go drown your sorrows in a pint of ice cream.

*** You did not make a new friend. ***

Bedroom
You've had a long day. All you want to do is climb into bed. But why is your pillow quivering like that?

>talk
The pillow stops rustling for a moment and seems to listen to you.

* * *

I found a new friend underneath my pillow.

Fingertips: I Found a New Friend
A heart-warming story of friendship by Adri
Release 2 / Serial number 120514 / Inform 7 build 6G60 (I6/v6.32 lib 6/12N) SD

Bedroom
You've had a long day. All you want to do is climb into bed. But why is your pillow quivering like that?

>drop pajams
You can't see any such thing.

>drop pajamas
But it's time for bed.

>xyzzy
A tired voice says, "Zzzzy"

* * *

I found a new friend underneath my pillow.

Fingertips: I Found a New Friend
A heart-warming story of friendship by Adri
Release 2 / Serial number 120514 / Inform 7 build 6G60 (I6/v6.32 lib 6/12N) SD

Bedroom
You've had a long day. All you want to do is climb into bed. But why is your pillow quivering like that?

>xyzyz
That's not a verb I recognize.

>xyzzy
A tired voice says, "Zzzzy".

>count me
You are a unique and special snowflake.

>count
(the pajamas)
There's just the one.

>dance
That's not a verb I recognize.

>sing
You hum a lullaby your mother used to sing to you. Your pillow seems relaxed by it.

>sit
You sit on the edge of the bed.

>sit
You are already sitting on the bed.

>sit on pillow
You press down on the pillow. You hear a muffled scream, and the pillow stops moving.

*** You did not make a new friend. ***

>s
bedroom
You've had a long day. All you want to do is climb into bed. But why is your pillow quivering like that?

>stand
You stand up again.

>stand
You are already standing.

>stand
You are already standing.

>up
You decide to sleep on the sofa tonight. You look under the pillow in the morning, but find nothing.

*** You did not make a new friend. ***

bedroom
You've had a long day. All you want to do is climb into bed. But why is your pillow quivering like that?

* * *

I found a new friend underneath my pillow.

Fingertips: I Found a New Friend
A heart-warming story of friendship by Adri
Release 2 / Serial number 120514 / Inform 7 build 6G60 (I6/v6.32 lib 6/12N) SD

Bedroom
You've had a long day. All you want to do is climb into bed. But why is your pillow quivering like that?

>up
You are already standing.

>down
You decide to sleep on the sofa tonight. You look under the pillow in the morning, but find nothing.

*** You did not make a new friend. ***

bedroom
You've had a long day. All you want to do is climb into bed. But why is your pillow quivering like that?

* * *

I found a new friend underneath my pillow.

Fingertips: I Found a New Friend
A heart-warming story of friendship by Adri
Release 2 / Serial number 120514 / Inform 7 build 6G60 (I6/v6.32 lib 6/12N) SD

Bedroom
You've had a long day. All you want to do is climb into bed. But why is your pillow quivering like that?

>down
You sit on the edge of the bed.

>up
You stand up again.

>dance
That's not a verb I recognize.

>stand on pillow
I only understood you as far as wanting to stand.

>stand on
I only understood you as far as wanting to stand.

>remove pajamas
But it's time for bed.

>throw pajamas
That's an odd thing to do.

>throw
(the pajamas)
That's an odd thing to do.

>curses
Quite.

>cry
Your pillow seems to cower in fear.

* * *

I found a new friend underneath my pillow.

Fingertips: I Found a New Friend
A heart-warming story of friendship by Adri
Release 2 / Serial number 120514 / Inform 7 build 6G60 (I6/v6.32 lib 6/12N) SD

Bedroom
You've had a long day. All you want to do is climb into bed. But why is your pillow quivering like that?

>cry
You burst into tears. Your pillow hums tunelessly. It seems to be trying to cheer you up.

>hum
You hum a lullaby your mother used to sing to you. Your pillow seems relaxed by it.

>sing
You hum a lullaby your mother used to sing to you. Your pillow seems relaxed by it.

>i
Your pajamas don't have any pockets.

>give
(the pajamas)
That's an odd thing to do.

>give bed to pillow
That's an odd thing to do.

* * *

>cry
You burst into tears. Your pillow hums tunelessly. It seems to be trying to cheer you up.

>dance
You dance around the bed. You feel silly.

* * *

I found a new friend underneath my pillow.

Fingertips: I Found a New Friend
A heart-warming story of friendship by Adri
Release 2 / Serial number 120514 / Inform 7 build 6G60 (I6/v6.32 lib 6/12N) SD

Bedroom
You've had a long day. All you want to do is climb into bed. But why is your pillow quivering like that?

>stand on bed
response missing.

>stand on me
No matter how you twist and turn, you can't seem to manage that.

>stand on pillow
You press down on the pillow. You hear a muffled scream, and the pillow stops moving.

*** You did not make a new friend. ***

bedroom
You've had a long day. All you want to do is climb into bed. But why is your pillow quivering like that?

>throw pillow
You pick up the pillow and throw it at the wall. Underneath it is a creature unlike anything you've ever seen before. It seems more afraid of you than you are of it, but you're so freaked out that you squash it.

*** You did not make a new friend. ***

bedroom
You've had a long day. All you want to do is climb into bed. But why is your pillow quivering like that?

>throw
(the pajamas)
That's an odd thing to do.

>throw pajamas
That's an odd thing to do.

>give me
That's an odd thing to do.

>down
You sit on the edge of the bed.

>take
(the pajamas)
You already have that.

>give
(the pajamas)
That's an odd thing to do.

>throw
(the pajamas)
That's an odd thing to do.

* * *

I found a new friend underneath my pillow.

Fingertips: I Found a New Friend
A heart-warming story of friendship by Adri
Release 2 / Serial number 120514 / Inform 7 build 6G60 (I6/v6.32 lib 6/12N) SD

Bedroom
You've had a long day. All you want to do is climb into bed. But why is your pillow quivering like that?

>eat
You nibble on your pillow. It tastes like marshmallow.

>eat bed
That's an odd thing to do.

>look under bed
A family of dust bunnies peeks out at you.

>look under bedding
You fold back the bedding. There's nothing under there.

>look under pillow
You pick up the pillow. Underneath it is a creature unlike anything you've ever seen before, but it seems to be friendly. It smiles and waves at you.

    *** You made a new friend. ***

Would you like to RESTART, or QUIT?

>restart
I found a new friend underneath my pillow.

Fingertips: I Found a New Friend
A heart-warming story of friendship by Adri
Release 1 / Serial number 120213 / Inform 7 build 6G60 (I6/v6.32 lib 6/12N) SD

bedroom
You've had a long day. All you want to do is climb into bed. But why is your pillow quivering like that?

>count me
You are a unique and special snowflake.

>count bed
There's just the one.

>count pillow
There's just the one.

>bite
(the pajamas)
That's an odd thing to do.

>eat
You nibble on your pillow. It tastes like marshmallow.

* * *

I found a new friend underneath my pillow.

Fingertips: I Found a New Friend
A heart-warming story of friendship by Adri
Release 2 / Serial number 120514 / Inform 7 build 6G60 (I6/v6.32 lib 6/12N) SD

Bedroom
You've had a long day. All you want to do is climb into bed. But why is your pillow quivering like that?

>hug pillow
You pick up the pillow and give it a gentle squeeze.  When you go to put it back, you see a small creature standing there with its arms raised. It doesn't look like anything you've ever seen before, but it seems friendly enough. You scoop it up and give it a hug.

    *** You made a new friend. ***

Would you like to RESTART, or QUIT?

>restart
I found a new friend underneath my pillow.

Fingertips: I Found a New Friend
A heart-warming story of friendship by Adri
Release 1 / Serial number 120217 / Inform 7 build 6G60 (I6/v6.32 lib 6/12N) SD

Bedroom
You've had a long day. All you want to do is climb into bed. But why is your pillow quivering like that?

>hug me
You give yourself a hug. You feel better.

>kiss me
If you think that'll help.

>kiss pillow
Keep your mind on the game.

>kiss bed
You can only do that to something animate.

>attack pillow
You press down on the pillow. You hear a muffled scream, and the pillow stops moving.

*** You did not make a new friend. ***

>r
bedroom
You've had a long day. All you want to do is climb into bed. But why is your pillow quivering like that?

>estar
That's not a verb I recognize.

>restart
Are you sure you want to restart?

>y
I found a new friend underneath my pillow.

Fingertips: I Found a New Friend
A heart-warming story of friendship by Adri
Release 1 / Serial number 120213 / Inform 7 build 6G60 (I6/v6.32 lib 6/12N) SD

bedroom
You've had a long day. All you want to do is climb into bed. But why is your pillow quivering like that?

>talk
The pillow stops rustling for a moment and seems to listen to you.

>ping
That's not a verb I recognize.

>pinch
(the pajamas)
You steal the pajamas.

>pitdh
That's not a verb I recognize.

>pitch
(the pajamas)
That's an odd thing to do.

* * *

>restart
I found a new friend underneath my pillow.

Fingertips: I Found a New Friend
A heart-warming story of friendship by Adri
Release 1 / Serial number 120217 / Inform 7 build 6G60 (I6/v6.32 lib 6/12N) SD

Bedroom
You've had a long day. All you want to do is climb into bed. But why is your pillow quivering like that?

>pet pillow
You rub the pillow in a soothing manner. You hear a soft purring sound, and a tiny creature crawls out from underneath the pillow. It's unlike anything you've ever seen before, but it seems friendly enough. You reach out and stroke its head.

    *** You made a new friend. ***

Would you like to RESTART, or QUIT?

>restart
I found a new friend underneath my pillow.

Fingertips: I Found a New Friend
A heart-warming story of friendship by Adri
Release 1 / Serial number 120217 / Inform 7 build 6G60 (I6/v6.32 lib 6/12N) SD

Bedroom
You've had a long day. All you want to do is climb into bed. But why is your pillow quivering like that?

>pet bunny
You reach under the bed and pat a bunny gently on the head. It twitches its nose at you.

>hug bunny
You can only do that to something animate.

* * *

I found a new friend underneath my pillow.

Fingertips: I Found a New Friend
A heart-warming story of friendship by Adri
Release 2 / Serial number 120514 / Inform 7 build 6G60 (I6/v6.32 lib 6/12N) SD

Bedroom
You've had a long day. All you want to do is climb into bed. But why is your pillow quivering like that?

>throw me
You hurl yourself at the bed. The pillow jumps about an inch in the air, but you don't get a good glimpse at what is underneath.

>throw bed
You can barely move the bed.

>throw pajamas
But it's time for bed.

>throw pillow
You pick up the pillow and throw it at the wall. Underneath it is a creature unlike anything you've ever seen before. It seems more afraid of you than you are of it, but you're so freaked out that you squash it.

*** You did not make a new friend. ***

* * *

bedroom
You've had a long day. All you want to do is climb into bed. But why is your pillow quivering like that?

>throw
You pick up the pillow and throw it at the wall. Underneath it is a creature unlike anything you've ever seen before. It seems more afraid of you than you are of it, but you're so freaked out that you squash it.

*** You did not make a new friend. ***

* * *

I found a new friend underneath my pillow.

Fingertips: I Found a New Friend
A heart-warming story of friendship by Adri
Release 2 / Serial number 120514 / Inform 7 build 6G60 (I6/v6.32 lib 6/12N) SD

Bedroom
You've had a long day. All you want to do is climb into bed. But why is your pillow quivering like that?

>dance
That's not a verb I recognize.

>cry
That's not a verb I recognize.

* * *

I found a new friend underneath my pillow.

Fingertips: I Found a New Friend
A heart-warming story of friendship by Adri
Release 2 / Serial number 120514 / Inform 7 build 6G60 (I6/v6.32 lib 6/12N) SD

Bedroom
You've had a long day. All you want to do is climb into bed. But why is your pillow quivering like that?

>find friend
You pick up the pillow. Underneath it is a creature unlike anything you've ever seen before, but it seems to be friendly. It smiles and waves at you.

    *** You made a new friend. ***

Would you like to RESTART, or QUIT?

>restart
I found a new friend underneath my pillow.

Fingertips: I Found a New Friend
A heart-warming story of friendship by Adri
Release 1 / Serial number 120213 / Inform 7 build 6G60 (I6/v6.32 lib 6/12N) SD

Bedroom
You've had a long day. All you want to do is climb into bed. But why is your pillow quivering like that?

* * *

I found a new friend underneath my pillow.

Fingertips: I Found a New Friend
A heart-warming story of friendship by Adri
Release 2 / Serial number 120514 / Inform 7 build 6G60 (I6/v6.32 lib 6/12N) SD

Bedroom
You've had a long day. All you want to do is climb into bed. But why is your pillow quivering like that?

>jump
You jump on the spot, fruitlessly.

>jump on bed
You can't jump onto the bed.

* * *

I found a new friend underneath my pillow.

Fingertips: I Found a New Friend
A heart-warming story of friendship by Adri
Release 2 / Serial number 120514 / Inform 7 build 6G60 (I6/v6.32 lib 6/12N) SD

Bedroom
You've had a long day. All you want to do is climb into bed. But why is your pillow quivering like that?

>jump on bed
You jump around on the bed like a monkey. Then you fall off and hit your head.

*** You did not make a new friend. ***

>strike
(the pajamas)
You can't strike the pajamas.

>strike pillow
You can't strike the pillow.

>steal
(the pajamas)
You steal the pajamas.

* * *

>jump on bed
You jump around on the bed like a monkey. Then you fall off and hit your head.

*** You did not make a new friend. ***

Bedroom
You've had a long day. All you want to do is climb into bed. But why is your pillow quivering like that?

* * *

I found a new friend underneath my pillow.

Fingertips: I Found a New Friend
A heart-warming story of friendship by Adri
Release 2 / Serial number 120514 / Inform 7 build 6G60 (I6/v6.32 lib 6/12N) SD

Bedroom
You've had a long day. All you want to do is climb into bed. But why is your pillow quivering like that?

>heist
(the pajamas)
You pick up the pillow. Underneath it is a creature unlike anything you've ever seen before, but it seems to be friendly. It smiles and waves at you.

    *** You made a new friend. ***

Would you like to RESTART, or QUIT?

>restart
I found a new friend underneath my pillow.

Fingertips: I Found a New Friend
A heart-warming story of friendship by Adri
Release 1 / Serial number 120213 / Inform 7 build 6G60 (I6/v6.32 lib 6/12N) SD

Bedroom
You've had a long day. All you want to do is climb into bed. But why is your pillow quivering like that?

>steal
(the pajamas)
You pick up the pillow. Underneath it is a creature unlike anything you've ever seen before, but it seems to be friendly. It smiles and waves at you.

    *** You made a new friend. ***

Would you like to RESTART, or QUIT?

* * *

I found a new friend underneath my pillow.

Fingertips: I Found a New Friend
A heart-warming story of friendship by Adri
Release 2 / Serial number 120514 / Inform 7 build 6G60 (I6/v6.32 lib 6/12N) SD

Bedroom
You've had a long day. All you want to do is climb into bed. But why is your pillow quivering like that?

>steal
You pick up the pillow. Underneath it is a creature unlike anything you've ever seen before, but it seems to be friendly. It smiles and waves at you.

    *** You made a new friend. ***

Would you like to RESTART, or QUIT?

>restart
I found a new friend underneath my pillow.

Fingertips: I Found a New Friend
A heart-warming story of friendship by Adri
Release 1 / Serial number 120213 / Inform 7 build 6G60 (I6/v6.32 lib 6/12N) SD

Bedroom
You've had a long day. All you want to do is climb into bed. But why is your pillow quivering like that?

>drop pillow
Dropped.

>drop
(the pajamas)
But it's time for bed.

>lie down
That's not something you can lie down on.

>climb
(into the pajamas)
That's not something you can enter.

>climb into
(the pajamas)
That's not something you can enter.

>lie
(in the pajamas)
That's not something you can lie down on.

* * *

I found a new friend underneath my pillow.

Fingertips: I Found a New Friend
A heart-warming story of friendship by Adri
Release 2 / Serial number 120514 / Inform 7 build 6G60 (I6/v6.32 lib 6/12N) SD

Bedroom
You've had a long day. All you want to do is climb into bed. But why is your pillow quivering like that?

>lie
You're too tired to deal with this right now. You curl up in bed and fall fast asleep. You look under the pillow in the morning, but find nothing.

*** You did not make a new friend. ***

>lie on bed
You're too tired to deal with this right now. You curl up in bed and fall fast asleep. You look under the pillow in the morning, but find nothing.

*** You did not make a new friend. ***

>y
Bedroom
You've had a long day. All you want to do is climb into bed. But why is your pillow quivering like that?

* * *

>lie
You're too tired to deal with this right now. You curl up in bed and fall fast asleep. You look under the pillow in the morning, but find nothing.

*** You did not make a new friend. ***

>y
Bedroom
You've had a long day. All you want to do is climb into bed. But why is your pillow quivering like that?

>lie down
You're too tired to deal with this right now. You curl up in bed and fall fast asleep. You look under the pillow in the morning, but find nothing.

*** You did not make a new friend. ***

>y
Bedroom
You've had a long day. All you want to do is climb into bed. But why is your pillow quivering like that?

>enter
You're too tired to deal with this right now. You curl up in bed and fall fast asleep. You look under the pillow in the morning, but find nothing.

*** You did not make a new friend. ***

Bedroom
You've had a long day. All you want to do is climb into bed. But why is your pillow quivering like that?

>sleep
You're too tired to deal with this right now. You curl up in bed and fall fast asleep. You look under the pillow in the morning, but find nothing.

*** You did not make a new friend. ***

Bedroom
You've had a long day. All you want to do is climb into bed. But why is your pillow quivering like that?

* * *

I found a new friend underneath my pillow.

Fingertips: I Found a New Friend
A heart-warming story of friendship by Adri
Release 2 / Serial number 120514 / Inform 7 build 6G60 (I6/v6.32 lib 6/12N) SD

Bedroom
You've had a long day. All you want to do is climb into bed. But why is your pillow quivering like that?

>lie on pillow
You press down on the pillow. You hear a muffled scream, and the pillow stops moving.

*** You did not make a new friend. ***

>y
Bedroom
You've had a long day. All you want to do is climb into bed. But why is your pillow quivering like that?

>lie on me
But you're already in yourself.

* * *

>lie on pillow
You press down on the pillow. You hear a muffled scream, and the pillow stops moving.

*** You did not make a new friend. ***

Bedroom
You've had a long day. All you want to do is climb into bed. But why is your pillow quivering like that?

>sit on pillow
You press down on the pillow. You hear a muffled scream, and the pillow stops moving.

*** You did not make a new friend. ***

Bedroom
You've had a long day. All you want to do is climb into bed. But why is your pillow quivering like that?

>sit bed
I only understood you as far as wanting to sit.

* * *

I found a new friend underneath my pillow.

Fingertips: I Found a New Friend
A heart-warming story of friendship by Adri
Release 2 / Serial number 120514 / Inform 7 build 6G60 (I6/v6.32 lib 6/12N) SD

Bedroom
You've had a long day. All you want to do is climb into bed. But why is your pillow quivering like that?

>lie on me
No matter how you twist and turn, you can't seem to manage that.

>lie on bed
You're too tired to deal with this right now. You curl up in bed and fall fast asleep. You look under the pillow in the morning, but find nothing.

*** You did not make a new friend. ***

>l
Bedroom
You've had a long day. All you want to do is climb into bed. But why is your pillow quivering like that?

* * *

>sit on pillow
You press down on the pillow. You hear a muffled scream, and the pillow stops moving.

*** You did not make a new friend. ***

* * *

I found a new friend underneath my pillow.

Fingertips: I Found a New Friend
A heart-warming story of friendship by Adri
Release 2 / Serial number 120514 / Inform 7 build 6G60 (I6/v6.32 lib 6/12N) SD

Bedroom
You've had a long day. All you want to do is climb into bed. But why is your pillow quivering like that?

>sit on bed
You sit on the edge of the bed.

>sit on pillow
You press down on the pillow. You hear a muffled scream, and the pillow stops moving.

*** You did not make a new friend. ***

* * *

I found a new friend underneath my pillow.

Fingertips: I Found a New Friend
A heart-warming story of friendship by Adri
Release 2 / Serial number 120514 / Inform 7 build 6G60 (I6/v6.32 lib 6/12N) SD

Bedroom
You've had a long day. All you want to do is climb into bed. But why is your pillow quivering like that?

>sit on me
No matter how you twist and turn, you can't seem to manage that.

* * *

>sit on bed
You sit on the edge of the bed.

* * *

>sit on me
No matter how you twist and turn, you can't seem to manage that.

>sit on friend
You can't sit on that.

>sit on pajamas
That's an odd thing to do.

>lie on bed
You're too tired to deal with this right now. You curl up in bed and fall fast asleep. You look under the pillow in the morning, but find nothing.

*** You did not make a new friend. ***

Bedroom
You've had a long day. All you want to do is climb into bed. But why is your pillow quivering like that?

>lie on pillow
You press down on the pillow. You hear a muffled scream, and the pillow stops moving.

*** You did not make a new friend. ***

* * *

Bedroom
You've had a long day. All you want to do is climb into bed. But why is your pillow quivering like that?

>lie on me
No matter how you twist and turn, you can't seem to manage that.

>lie on pajamas
That's not something you can lie down on.

>enter pillow
You press down on the pillow. You hear a muffled scream, and the pillow stops moving.

*** You did not make a new friend. ***

Bedroom
You've had a long day. All you want to do is climb into bed. But why is your pillow quivering like that?

* * *

>sit on me
No matter how you twist and turn, you can't seem to manage that.

>sit on pajamas
You can't sit on that.

>sit on wall
You can't sit on that.

* * *

I found a new friend underneath my pillow.

Fingertips: I Found a New Friend
A heart-warming story of friendship by Adri
Release 2 / Serial number 120514 / Inform 7 build 6G60 (I6/v6.32 lib 6/12N) SD

Bedroom
You've had a long day. All you want to do is climb into bed. But why is your pillow quivering like that?

>sit on chair
You can't see any such thing.

>sit on bed
You sit on the edge of the bed.

* * *

I found a new friend underneath my pillow.

Fingertips: I Found a New Friend
A heart-warming story of friendship by Adri
Release 2 / Serial number 120514 / Inform 7 build 6G60 (I6/v6.32 lib 6/12N) SD

Bedroom
You've had a long day. All you want to do is climb into bed. But why is your pillow quivering like that?

>sit
(on the bed)
You sit on the edge of the bed.

>sit on
You are already sitting on the bed.

>sit on bed
You are already sitting on the bed.

>sit on pillow
You press down on the pillow. You hear a muffled scream, and the pillow stops moving.

*** You did not make a new friend. ***

* * *

Bedroom
You've had a long day. All you want to do is climb into bed. But why is your pillow quivering like that?

>sit on me
No matter how you twist and turn, you can't seem to manage that.

* * *

>sit on pajamas
You can't sit on that.

>down
You are already sitting on the bed.

>sit
You are already sitting on the bed.

* * *

>sit
(on the bed)
You sit on the edge of the bed.

>sit in
You are already sitting on the bed.

>sit on
You are already sitting on the bed.

>sit in pillow
You press down on the pillow. You hear a muffled scream, and the pillow stops moving.

*** You did not make a new friend. ***

Bedroom
You've had a long day. All you want to do is climb into bed. But why is your pillow quivering like that?

>lie
You're too tired to deal with this right now. You curl up in bed and fall fast asleep. You look under the pillow in the morning, but find nothing.

*** You did not make a new friend. ***

Bedroom
You've had a long day. All you want to do is climb into bed. But why is your pillow quivering like that?

>lie down
You're too tired to deal with this right now. You curl up in bed and fall fast asleep. You look under the pillow in the morning, but find nothing.

*** You did not make a new friend. ***

Bedroom
You've had a long day. All you want to do is climb into bed. But why is your pillow quivering like that?

>lie on bed
You're too tired to deal with this right now. You curl up in bed and fall fast asleep. You look under the pillow in the morning, but find nothing.

*** You did not make a new friend. ***

* * *

>sit
(on the bed)
You sit on the edge of the bed.

>lie down
(on the bed)
You're too tired to deal with this right now. You curl up in bed and fall fast asleep. You look under the pillow in the morning, but find nothing.

*** You did not make a new friend. ***

Bedroom
You've had a long day. All you want to do is climb into bed. But why is your pillow quivering like that?

* * *

>sit
(on the bed)
You sit on the edge of the bed.

>stand
You stand up again.

>sit
(on the bed)
You sit on the edge of the bed.

>throw pillow
You pick up the pillow and throw it at the wall. Underneath it is a creature unlike anything you've ever seen before. It seems more afraid of you than you are of it, but you're so freaked out that you squash it.

*** You did not make a new friend. ***

* * *

Bedroom
You've had a long day. All you want to do is climb into bed. But why is your pillow quivering like that?

>stand
You are already standing.

>fuck bunny
You can't see any such thing.

>fuck bunnies
You can't see any such thing.

>fuck me
This isn't that sort of game.

>clean under bed
You can't clean the bed.

* * *

>sit
(on the bed)
You sit on the edge of the bed.

>sit on bed
You are already sitting on the bed.

* * *

>sit
(on the bed)
You sit on the edge of the bed.

>sit down
You are already sitting on the bed.

* * *

I found a new friend underneath my pillow.

Fingertips: I Found a New Friend
A heart-warming story of friendship by Adri
Release 2 / Serial number 120514 / Inform 7 build 6G60 (I6/v6.32 lib 6/12N) SD

Bedroom
You've had a long day. All you want to do is climb into bed. But why is your pillow quivering like that?

>sit on em
You can't see any such thing.

>sit on me
No matter how you twist and turn, you can't seem to manage that.

* * *

I found a new friend underneath my pillow.

Fingertips: I Found a New Friend
A heart-warming story of friendship by Adri
Release 2 / Serial number 120514 / Inform 7 build 6G60 (I6/v6.32 lib 6/12N) SD

Bedroom
You've had a long day. All you want to do is climb into bed. But why is your pillow quivering like that?

>enter me
No matter how you twist and turn, you can't seem to manage that.

* * *

I found a new friend underneath my pillow.

Fingertips: I Found a New Friend
A heart-warming story of friendship by Adri
Release 2 / Serial number 120514 / Inform 7 build 6G60 (I6/v6.32 lib 6/12N) SD

Bedroom
You've had a long day. All you want to do is climb into bed. But why is your pillow quivering like that?

>attack bed
Violence isn't the answer to this one.

>attack me
Violence isn't the answer to this one.

* * *

I found a new friend underneath my pillow.

Fingertips: I Found a New Friend
A heart-warming story of friendship by Adri
Release 2 / Serial number 120514 / Inform 7 build 6G60 (I6/v6.32 lib 6/12N) SD

Bedroom
You've had a long day. All you want to do is climb into bed. But why is your pillow quivering like that?

>attack
You press down on the pillow. You hear a muffled scream, and the pillow stops moving.

*** You did not make a new friend. ***

>y
Bedroom
You've had a long day. All you want to do is climb into bed. But why is your pillow quivering like that?

>punch
(the pajamas)
Violence isn't the answer to this one.

>attack
You press down on the pillow. You hear a muffled scream, and the pillow stops moving.

*** You did not make a new friend. ***

* * *

I found a new friend underneath my pillow.

Fingertips: I Found a New Friend
A heart-warming story of friendship by Adri
Release 2 / Serial number 120514 / Inform 7 build 6G60 (I6/v6.32 lib 6/12N) SD

Bedroom
You've had a long day. All you want to do is climb into bed. But why is your pillow quivering like that?

>punch
You press down on the pillow. You hear a muffled scream, and the pillow stops moving.

*** You did not make a new friend. ***

* * *

I found a new friend underneath my pillow.

Fingertips: I Found a New Friend
A heart-warming story of friendship by Adri
Release 2 / Serial number 120514 / Inform 7 build 6G60 (I6/v6.32 lib 6/12N) SD

Bedroom
You've had a long day. All you want to do is climb into bed. But why is your pillow quivering like that?

>hand
You pick up the pillow and throw it at the wall. Underneath it is a creature unlike anything you've ever seen before. It seems more afraid of you than you are of it, but you're so freaked out that you squash it.

*** You did not make a new friend. ***

Bedroom
You've had a long day. All you want to do is climb into bed. But why is your pillow quivering like that?

>give pillow
You pick up the pillow and throw it at the wall. Underneath it is a creature unlike anything you've ever seen before. It seems more afraid of you than you are of it, but you're so freaked out that you squash it.

*** You did not make a new friend. ***

Bedroom
You've had a long day. All you want to do is climb into bed. But why is your pillow quivering like that?

* * *

I found a new friend underneath my pillow.

Fingertips: I Found a New Friend
A heart-warming story of friendship by Adri
Release 2 / Serial number 120514 / Inform 7 build 6G60 (I6/v6.32 lib 6/12N) SD

Bedroom
You've had a long day. All you want to do is climb into bed. But why is your pillow quivering like that?

>give
That's an odd thing to do.

>give pillow
That's an odd thing to do.

>give pillow to pillow
That's an odd thing to do.

* * *

>give
That's an odd thing to do.

>give pillow to bed
You can only do that to something animate.

>give bed to pillow
That's an odd thing to do.

>throw bed
You can barely move the bed.

>take bed
You can barely move the bed.

* * *

I found a new friend underneath my pillow.

Fingertips: I Found a New Friend
A heart-warming story of friendship by Adri
Release 2 / Serial number 120514 / Inform 7 build 6G60 (I6/v6.32 lib 6/12N) SD

Bedroom
You've had a long day. All you want to do is climb into bed. But why is your pillow quivering like that?

>drop pajamas
But it's time for bed.

>fold
(the pajamas)
You can't fold the pajamas.

* * *

I found a new friend underneath my pillow.

Fingertips: I Found a New Friend
A heart-warming story of friendship by Adri
Release 2 / Serial number 120514 / Inform 7 build 6G60 (I6/v6.32 lib 6/12N) SD

Bedroom
You've had a long day. All you want to do is climb into bed. But why is your pillow quivering like that?

>fold bed
You can't fold the bed.

* * *

I found a new friend underneath my pillow.

Fingertips: I Found a New Friend
A heart-warming story of friendship by Adri
Release 2 / Serial number 120514 / Inform 7 build 6G60 (I6/v6.32 lib 6/12N) SD

Bedroom
You've had a long day. All you want to do is climb into bed. But why is your pillow quivering like that?

>x pajamas
The dinosaurs are a little childish, but nobody is here to see them. You wanted to be a paleontologist when you grew up. This is probably the closest you're going to get.

>x my pajamas
The dinosaurs are a little childish, but nobody is here to see them. You wanted to be a paleontologist when you grew up. This is probably the closest you're going to get.

>x clothes
The dinosaurs are a little childish, but nobody is here to see them. You wanted to be a paleontologist when you grew up. This is probably the closest you're going to get.

>remove clothes
But it's time for bed.

* * *

>x pajamas
The dinosaurs are a little childish, but nobody is here to see them. You wanted to be a paleontologist when you grew up. This is probably the closest you're going to get.

>pet pajamas
You know the dinosaurs aren't real, right?

* * *

>x pajamas
The dinosaurs are a little childish, but nobody is here to see them. You wanted to be a paleontologist when you grew up. This is probably the closest you're going to get.

>x dinosaurs
You see a T-rex and a Triceratops and a Carnotaur and a Pachycephalosaurus.

>take dinosaurs
You can't see any such thing.

* * *

I found a new friend underneath my pillow.

Fingertips: I Found a New Friend
A heart-warming story of friendship by Adri
Release 2 / Serial number 120514 / Inform 7 build 6G60 (I6/v6.32 lib 6/12N) SD

Bedroom
You've had a long day. All you want to do is climb into bed. But why is your pillow quivering like that?

>count me
You are a unique and special snowflake.

>count pillow
There's just the one.

>count bunnies
There are 69,105 dust bunnies here.

>count sheep
You close your eyes and envision a fluffy white sheep jumping over a fence. One.

There's just the one.

* * *

I found a new friend underneath my pillow.

Fingertips: I Found a New Friend
A heart-warming story of friendship by Adri
Release 2 / Serial number 120514 / Inform 7 build 6G60 (I6/v6.32 lib 6/12N) SD

Bedroom
You've had a long day. All you want to do is climb into bed. But why is your pillow quivering like that?

>count sheep
You close your eyes and envision a fluffy white sheep jumping over a fence. One.

>count me
You are a unique and special snowflake.

* * *

>count sheep
You close your eyes and envision a fluffy white sheep jumping over a fence. One.

>count bunnies
There are 69,105 dust bunnies here.

* * *

>count sheep
You close your eyes and envision a fluffy white sheep jumping over a fence. One.

>count sheep
Another sheep jumps over the fence. Two.

>count sheep
This sheep seems to struggle a bit, but finally makes it over the fence. Three.

>count sheep
Another sheep jumps over the fence. Four.

>count sheep
The next sheep chooses to walk around the fence. Five.

>count sheep
Another sheep jumps over the fence. Six.

>x bunnies
dust bunnies!

>x sheep
That only exists in your head.

>x sheep
Didn't I already tell you that only exists in your head?

>x sheep
Stop it!

>x sheep
Okay, okay, if I give you a sheep, will you get back to making a friend?

>x sheep
All right, you win.
               /\
    @@@@@@@@@@@  O  \
 @@@@@@@@@@@@@@@____/
@@@@@@@@@@@@@@@@
@ @@@@@@@@@@@@
   ||      ||
   ~~      ~~

>x sheep
Sorry, that's all you get.

>x sheep
You can't see any such thing.

>x sheep
You can't see any such thing.

>x bed
Your aunt made you this quilt as a Christmas present. It's an abstract pattern of brightly colored shapes. It balances out your boring white sheets.

>l
Bedroom
You've had a long day. All you want to do is climb into bed. But why is your pillow quivering like that?

* * *

>count sheep
Another sheep jumps over the fence. Six.

>count sheep
Another sheep jumps over the fence. Seven.

>count sheep
Another sheep jumps over the fence. Eight.

I beg your pardon?

>count sheep
Another sheep jumps over the fence. Nine.

* * *

>count sheep
This sheep seems to struggle a bit, but finally makes it over the fence. Three.

>take pillow
You pick up the pillow. Underneath it is a creature unlike anything you've ever seen before, but it seems to be friendly. It smiles and waves at you.

    *** You made a new friend. ***

Would you like to RESTART, see some suggestions for AMUSING things to do, or QUIT?

>restart
I found a new friend underneath my pillow.

Fingertips: I Found a New Friend
A heart-warming story of friendship by Adri
Release 1 / Serial number 120219 / Inform 7 build 6G60 (I6/v6.32 lib 6/12N) SD

Bedroom
You've had a long day. All you want to do is climb into bed. But why is your pillow quivering like that?

>count sheep
You close your eyes and envision a fluffy white sheep jumping over a fence. One.

* * *

>count sheep
This sheep seems to struggle a bit, but finally makes it over the fence. Three.

>throw pillow
You pick up the pillow and throw it at the wall. Underneath it is a creature unlike anything you've ever seen before. It seems more afraid of you than you are of it, but you're so freaked out that you squash it.

*** You did not make a new friend. ***

* * *

Bedroom
You've had a long day. All you want to do is climb into bed. But why is your pillow quivering like that?

>count sheep
You close your eyes and envision a fluffy white sheep jumping over a fence. One.

>x sheep
That only exists in your head.

* * *

>x sheep
Stop it!

>throw pillow
You pick up the pillow and throw it at the wall. Underneath it is a creature unlike anything you've ever seen before. It seems more afraid of you than you are of it, but you're so freaked out that you squash it.

*** You did not make a new friend. ***

* * *

Bedroom
You've had a long day. All you want to do is climb into bed. But why is your pillow quivering like that?

>x sheep
Okay, okay, if I give you a sheep, will you get back to making a friend?

* * *

I found a new friend underneath my pillow.

Fingertips: I Found a New Friend
A heart-warming story of friendship by Adri
Release 2 / Serial number 120514 / Inform 7 build 6G60 (I6/v6.32 lib 6/12N) SD

Bedroom
You've had a long day. All you want to do is climb into bed. But why is your pillow quivering like that?

>count bunnies
There are 69,105 dust bunnies here.

>look under bed
A family of dust bunnies peeks out at you.

>x bunnies
You can't see any such thing.

* * *

I found a new friend underneath my pillow.

Fingertips: I Found a New Friend
A heart-warming story of friendship by Adri
Release 2 / Serial number 120514 / Inform 7 build 6G60 (I6/v6.32 lib 6/12N) SD

Bedroom
You've had a long day. All you want to do is climb into bed. But why is your pillow quivering like that?

>talk to pillow
The pillow stops rustling for a moment and seems to listen to you.

>cry
You burst into tears. Your pillow hums tunelessly. It seems to be trying to cheer you up.

>shout
Your pillow seems to cower in fear.

* * *

I found a new friend underneath my pillow.

Fingertips: I Found a New Friend
A heart-warming story of friendship by Adri
Release 2 / Serial number 120514 / Inform 7 build 6G60 (I6/v6.32 lib 6/12N) SD

Bedroom
You've had a long day. All you want to do is climb into bed. But why is your pillow quivering like that?

>punch pillow
You press down on the pillow. You hear a muffled scream, and the pillow stops moving.

*** You did not make a new friend. ***

Bedroom
You've had a long day. All you want to do is climb into bed. But why is your pillow quivering like that?

* * *

I found a new friend underneath my pillow.

Fingertips: I Found a New Friend
A heart-warming story of friendship by Adri
Release 2 / Serial number 120514 / Inform 7 build 6G60 (I6/v6.32 lib 6/12N) SD

Bedroom
You've had a long day. All you want to do is climb into bed. But why is your pillow quivering like that?

>give pajamas to pillow
That's an odd thing to do.

>give bed to pillow
That's an odd thing to do.

>give pillow to pillow
That's an odd thing to do.

>throw pillow at pillow
You pick up the pillow and throw it at the wall. Underneath it is a creature unlike anything you've ever seen before. It seems more afraid of you than you are of it, but you're so freaked out that you squash it.

*** You did not make a new friend. ***

Bedroom
You've had a long day. All you want to do is climb into bed. But why is your pillow quivering like that?

>throw bed at pillow
You can barely move the bed.

* * *

I found a new friend underneath my pillow.

Fingertips: I Found a New Friend
A heart-warming story of friendship by Adri
Release 2 / Serial number 120514 / Inform 7 build 6G60 (I6/v6.32 lib 6/12N) SD

Bedroom
You've had a long day. All you want to do is climb into bed. But why is your pillow quivering like that?

>x me
You are tired and ready for bed. You are wearing your favorite pajamas.

>throw pillow
You pick up the pillow and throw it at the wall. Underneath it is a creature unlike anything you've ever seen before. It seems more afraid of you than you are of it, but you're so freaked out that you squash it.

*** You did not make a new friend. ***

* * *

I found a new friend underneath my pillow.

Fingertips: I Found a New Friend
A heart-warming story of friendship by Adri
Release 2 / Serial number 120514 / Inform 7 build 6G60 (I6/v6.32 lib 6/12N) SD

Bedroom
You've had a long day. All you want to do is climb into bed. But why is your pillow quivering like that?

>drop me
You lack the dexterity.

>drop bed
The bed is already here.

>drop pajamas
But it's time for bed.

>drop pillow
You haven't got him.

>drop friend
You haven't got that.

>x pillow
There seems to be something underneath your pillow.

>take pillow
You pick up the pillow. Underneath it is a creature unlike anything you've ever seen before, but it seems to be friendly. It smiles and waves at you.

    *** You made a new friend. ***

Would you like to RESTART, or QUIT?

>restart
I found a new friend underneath my pillow.

Fingertips: I Found a New Friend
A heart-warming story of friendship by Adri
Release 1 / Serial number 120216 / Inform 7 build 6G60 (I6/v6.32 lib 6/12N) SD

Bedroom
You've had a long day. All you want to do is climb into bed. But why is your pillow quivering like that?

>drop wall
You can't see any such thing.

>pour
(the pajamas)
You can't pour the pajamas.

>spill
(the pajamas)
You can't pour the pajamas.

* * *

I found a new friend underneath my pillow.

Fingertips: I Found a New Friend
A heart-warming story of friendship by Adri
Release 2 / Serial number 120514 / Inform 7 build 6G60 (I6/v6.32 lib 6/12N) SD

Bedroom
You've had a long day. All you want to do is climb into bed. But why is your pillow quivering like that?

>x sheep
That only exists in your head.

>up
You are already standing.

* * *

>x sheep
You can't see any such thing.

>x sheep
You spend the rest of the evening looking at photos of sheep on the internet. You look under the pillow in the morning, but find nothing.

*** You did not make a new friend. ***

>x sheep
You can't see any such thing.

>count sheep
You close your eyes and envision a fluffy white sheep jumping over a fence. One.

* * *

>count sheep
Another sheep jumps over the fence. Six.

>count sheep
The next thing you know, the sun is shining. You must have fallen asleep. You look under your pillow, but find nothing there.

*** You did not make a new friend. ***

Bedroom
You've had a long day. All you want to do is climb into bed. But why is your pillow quivering like that?

* * *

>count sheep
You close your eyes and envision a fluffy white sheep jumping over a fence. One.

>x sheep
You can't see any such thing.

>x sheep
You spent so much time looking for the sheep, that you forgot all about the pillow.

*** You did not make a new friend. ***

>throw pillow
You pick up the pillow and throw it at the wall. Underneath it is a creature unlike anything you've ever seen before. It seems more afraid of you than you are of it, but you're so freaked out that you squash it.

*** You did not make a new friend. ***

* * *

Bedroom
You've had a long day. All you want to do is climb into bed. But why is your pillow quivering like that?

>x sheep
You can't see any such thing.

* * *

>x sheep
You spend the rest of the evening looking at photos of sheep on the internet. You look under the pillow in the morning, but find nothing.

*** You did not make a new friend. ***

Bedroom
You've had a long day. All you want to do is climb into bed. But why is your pillow quivering like that?

>x sheep
That only exists in your head.

>throw pillow
You pick up the pillow and throw it at the wall. Underneath it is a creature unlike anything you've ever seen before. It seems more afraid of you than you are of it, but you're so freaked out that you squash it.

*** You did not make a new friend. ***

* * *

Bedroom
You've had a long day. All you want to do is climb into bed. But why is your pillow quivering like that?

>x sheep
Didn't I already tell you that only exists in your head?

* * *

>x sheep
That only exists in your head.

>g
Didn't I already tell you that only exists in your head?

>g
Stop it!

>throw pillow
You pick up the pillow and throw it at the wall. Underneath it is a creature unlike anything you've ever seen before. It seems more afraid of you than you are of it, but you're so freaked out that you squash it.

*** You did not make a new friend. ***

* * *

Bedroom
You've had a long day. All you want to do is climb into bed. But why is your pillow quivering like that?

>l
Bedroom
You've had a long day. All you want to do is climb into bed. But why is your pillow quivering like that?

>l
Bedroom
You've had a long day. All you want to do is climb into bed. But why is your pillow quivering like that?

>restart
Are you sure you want to restart?

>y
I found a new friend underneath my pillow.

Fingertips: I Found a New Friend
A heart-warming story of friendship by Adri
Release 1 / Serial number 120220 / Inform 7 build 6G60 (I6/v6.32 lib 6/12N) SD

Bedroom
You've had a long day. All you want to do is climb into bed. But why is your pillow quivering like that?

>l
Bedroom
You've had a long day. All you want to do is climb into bed. But why is your pillow quivering like that?

* * *

>up
You are already standing.

>down
You sit on the edge of the bed.

>walk
You decide to sleep on the sofa tonight. You look under the pillow in the morning, but find nothing.

*** You did not make a new friend. ***

* * *

I found a new friend underneath my pillow.

Fingertips: I Found a New Friend
A heart-warming story of friendship by Adri
Release 2 / Serial number 120514 / Inform 7 build 6G60 (I6/v6.32 lib 6/12N) SD

Bedroom
You've had a long day. All you want to do is climb into bed. But why is your pillow quivering like that?

>take pillow
You pick up the pillow. Underneath it is a creature unlike anything you've ever seen before, but it seems to be friendly. It smiles and waves at you.

    *** You made a new friend. ***

Would you like to RESTART, see some suggestions for AMUSING things to do, or QUIT?

>restart
I found a new friend underneath my pillow.

Fingertips: I Found a New Friend
A heart-warming story of friendship by Adri
Release 1 / Serial number 120216 / Inform 7 build 6G60 (I6/v6.32 lib 6/12N) SD

Bedroom
You've had a long day. All you want to do is climb into bed. But why is your pillow quivering like that?

>attack pillow
You press down on the pillow. You hear a muffled scream, and the pillow stops moving.

*** You did not make a new friend. ***

>y
Bedroom
You've had a long day. All you want to do is climb into bed. But why is your pillow quivering like that?

* * *

I found a new friend underneath my pillow.

Fingertips: I Found a New Friend
A heart-warming story of friendship by Adri
Release 2 / Serial number 120514 / Inform 7 build 6G60 (I6/v6.32 lib 6/12N) SD

Bedroom
You've had a long day. All you want to do is climb into bed. But why is your pillow quivering like that?

>throw pillow at pillow
That's an odd thing to do.

>throw bed at pillow
You can barely move the bed.

>throw bed at bed
That's an odd thing to do.

* * *

>throw pillow at pillow
That's an odd thing to do.

Bedroom
You've had a long day. All you want to do is climb into bed. But why is your pillow quivering like that?

* * *

>throw pillow at pillow
That's an odd thing to do.

>throw pillow
You pick up the pillow and throw it at the wall. Underneath it is a creature unlike anything you've ever seen before. It seems more afraid of you than you are of it, but you're so freaked out that you squash it.

*** You did not make a new friend. ***

* * *

>throw pillow at pillow
That's an odd thing to do.

>throw pillow at bed
You can only do that to something animate.

>throw bed at pillow
You can barely move the bed.

* * *

>throw pillow at pillow
That's an odd thing to do.

>throw pillow at all
You can't use multiple objects with that verb.

>throw pillow at wall
You can't see any such thing.

>throw pillow at bed
You can only do that to something animate.

>throw bed
You can barely move the bed.

>throw bed at pillow
You can barely move the bed.

>throw me
You hurl yourself at the bed. The pillow jumps about an inch in the air, but you don't get a good glimpse at what is underneath.

* * *

>throw pillow at pillow
That's an odd thing to do.

>throw bed at bed
You can only do that to something animate.

* * *

>throw pillow at pillow
That's an odd thing to do.

>throw bunny at bunny
That's an odd thing to do.

>throw bunny
You can't see any such thing.

>throw pillow at wall
You pick up the pillow and throw it at the pillow. Underneath it is a creature unlike anything you've ever seen before. It seems more afraid of you than you are of it, but you're so freaked out that you squash it.

*** You did not make a new friend. ***

>t
Bedroom
You've had a long day. All you want to do is climb into bed. But why is your pillow quivering like that?

>throw bunny at pillow
You press down on the pillow. You hear a muffled scream, and the pillow stops moving.

*** You did not make a new friend. ***

Bedroom
You've had a long day. All you want to do is climb into bed. But why is your pillow quivering like that?

>throw bunny
You can't see any such thing.

* * *

I found a new friend underneath my pillow.

Fingertips: I Found a New Friend
A heart-warming story of friendship by Adri
Release 2 / Serial number 120514 / Inform 7 build 6G60 (I6/v6.32 lib 6/12N) SD

Bedroom
You've had a long day. All you want to do is climb into bed. But why is your pillow quivering like that?

>throw bed
You can barely move the bed.

>throw sheep
That's an odd thing to do.

>throw sheep at pillow
That's an odd thing to do.

>throw pillow at pillow
You pick up the pillow and throw it at the wall. Underneath it is a creature unlike anything you've ever seen before. It seems more afraid of you than you are of it, but you're so freaked out that you squash it.

*** You did not make a new friend. ***

* * *

I found a new friend underneath my pillow.

Fingertips: I Found a New Friend
A heart-warming story of friendship by Adri
Release 2 / Serial number 120514 / Inform 7 build 6G60 (I6/v6.32 lib 6/12N) SD

Bedroom
You've had a long day. All you want to do is climb into bed. But why is your pillow quivering like that?

>throw pillow at bed
You can only do that to something animate.

* * *

>throw bed at pillow
You can barely move the bed.

>throw pillow
You pick up the pillow and throw it at the wall. Underneath it is a creature unlike anything you've ever seen before. It seems more afraid of you than you are of it, but you're so freaked out that you squash it.

*** You did not make a new friend. ***

* * *

I found a new friend underneath my pillow.

Fingertips: I Found a New Friend
A heart-warming story of friendship by Adri
Release 2 / Serial number 120514 / Inform 7 build 6G60 (I6/v6.32 lib 6/12N) SD

Bedroom
You've had a long day. All you want to do is climb into bed. But why is your pillow quivering like that?

>throw me at wall
You can't see any such thing.

>throw me
You hurl yourself at the bed. The pillow jumps about an inch in the air, but you don't get a good glimpse at what is underneath.

* * *

I found a new friend underneath my pillow.

Fingertips: I Found a New Friend
A heart-warming story of friendship by Adri
Release 2 / Serial number 120514 / Inform 7 build 6G60 (I6/v6.32 lib 6/12N) SD

Bedroom
You've had a long day. All you want to do is climb into bed. But why is your pillow quivering like that?

>throw me at pillow
You press down on the pillow. You hear a muffled scream, and the pillow stops moving.

*** You did not make a new friend. ***

Bedroom
You've had a long day. All you want to do is climb into bed. But why is your pillow quivering like that?

>throw me at wall
You hurl yourself at the wall. Ouch. You limp quietly back to the bed, grateful that no one was around to see that.

>throw me at bed
You hurl yourself at the bed. The pillow jumps about an inch in the air, but you don't get a good glimpse at what is underneath.

>throw me at bunnies
That's an odd thing to do.

>throw bunnies at bed
You can't see any such thing.

* * *

I found a new friend underneath my pillow.

Fingertips: I Found a New Friend
A heart-warming story of friendship by Adri
Release 2 / Serial number 120514 / Inform 7 build 6G60 (I6/v6.32 lib 6/12N) SD

Bedroom
You've had a long day. All you want to do is climb into bed. But why is your pillow quivering like that?

>x his glass
You can't see any such thing.

* * *

I found a new friend underneath my pillow.

Fingertips: I Found a New Friend
A heart-warming story of friendship by Adri
Release 2 / Serial number 120514 / Inform 7 build 6G60 (I6/v6.32 lib 6/12N) SD

Bedroom
You've had a long day. All you want to do is climb into bed. But why is your pillow quivering like that?

>throw sheep
That's an odd thing to do.

>take sheep
That's fixed in place.

>take bunnies
They're fixed in place.

>x sheep
That only exists in your head.

* * *

>x sheep
Stop it!

>x foo
You can't see any such thing.

>take foo
You can't see any such thing.

>look under bed
A family of dust bunnies peeks out at you.

* * *

I found a new friend underneath my pillow.

Fingertips: I Found a New Friend
A heart-warming story of friendship by Adri
Release 2 / Serial number 120514 / Inform 7 build 6G60 (I6/v6.32 lib 6/12N) SD

Bedroom
You've had a long day. All you want to do is climb into bed. But why is your pillow quivering like that?

>l
Bedroom
You've had a long day. All you want to do is climb into bed. But why is your pillow quivering like that?

>clean under bed
You can't clean the bed.

You vacuum up the dust bunnies. You feel a pang of regret.

* * *

>l
Bedroom
You've had a long day. All you want to do is climb into bed. But why is your pillow quivering like that?

>x
(the pajamas)
The dinosaurs are a little childish, but nobody is here to see them. You wanted to be a paleontologist when you grew up. This is probably the closest you're going to get.

2

>throw pillow
You pick up the pillow and throw it at the wall. Underneath it is a creature unlike anything you've ever seen before. It seems more afraid of you than you are of it, but you're so freaked out that you squash it.

*** You did not make a new friend. ***

* * *

Bedroom
You've had a long day. All you want to do is climb into bed. But why is your pillow quivering like that?

>l
Bedroom
You've had a long day. All you want to do is climb into bed. But why is your pillow quivering like that?

0

>l
Bedroom
You've had a long day. All you want to do is climb into bed. But why is your pillow quivering like that?

1

* * *

>l
Bedroom
You've had a long day. All you want to do is climb into bed. But why is your pillow quivering like that?

>x pillow
There seems to be something underneath your pillow.

>listen
There's some rustling sounds coming from under your pillow.

>z
You pause to assess the situation. You're very tired, and there seems to be something underneath your pillow.

* * *

I found a new friend underneath my pillow.

Fingertips: I Found a New Friend
A heart-warming story of friendship by Adri
Release 2 / Serial number 120514 / Inform 7 build 6G60 (I6/v6.32 lib 6/12N) SD

Bedroom
You've had a long day. All you want to do is climb into bed. But why is your pillow quivering like that?

>clean bed
You vacuum up the dust bunnies. You feel a pang of regret.

* * *

I found a new friend underneath my pillow.

Fingertips: I Found a New Friend
A heart-warming story of friendship by Adri
Release 2 / Serial number 120514 / Inform 7 build 6G60 (I6/v6.32 lib 6/12N) SD

Bedroom
You've had a long day. All you want to do is climb into bed. But why is your pillow quivering like that?

>clean
You can't clean the pillow.

>clean under bed
You feel a pang of regret as you vacuum up the dust bunnies. You decide to go drown your sorrows in a pint of ice cream.

*** You did not make a new friend. ***

* * *

I found a new friend underneath my pillow.

Fingertips: I Found a New Friend
A heart-warming story of friendship by Adri
Release 2 / Serial number 120514 / Inform 7 build 6G60 (I6/v6.32 lib 6/12N) SD

Bedroom
You've had a long day. All you want to do is climb into bed. But why is your pillow quivering like that?

>clean
(the dust bunnies)
You feel a pang of regret as you vacuum up the dust bunnies. You decide to go drown your sorrows in a pint of ice cream.

*** You did not make a new friend. ***

* * *

Bedroom
You've had a long day. All you want to do is climb into bed. But why is your pillow quivering like that?

>hug
You pick up the pillow and give it a gentle squeeze.  When you go to put it back, you see a small creature standing there with its arms raised. It doesn't look like anything you've ever seen before, but it seems friendly enough. You scoop it up and give it a hug.

    *** You made a new friend. ***

Would you like to RESTART, see some suggestions for AMUSING things to do, or QUIT?

* * *

I found a new friend underneath my pillow.

Fingertips: I Found a New Friend
A heart-warming story of friendship by Adri
Release 2 / Serial number 120514 / Inform 7 build 6G60 (I6/v6.32 lib 6/12N) SD

Bedroom
You've had a long day. All you want to do is climb into bed. But why is your pillow quivering like that?

>look under bed
A family of dust bunnies peeks out at you.

>x bunnies
A particularly cheeky bunny winks at you. You wonder momentarily whether this violates the "no pets" clause in your lease.

* * *

I found a new friend underneath my pillow.

Fingertips: I Found a New Friend
A heart-warming story of friendship by Adri
Release 2 / Serial number 120514 / Inform 7 build 6G60 (I6/v6.32 lib 6/12N) SD

Bedroom
You've had a long day. All you want to do is climb into bed. But why is your pillow quivering like that?

>e
You decide to sleep on the sofa tonight. You look under the pillow in the morning, but find nothing.

*** You did not make a new friend. ***

Bedroom
You've had a long day. All you want to do is climb into bed. But why is your pillow quivering like that?

>throw bunnies
That's an odd thing to do.

>throw bed
You can barely move the bed.

* * *

>throw sheep
That's an odd thing to do.

>take sheep
You can't see any such thing.

>throw me
You hurl yourself at the bed. The pillow jumps about an inch in the air, but you don't get a good glimpse at what is underneath.

>throw me at pillow
You hurl yourself at the bed. The pillow jumps about an inch in the air, but you don't get a good glimpse at what is underneath.

* * *

I found a new friend underneath my pillow.

Fingertips: I Found a New Friend
A heart-warming story of friendship by Adri
Release 2 / Serial number 120514 / Inform 7 build 6G60 (I6/v6.32 lib 6/12N) SD

Bedroom
You've had a long day. All you want to do is climb into bed. But why is your pillow quivering like that?

>eat bunnies
That's an odd thing to do.

>eat me
That's an odd thing to do.

>hug sheep
You can only do that to something animate.

>hug bunnies
They're very cute, but you would probably crush them.

>pet bunnies
You reach under the bed and pat a bunny gently on the head. It twitches its nose at you.

>pet sheep
You pat the sheep. You feel silly.

* * *

I found a new friend underneath my pillow.

Fingertips: I Found a New Friend
A heart-warming story of friendship by Adri
Release 2 / Serial number 120514 / Inform 7 build 6G60 (I6/v6.32 lib 6/12N) SD

Bedroom
You've had a long day. All you want to do is climb into bed. But why is your pillow quivering like that?

>clean bunnies
You feel a pang of regret as you vacuum up the dust bunnies. You decide to go drown your sorrows in a pint of ice cream.

*** You did not make a new friend. ***

>take all
There are none at all available!

>drop all
(the pajamas)
But it's time for bed.

>take pajamas
You already have that.

>take bed
You can barely move the bed.

>take friend
You can't see any such thing.

>throw friend
That's an odd thing to do.

>throw bunnies
That's an odd thing to do.

>throw sheep
That's an odd thing to do.

* * *

>clean bunnies
You feel a pang of regret as you vacuum up the dust bunnies. You decide to go drown your sorrows in a pint of ice cream.

*** You did not make a new friend. ***

>clean dust bunnies
You can't clean the dust bunnies.

>clean pillow
You can't clean the pillow.

>clean sheep
You can't clean the sheep.

>clean bunny
You can't clean the dust bunnies.

* * *

>clean bunnies
You feel a pang of regret as you vacuum up the dust bunnies. You decide to go drown your sorrows in a pint of ice cream.

*** You did not make a new friend. ***

Bedroom
You've had a long day. All you want to do is climb into bed. But why is your pillow quivering like that?

* * *

I found a new friend underneath my pillow.

Fingertips: I Found a New Friend
A heart-warming story of friendship by Adri
Release 2 / Serial number 120514 / Inform 7 build 6G60 (I6/v6.32 lib 6/12N) SD

Bedroom
You've had a long day. All you want to do is climb into bed. But why is your pillow quivering like that?

>walk
You decide to sleep on the sofa tonight. You look under the pillow in the morning, but find nothing.

*** You did not make a new friend. ***

>w
Bedroom
You've had a long day. All you want to do is climb into bed. But why is your pillow quivering like that?

>walk away
You can't see any such thing.

>walk n
You decide to sleep on the sofa tonight. You look under the pillow in the morning, but find nothing.

*** You did not make a new friend. ***

Bedroom
You've had a long day. All you want to do is climb into bed. But why is your pillow quivering like that?

* * *

>walk
You decide to sleep on the sofa tonight. You look under the pillow in the morning, but find nothing.

*** You did not make a new friend. ***

Bedroom
You've had a long day. All you want to do is climb into bed. But why is your pillow quivering like that?

>walk away
You decide to sleep on the sofa tonight. You look under the pillow in the morning, but find nothing.

*** You did not make a new friend. ***

Bedroom
You've had a long day. All you want to do is climb into bed. But why is your pillow quivering like that?

>run away
You run away screaming, never to return.

*** You did not make a new friend. ***

Bedroom
You've had a long day. All you want to do is climb into bed. But why is your pillow quivering like that?

>pet
That's not a verb I recognize.

* * *

I found a new friend underneath my pillow.

Fingertips: I Found a New Friend
A heart-warming story of friendship by Adri
Release 2 / Serial number 120514 / Inform 7 build 6G60 (I6/v6.32 lib 6/12N) SD

Bedroom
You've had a long day. All you want to do is climb into bed. But why is your pillow quivering like that?

>run
You run away screaming, never to return.

*** You did not make a new friend. ***

Bedroom
You've had a long day. All you want to do is climb into bed. But why is your pillow quivering like that?

>run out
You decide to sleep on the sofa tonight. You look under the pillow in the morning, but find nothing.

*** You did not make a new friend. ***

Bedroom
You've had a long day. All you want to do is climb into bed. But why is your pillow quivering like that?

>run n
You decide to sleep on the sofa tonight. You look under the pillow in the morning, but find nothing.

*** You did not make a new friend. ***

Bedroom
You've had a long day. All you want to do is climb into bed. But why is your pillow quivering like that?

* * *

>run
You run away screaming, never to return.

*** You did not make a new friend. ***

>r
Bedroom
You've had a long day. All you want to do is climb into bed. But why is your pillow quivering like that?

>run away
You run away screaming, never to return.

*** You did not make a new friend. ***

* * *

Bedroom
You've had a long day. All you want to do is climb into bed. But why is your pillow quivering like that?

>run out
You run away screaming, never to return.

*** You did not make a new friend. ***

Bedroom
You've had a long day. All you want to do is climb into bed. But why is your pillow quivering like that?

>run n
I only understood you as far as wanting to run.

>walk n
You decide to sleep on the sofa tonight. You look under the pillow in the morning, but find nothing.

*** You did not make a new friend. ***

* * *

I found a new friend underneath my pillow.

Fingertips: I Found a New Friend
A heart-warming story of friendship by Adri
Release 2 / Serial number 120514 / Inform 7 build 6G60 (I6/v6.32 lib 6/12N) SD

Bedroom
You've had a long day. All you want to do is climb into bed. But why is your pillow quivering like that?

>run out
You run away screaming, never to return.

*** You did not make a new friend. ***

* * *

I found a new friend underneath my pillow.

Fingertips: I Found a New Friend
A heart-warming story of friendship by Adri
Release 2 / Serial number 120514 / Inform 7 build 6G60 (I6/v6.32 lib 6/12N) SD

Bedroom
You've had a long day. All you want to do is climb into bed. But why is your pillow quivering like that?

>hug bunnies
They're very cute, but you would probably crush them.

* * *

>pet bunnies
You reach under the bed and pat a bunny gently on the head. It twitches its nose at you.

>pet bed
You pat the bed. You feel silly.

>pet me
You pat yourself. You feel silly.

>hug me
You give yourself a hug. You feel better.

* * *

I found a new friend underneath my pillow.

Fingertips: I Found a New Friend
A heart-warming story of friendship by Adri
Release 2 / Serial number 120514 / Inform 7 build 6G60 (I6/v6.32 lib 6/12N) SD

Bedroom
You've had a long day. All you want to do is climb into bed. But why is your pillow quivering like that?

>pet me
You give yourself a soothing pat on the back.

>pet bed
You pat the bed. You feel silly.

>pet pajamas
You pat the pajamas. You feel silly.

* * *

>pet me
You give yourself a soothing pat on the back.

>pet bunnies
You reach under the bed and pat a bunny gently on the head. It twitches its nose at you.

>pet sheep
You can't see any such thing.

* * *

I found a new friend underneath my pillow.

Fingertips: I Found a New Friend
A heart-warming story of friendship by Adri
Release 2 / Serial number 120514 / Inform 7 build 6G60 (I6/v6.32 lib 6/12N) SD

Bedroom
You've had a long day. All you want to do is climb into bed. But why is your pillow quivering like that?

>talk
The pillow stops rustling for a moment and seems to listen to you.

>talk to me
The pillow stops rustling for a moment and seems to listen to you.

>talk to pillow
The pillow stops rustling for a moment and seems to listen to you.

>talk about life
The pillow stops rustling for a moment and seems to listen to you.

>ask pillow about life
The pillow stops rustling for a moment and seems to listen to you.

* * *

>talk
The pillow stops rustling for a moment and seems to listen to you.

>talk to pillow about life
The pillow stops rustling for a moment and seems to listen to you.

* * *

I found a new friend underneath my pillow.

Fingertips: I Found a New Friend
A heart-warming story of friendship by Adri
Release 2 / Serial number 120514 / Inform 7 build 6G60 (I6/v6.32 lib 6/12N) SD

Bedroom
You've had a long day. All you want to do is climb into bed. But why is your pillow quivering like that?

>give pillow to pillow
That's an odd thing to do.

>give bed to pillow
That's an odd thing to do.

>take blanket
You should leave that on the bed.

>point to pillow
That's not a verb I recognize.

>show pillow to pillow
(first taking the pillow)
You pick up the pillow. Underneath it is a creature unlike anything you've ever seen before, but it seems to be friendly. It smiles and waves at you.

    *** You made a new friend. ***

Would you like to RESTART, see some suggestions for AMUSING things to do, or QUIT?

* * *

I found a new friend underneath my pillow.

Fingertips: I Found a New Friend
A heart-warming story of friendship by Adri
Release 2 / Serial number 120514 / Inform 7 build 6G60 (I6/v6.32 lib 6/12N) SD

Bedroom
You've had a long day. All you want to do is climb into bed. But why is your pillow quivering like that?

>say hello
The pillow stops rustling for a moment and seems to listen to you.

>show bed to pillow
That's an odd thing to do.

>run
You run away screaming, never to return.

*** You did not make a new friend. ***

* * *

I found a new friend underneath my pillow.

Fingertips: I Found a New Friend
A heart-warming story of friendship by Adri
Release 2 / Serial number 120514 / Inform 7 build 6G60 (I6/v6.32 lib 6/12N) SD

Bedroom
You've had a long day. All you want to do is climb into bed. But why is your pillow quivering like that?

>drop bed
The bed is already here.

>pour bed
You can't pour the bed.

>spill bed
You can't pour the bed.

>put bed on pillow
(first taking the bed)

You can barely move the bed.
You need to be holding the bed before you can put it on top of something else.

* * *

I found a new friend underneath my pillow.

Fingertips: I Found a New Friend
A heart-warming story of friendship by Adri
Release 2 / Serial number 120514 / Inform 7 build 6G60 (I6/v6.32 lib 6/12N) SD

Bedroom
You've had a long day. All you want to do is climb into bed. But why is your pillow quivering like that?

>put bed on pillow
You can barely move the bed.

>put me on pillow
That's an odd thing to do.

* * *

I found a new friend underneath my pillow.

Fingertips: I Found a New Friend
A heart-warming story of friendship by Adri
Release 2 / Serial number 120514 / Inform 7 build 6G60 (I6/v6.32 lib 6/12N) SD

Bedroom
You've had a long day. All you want to do is climb into bed. But why is your pillow quivering like that?

>sit on pillow
You press down on the pillow. You hear a muffled scream, and the pillow stops moving.

*** You did not make a new friend. ***

* * *

Bedroom
You've had a long day. All you want to do is climb into bed. But why is your pillow quivering like that?

>put me on pillow
You press down on the pillow. You hear a muffled scream, and the pillow stops moving.

*** You did not make a new friend. ***

Bedroom
You've had a long day. All you want to do is climb into bed. But why is your pillow quivering like that?

>put bed on pillow
You can barely move the bed.

(first taking the bed)

You can barely move the bed.
You need to be holding the bed before you can put it on top of something else.

* * *

I found a new friend underneath my pillow.

Fingertips: I Found a New Friend
A heart-warming story of friendship by Adri
Release 2 / Serial number 120514 / Inform 7 build 6G60 (I6/v6.32 lib 6/12N) SD

Bedroom
You've had a long day. All you want to do is climb into bed. But why is your pillow quivering like that?

>put me on bed
You sit on the edge of the bed.

(first taking yourself)

You are always self-possessed.
You need to be holding yourself before you can put yourself on top of something else.

>put me on pillow
You press down on the pillow. You hear a muffled scream, and the pillow stops moving.

*** You did not make a new friend. ***

* * *

Bedroom
You've had a long day. All you want to do is climb into bed. But why is your pillow quivering like that?

>put me on me
No matter how you twist and turn, you can't seem to manage that.

* * *

Bedroom
You've had a long day. All you want to do is climb into bed. But why is your pillow quivering like that?

>put pillow on pillow
That's an odd thing to do.

>put pillow on bed
The pillow is already on the bed.

>put pillow on me
You pick up the pillow. Underneath it is a creature unlike anything you've ever seen before, but it seems to be friendly. It smiles and waves at you.

    *** You made a new friend. ***

Would you like to RESTART, see some suggestions for AMUSING things to do, or QUIT?

>restart
I found a new friend underneath my pillow.

Fingertips: I Found a New Friend
A heart-warming story of friendship by Adri
Release 1 / Serial number 120219 / Inform 7 build 6G60 (I6/v6.32 lib 6/12N) SD

Bedroom
You've had a long day. All you want to do is climb into bed. But why is your pillow quivering like that?

>put bed on pillow
You can barely move the bed.

>put bed on me
You can barely move the bed.

>put pajamas on me
You already have that.

* * *

I found a new friend underneath my pillow.

Fingertips: I Found a New Friend
A heart-warming story of friendship by Adri
Release 2 / Serial number 120514 / Inform 7 build 6G60 (I6/v6.32 lib 6/12N) SD

Bedroom
You've had a long day. All you want to do is climb into bed. But why is your pillow quivering like that?

>put pajamas on me
You already have that.

>put pajamas on bed
But it's time for bed.

* * *

I found a new friend underneath my pillow.

Fingertips: I Found a New Friend
A heart-warming story of friendship by Adri
Release 2 / Serial number 120514 / Inform 7 build 6G60 (I6/v6.32 lib 6/12N) SD

Bedroom
You've had a long day. All you want to do is climb into bed. But why is your pillow quivering like that?

>poke
That's not a verb I recognize.

>touch
(the pajamas)
You feel nothing unexpected.

* * *

I found a new friend underneath my pillow.

Fingertips: I Found a New Friend
A heart-warming story of friendship by Adri
Release 2 / Serial number 120514 / Inform 7 build 6G60 (I6/v6.32 lib 6/12N) SD

Bedroom
You've had a long day. All you want to do is climb into bed. But why is your pillow quivering like that?

>touch me
You give yourself a soothing pat on the back.

>touch pajamas
You know the dinosaurs aren't real, right?

>jab
That's not a verb I recognize.

>pet pillow
You rub the pillow in a soothing manner. You hear a soft purring sound, and a tiny creature crawls out from underneath the pillow. It's unlike anything you've ever seen before, but it seems friendly enough. You reach out and stroke its head.

    *** You made a new friend. ***

Would you like to RESTART, see some suggestions for AMUSING things to do, or QUIT?

Please give one of the answers above.

Would you like to RESTART, see some suggestions for AMUSING things to do, or QUIT?

>restart
I found a new friend underneath my pillow.

Fingertips: I Found a New Friend
A heart-warming story of friendship by Adri
Release 1 / Serial number 120219 / Inform 7 build 6G60 (I6/v6.32 lib 6/12N) SD

Bedroom
You've had a long day. All you want to do is climb into bed. But why is your pillow quivering like that?

* * *

I found a new friend underneath my pillow.

Fingertips: I Found a New Friend
A heart-warming story of friendship by Adri
Release 2 / Serial number 120514 / Inform 7 build 6G60 (I6/v6.32 lib 6/12N) SD

Bedroom
You've had a long day. All you want to do is climb into bed. But why is your pillow quivering like that?

>poke pillow
You give the pillow a quick jab. You hear an "eep" and the pillow stops moving for a moment.

>poke me
You give yourself a quick jab. Ouch.

>poke bed
You give the bed a quick jab. Nothing happens.

* * *

>poke pillow
You give the pillow a quick jab. You hear an "eep" and the pillow stops moving for a moment.

>touch pillow
You rub the pillow in a soothing manner. You hear a soft purring sound, and a tiny creature crawls out from underneath the pillow. It's unlike anything you've ever seen before, but it seems friendly enough. You reach out and stroke its head.

    *** You made a new friend. ***

Would you like to RESTART, see some suggestions for AMUSING things to do, or QUIT?

>restart
I found a new friend underneath my pillow.

Fingertips: I Found a New Friend
A heart-warming story of friendship by Adri
Release 1 / Serial number 120219 / Inform 7 build 6G60 (I6/v6.32 lib 6/12N) SD

Bedroom
You've had a long day. All you want to do is climb into bed. But why is your pillow quivering like that?

>touch it
I'm not sure what "it" refers to.

>touch
(the pajamas)
You know the dinosaurs aren't real, right?

* * *

I found a new friend underneath my pillow.

Fingertips: I Found a New Friend
A heart-warming story of friendship by Adri
Release 2 / Serial number 120514 / Inform 7 build 6G60 (I6/v6.32 lib 6/12N) SD

Bedroom
You've had a long day. All you want to do is climb into bed. But why is your pillow quivering like that?

>x wall
You pause to admire the wallpaper. Delightful.

>look under bed
A family of dust bunnies peeks out at you.

>count bunnies
There are 69,105 dust bunnies here.

* * *

I found a new friend underneath my pillow.

Fingertips: I Found a New Friend
A heart-warming story of friendship by Adri
Release 2 / Serial number 120514 / Inform 7 build 6G60 (I6/v6.32 lib 6/12N) SD

Bedroom
You've had a long day. All you want to do is climb into bed. But why is your pillow quivering like that?

>throw pillow at wall
You pick up the pillow and throw it at the wall. Underneath it is a creature unlike anything you've ever seen before. It seems more afraid of you than you are of it, but you're so freaked out that you squash it.

*** You did not make a new friend. ***

Bedroom
You've had a long day. All you want to do is climb into bed. But why is your pillow quivering like that?

>throw pillow at bed
You pick up the pillow and throw it at the wall. Underneath it is a creature unlike anything you've ever seen before. It seems more afraid of you than you are of it, but you're so freaked out that you squash it.

*** You did not make a new friend. ***

Bedroom
You've had a long day. All you want to do is climb into bed. But why is your pillow quivering like that?

* * *

I found a new friend underneath my pillow.

Fingertips: I Found a New Friend
A heart-warming story of friendship by Adri
Release 2 / Serial number 120514 / Inform 7 build 6G60 (I6/v6.32 lib 6/12N) SD

Bedroom
You've had a long day. All you want to do is climb into bed. But why is your pillow quivering like that?

>attack ne
You must name something more substantial.

>attack me
Violence isn't the answer to this one.

>throw wall
That's an odd thing to do.

>drop pillow
You haven't got him.

* * *

I found a new friend underneath my pillow.

Fingertips: I Found a New Friend
A heart-warming story of friendship by Adri
Release 2 / Serial number 120514 / Inform 7 build 6G60 (I6/v6.32 lib 6/12N) SD

Bedroom
You've had a long day. All you want to do is climb into bed. But why is your pillow quivering like that?

>throw bed at me
That's an odd thing to do.

>throw bed at pillow
You press down on the pillow. You hear a muffled scream, and the pillow stops moving.

*** You did not make a new friend. ***

Bedroom
You've had a long day. All you want to do is climb into bed. But why is your pillow quivering like that?

>take bed
You can barely move the bed.

>take bunnies
You can't see any such thing.

>take sheep
You can't see any such thing.

>drop sheep
You haven't got that.

* * *

I found a new friend underneath my pillow.

Fingertips: I Found a New Friend
A heart-warming story of friendship by Adri
Release 2 / Serial number 120514 / Inform 7 build 6G60 (I6/v6.32 lib 6/12N) SD

Bedroom
You've had a long day. All you want to do is climb into bed. But why is your pillow quivering like that?

>hug sheep
You can't see any such thing.

>x sheep
That only exists in your head.

* * *

>hug sheep
You can't see any such thing.

>hug bunny
They're very cute, but you would probably crush them.

>clean sheep
You can't clean the sheep.

* * *

>clean bunny
You can't clean the dust bunnies.

>count bunnies
There are 69,105 dust bunnies here.

>x bunnies
A particularly cheeky bunny winks at you. You wonder momentarily whether this violates the "no pets" clause in your lease.

>pet bunnies
You reach under the bed and pat a bunny gently on the head. It twitches its nose at you.

* * *

>hug sheep
You can't see any such thing.

>pet sheep
You can't see any such thing.

>hug bunnies
They're very cute, but you would probably crush them.

* * *

>pet bunnies
You reach under the bed and pat a bunny gently on the head. It twitches its nose at you.

>count bunnies
There are 69,105 dust bunnies here.

>xyzzy
A tired voice says, "Zzzzy".

>feed pillow
You can't feed the pillow.

>feed bunnies
You can't see any such thing.

* * *

I found a new friend underneath my pillow.

Fingertips: I Found a New Friend
A heart-warming story of friendship by Adri
Release 2 / Serial number 120514 / Inform 7 build 6G60 (I6/v6.32 lib 6/12N) SD

Bedroom
You've had a long day. All you want to do is climb into bed. But why is your pillow quivering like that?

>clean sheep
You can't clean the sheep.

>clean bed
You feel a pang of regret as you vacuum up the dust bunnies. You decide to go drown your sorrows in a pint of ice cream.

*** You did not make a new friend. ***

Bedroom
You've had a long day. All you want to do is climb into bed. But why is your pillow quivering like that?

* * *

I found a new friend underneath my pillow.

Fingertips: I Found a New Friend
A heart-warming story of friendship by Adri
Release 2 / Serial number 120514 / Inform 7 build 6G60 (I6/v6.32 lib 6/12N) SD

Bedroom
You've had a long day. All you want to do is climb into bed. But why is your pillow quivering like that?

>throw bunnies
You can't see any such thing.

>throw foo at wall
You can't see any such thing.

>throw wall
That's an odd thing to do.

* * *

>throw bunnies
You can't see any such thing.

>throw sheep
You can't see any such thing.

>throw bed
You can barely move the bed.

>throw pajamas
You already have that.

>throw beddng
You can't see any such thing.

>throw bedding
You should leave that on the bed.

>crawl
You can't crawl.

>crawl under bed
You can't crawl under the bed.

* * *

I found a new friend underneath my pillow.

Fingertips: I Found a New Friend
A heart-warming story of friendship by Adri
Release 2 / Serial number 120514 / Inform 7 build 6G60 (I6/v6.32 lib 6/12N) SD

Bedroom
You've had a long day. All you want to do is climb into bed. But why is your pillow quivering like that?

>touch it
I'm not sure what "it" refers to.

>don't make a new friend
That's not a verb I recognize.

>throw bedding
That's an odd thing to do.

* * *

I found a new friend underneath my pillow.

Fingertips: I Found a New Friend
A heart-warming story of friendship by Adri
Release 2 / Serial number 120514 / Inform 7 build 6G60 (I6/v6.32 lib 6/12N) SD

Bedroom
You've had a long day. All you want to do is climb into bed. But why is your pillow quivering like that?

>don't make a new friend
You run away screaming, never to return.

*** You did not make a new friend. ***

Bedroom
You've had a long day. All you want to do is climb into bed. But why is your pillow quivering like that?

* * *

I found a new friend underneath my pillow.

Fingertips: I Found a New Friend
A heart-warming story of friendship by Adri
Release 2 / Serial number 120514 / Inform 7 build 6G60 (I6/v6.32 lib 6/12N) SD

Bedroom
You've had a long day. All you want to do is climb into bed. But why is your pillow quivering like that?

>enter
That's not something you can enter.

>lie
That's not something you can lie down on.

* * *

I found a new friend underneath my pillow.

Fingertips: I Found a New Friend
A heart-warming story of friendship by Adri
Release 2 / Serial number 120514 / Inform 7 build 6G60 (I6/v6.32 lib 6/12N) SD

Bedroom
You've had a long day. All you want to do is climb into bed. But why is your pillow quivering like that?

>lie down
(on the bed)
You're too tired to deal with this right now. You curl up in bed and fall fast asleep. You look under the pillow in the morning, but find nothing.

*** You did not make a new friend. ***

>lie on bed
You get onto the bed.

You're too tired to deal with this right now. You curl up in bed and fall fast asleep. You look under the pillow in the morning, but find nothing.

*** You did not make a new friend. ***

>l
Bedroom (on the bed)
You've had a long day. All you want to do is climb into bed. But why is your pillow quivering like that?

* * *

>lie down
(on the bed)
You're too tired to deal with this right now. You curl up in bed and fall fast asleep. You look under the pillow in the morning, but find nothing.

*** You did not make a new friend. ***

>go to sleep
You're too tired to deal with this right now. You curl up in bed and fall fast asleep. You look under the pillow in the morning, but find nothing.

*** You did not make a new friend. ***

Bedroom
You've had a long day. All you want to do is climb into bed. But why is your pillow quivering like that?

>lie
(in the bed)
You get onto the bed.

You're too tired to deal with this right now. You curl up in bed and fall fast asleep. You look under the pillow in the morning, but find nothing.

*** You did not make a new friend. ***

Bedroom (on the bed)
You've had a long day. All you want to do is climb into bed. But why is your pillow quivering like that?

>lie on bed
But you're already on the bed.

* * *

Bedroom
You've had a long day. All you want to do is climb into bed. But why is your pillow quivering like that?

>find
(the friend)
You pick up the pillow. Underneath it is a creature unlike anything you've ever seen before, but it seems to be friendly. It smiles and waves at you.

    *** You made a new friend. ***

Would you like to RESTART, see some suggestions for AMUSING things to do, or QUIT?

>restart
I found a new friend underneath my pillow.

Fingertips: I Found a New Friend
A heart-warming story of friendship by Adri
Release 1 / Serial number 120219 / Inform 7 build 6G60 (I6/v6.32 lib 6/12N) SD

Bedroom
You've had a long day. All you want to do is climb into bed. But why is your pillow quivering like that?

>make
What would you like to make?

* * *

I found a new friend underneath my pillow.

Fingertips: I Found a New Friend
A heart-warming story of friendship by Adri
Release 2 / Serial number 120514 / Inform 7 build 6G60 (I6/v6.32 lib 6/12N) SD

Bedroom
You've had a long day. All you want to do is climb into bed. But why is your pillow quivering like that?

>lie on bed
You're too tired to deal with this right now. You curl up in bed and fall fast asleep. You look under the pillow in the morning, but find nothing.

*** You did not make a new friend. ***

* * *

Bedroom
You've had a long day. All you want to do is climb into bed. But why is your pillow quivering like that?

>lie down
I didn't understand that sentence.

>go to bed
You're too tired to deal with this right now. You curl up in bed and fall fast asleep. You look under the pillow in the morning, but find nothing.

*** You did not make a new friend. ***

Bedroom
You've had a long day. All you want to do is climb into bed. But why is your pillow quivering like that?

>lie down on bed
I didn't understand that sentence.

* * *

I found a new friend underneath my pillow.

Fingertips: I Found a New Friend
A heart-warming story of friendship by Adri
Release 2 / Serial number 120514 / Inform 7 build 6G60 (I6/v6.32 lib 6/12N) SD

Bedroom
You've had a long day. All you want to do is climb into bed. But why is your pillow quivering like that?

>i
Your pajamas don't have any pockets.

>fuck
Your pillow seems to cower in fear.

>pet
You must supply a noun.

* * *

>i
Your pajamas don't have any pockets.

>l
Bedroom
You've had a long day. All you want to do is climb into bed. But why is your pillow quivering like that?

>x bed
Your aunt made you this quilt as a Christmas present. It's an abstract pattern of brightly colored shapes. It balances out your boring white sheets.

* * *

I found a new friend underneath my pillow.

Fingertips: I Found a New Friend
A heart-warming story of friendship by Adri
Release 2 / Serial number 120514 / Inform 7 build 6G60 (I6/v6.32 lib 6/12N) SD

Bedroom
You've had a long day. All you want to do is climb into bed. But why is your pillow quivering like that?

>pet
(the pillow)
You rub the pillow in a soothing manner. You hear a soft purring sound, and a tiny creature crawls out from underneath the pillow. It's unlike anything you've ever seen before, but it seems friendly enough. You reach out and stroke its head.

    *** You made a new friend. ***

Would you like to RESTART, see some suggestions for AMUSING things to do, or QUIT?

>restart
I found a new friend underneath my pillow.

Fingertips: I Found a New Friend
A heart-warming story of friendship by Adri
Release 1 / Serial number 120219 / Inform 7 build 6G60 (I6/v6.32 lib 6/12N) SD

Bedroom
You've had a long day. All you want to do is climb into bed. But why is your pillow quivering like that?

>eat
You must supply a noun.

* * *

I found a new friend underneath my pillow.

Fingertips: I Found a New Friend
A heart-warming story of friendship by Adri
Release 2 / Serial number 120514 / Inform 7 build 6G60 (I6/v6.32 lib 6/12N) SD

Bedroom
You've had a long day. All you want to do is climb into bed. But why is your pillow quivering like that?

>count
(the sheep)
You close your eyes and envision a fluffy white sheep jumping over a fence. One.

>count sheep
You close your eyes and envision a fluffy white sheep jumping over a fence. One.

* * *

I found a new friend underneath my pillow.

Fingertips: I Found a New Friend
A heart-warming story of friendship by Adri
Release 2 / Serial number 120514 / Inform 7 build 6G60 (I6/v6.32 lib 6/12N) SD

Bedroom
You've had a long day. All you want to do is climb into bed. But why is your pillow quivering like that?

>undress
But it's time for bed.

>remove
(the pajamas)
But it's time for bed.

>take off
(the pillow)
You haven't got him.

* * *

>undress
But it's time for bed.

>take off
(the pajamas)
But it's time for bed.

* * *

I found a new friend underneath my pillow.

Fingertips: I Found a New Friend
A heart-warming story of friendship by Adri
Release 2 / Serial number 120514 / Inform 7 build 6G60 (I6/v6.32 lib 6/12N) SD

Bedroom
You've had a long day. All you want to do is climb into bed. But why is your pillow quivering like that?

>remove
(the pajamas)
But it's time for bed.

>undress
But it's time for bed.

>remove bed
You're not wearing that.

* * *

I found a new friend underneath my pillow.

Fingertips: I Found a New Friend
A heart-warming story of friendship by Adri
Release 2 / Serial number 120514 / Inform 7 build 6G60 (I6/v6.32 lib 6/12N) SD

Bedroom
You've had a long day. All you want to do is climb into bed. But why is your pillow quivering like that?

>undo
[You can't "undo" what hasn't been done!]

>l
Bedroom
You've had a long day. All you want to do is climb into bed. But why is your pillow quivering like that?

>undo
There is no need to do that.

* * *

I found a new friend underneath my pillow.

Fingertips: I Found a New Friend
A heart-warming story of friendship by Adri
Release 2 / Serial number 120514 / Inform 7 build 6G60 (I6/v6.32 lib 6/12N) SD

Bedroom
You've had a long day. All you want to do is climb into bed. But why is your pillow quivering like that?

>throw bed at pillow
You can barely move the bed.

* * *

>throw bed at bed
That's an odd thing to do.

>throw bed at me
You can barely move the bed.

>throw pillow at me
That's an odd thing to do.

>throw pillow at me
That's an odd thing to do.

>throw bunny at pillow
You can't see any such thing.

>throw me at bunny
That's an odd thing to do.

>throw beding
You can't see any such thing.

>throw beding
You can't see any such thing.

>throw bedding
That's an odd thing to do.

>throw bedding at pillow
You press down on the pillow. You hear a muffled scream, and the pillow stops moving.

*** You did not make a new friend. ***

Bedroom
You've had a long day. All you want to do is climb into bed. But why is your pillow quivering like that?

* * *

I found a new friend underneath my pillow.

Fingertips: I Found a New Friend
A heart-warming story of friendship by Adri
Release 2 / Serial number 120514 / Inform 7 build 6G60 (I6/v6.32 lib 6/12N) SD

Bedroom
You've had a long day. All you want to do is climb into bed. But why is your pillow quivering like that?

>put bedding on bed
You should leave that on the bed.

>put pajamas on em
You can't see any such thing.

>put pajamas on me
You already have that.

* * *

I found a new friend underneath my pillow.

Fingertips: I Found a New Friend
A heart-warming story of friendship by Adri
Release 2 / Serial number 120514 / Inform 7 build 6G60 (I6/v6.32 lib 6/12N) SD

Bedroom
You've had a long day. All you want to do is climb into bed. But why is your pillow quivering like that?

>throw wall at bed
That's an odd thing to do.

>throw wall
That's an odd thing to do.

>throw wall at pillow
You press down on the pillow. You hear a muffled scream, and the pillow stops moving.

*** You did not make a new friend. ***

Bedroom
You've had a long day. All you want to do is climb into bed. But why is your pillow quivering like that?

* * *

I found a new friend underneath my pillow.

Fingertips: I Found a New Friend
A heart-warming story of friendship by Adri
Release 2 / Serial number 120514 / Inform 7 build 6G60 (I6/v6.32 lib 6/12N) SD

Bedroom
You've had a long day. All you want to do is climb into bed. But why is your pillow quivering like that?

I beg your pardon?

I beg your pardon?

* * *

I found a new friend underneath my pillow.

Fingertips: I Found a New Friend
A heart-warming story of friendship by Adri
Release 2 / Serial number 120514 / Inform 7 build 6G60 (I6/v6.32 lib 6/12N) SD

Bedroom
You've had a long day. All you want to do is climb into bed. But why is your pillow quivering like that?

>throw wall at me
That's an odd thing to do.

>throw pajamas
That's an odd thing to do.

>throw bunnies at me
You can't see any such thing.

* * *

I found a new friend underneath my pillow.

Fingertips: I Found a New Friend
A heart-warming story of friendship by Adri
Release 2 / Serial number 120514 / Inform 7 build 6G60 (I6/v6.32 lib 6/12N) SD

Bedroom
You've had a long day. All you want to do is climb into bed. But why is your pillow quivering like that?

>throw pillow at me
That's an odd thing to do.

>throw pillow at bunnies
You pick up the pillow and throw it at the pillow. Underneath it is a creature unlike anything you've ever seen before. It seems more afraid of you than you are of it, but you're so freaked out that you squash it.

*** You did not make a new friend. ***

Bedroom
You've had a long day. All you want to do is climb into bed. But why is your pillow quivering like that?

>throw pillow at bunnies
You pick up the pillow and throw it at the pillow. Underneath it is a creature unlike anything you've ever seen before. It seems more afraid of you than you are of it, but you're so freaked out that you squash it.

*** You did not make a new friend. ***

* * *

Bedroom
You've had a long day. All you want to do is climb into bed. But why is your pillow quivering like that?

>throw pillow at pillow
That's an odd thing to do.

* * *

>throw pillow at me
That's an odd thing to do.

>throw pillow at bed
You pick up the pillow and throw it at the bed. Underneath it is a creature unlike anything you've ever seen before. It seems more afraid of you than you are of it, but you're so freaked out that you squash it.

*** You did not make a new friend. ***

Bedroom
You've had a long day. All you want to do is climb into bed. But why is your pillow quivering like that?

* * *

I found a new friend underneath my pillow.

Fingertips: I Found a New Friend
A heart-warming story of friendship by Adri
Release 2 / Serial number 120514 / Inform 7 build 6G60 (I6/v6.32 lib 6/12N) SD

Bedroom
You've had a long day. All you want to do is climb into bed. But why is your pillow quivering like that?

>crawl under bed
You crawl underneath the bed. The bunnies immediately swarm over you, and you're never heard from again.

*** You did not make a new friend. ***

* * *

I found a new friend underneath my pillow.

Fingertips: I Found a New Friend
A heart-warming story of friendship by Adri
Release 2 / Serial number 120514 / Inform 7 build 6G60 (I6/v6.32 lib 6/12N) SD

Bedroom
You've had a long day. All you want to do is climb into bed. But why is your pillow quivering like that?

>put pillow on bed
The pillow is already on the bed.

>jump on bed
You jump around on the bed like a monkey.

* * *

I found a new friend underneath my pillow.

Fingertips: I Found a New Friend
A heart-warming story of friendship by Adri
Release 2 / Serial number 120514 / Inform 7 build 6G60 (I6/v6.32 lib 6/12N) SD

Bedroom
You've had a long day. All you want to do is climb into bed. But why is your pillow quivering like that?

>put me on me
No matter how you twist and turn, you can't seem to manage that.

>put me on bed
You sit on the edge of the bed.

>put me on wall
You can't sit on that.

>put me on pillow
You press down on the pillow. You hear a muffled scream, and the pillow stops moving.

*** You did not make a new friend. ***

* * *

Bedroom
You've had a long day. All you want to do is climb into bed. But why is your pillow quivering like that?

>put me on bedding
You can't sit on that.

* * *

I found a new friend underneath my pillow.

Fingertips: I Found a New Friend
A heart-warming story of friendship by Adri
Release 2 / Serial number 120514 / Inform 7 build 6G60 (I6/v6.32 lib 6/12N) SD

Bedroom
You've had a long day. All you want to do is climb into bed. But why is your pillow quivering like that?

>throw me at bedding
You hurl yourself at the bed. The pillow jumps about an inch in the air, but you don't get a good glimpse at what is underneath.

>throw me at bed
You hurl yourself at the bed. The pillow jumps about an inch in the air, but you don't get a good glimpse at what is underneath.

* * *

>throw me at bedding
You hurl yourself at the bed. The pillow jumps about an inch in the air, but you don't get a good glimpse at what is underneath.

>lie on bed
You're too tired to deal with this right now. You curl up in bed and fall fast asleep. You look under the pillow in the morning, but find nothing.

*** You did not make a new friend. ***

* * *

Bedroom
You've had a long day. All you want to do is climb into bed. But why is your pillow quivering like that?

>lie on bedding
You're too tired to deal with this right now. You curl up in bed and fall fast asleep. You look under the pillow in the morning, but find nothing.

*** You did not make a new friend. ***

Bedroom
You've had a long day. All you want to do is climb into bed. But why is your pillow quivering like that?

* * *

I found a new friend underneath my pillow.

Fingertips: I Found a New Friend
A heart-warming story of friendship by Adri
Release 2 / Serial number 120514 / Inform 7 build 6G60 (I6/v6.32 lib 6/12N) SD

Bedroom
You've had a long day. All you want to do is climb into bed. But why is your pillow quivering like that?

>eat bedding
That's an odd thing to do.

* * *

I found a new friend underneath my pillow.

Fingertips: I Found a New Friend
A heart-warming story of friendship by Adri
Release 2 / Serial number 120514 / Inform 7 build 6G60 (I6/v6.32 lib 6/12N) SD

Bedroom
You've had a long day. All you want to do is climb into bed. But why is your pillow quivering like that?

>enter bedding
You can't go in that direction.

>eat bed
That's an odd thing to do.

* * *

I found a new friend underneath my pillow.

Fingertips: I Found a New Friend
A heart-warming story of friendship by Adri
Release 2 / Serial number 120514 / Inform 7 build 6G60 (I6/v6.32 lib 6/12N) SD

Bedroom
You've had a long day. All you want to do is climb into bed. But why is your pillow quivering like that?

>throw bedding
no

* * *

I found a new friend underneath my pillow.

Fingertips: I Found a New Friend
A heart-warming story of friendship by Adri
Release 2 / Serial number 120514 / Inform 7 build 6G60 (I6/v6.32 lib 6/12N) SD

Bedroom
You've had a long day. All you want to do is climb into bed. But why is your pillow quivering like that?

>drop pillow onbed
I only understood you as far as wanting to drop the pillow.

>drop pillow on bed
The pillow is already on the bed.

>drop pillow on wall
You pick up the pillow. Underneath it is a creature unlike anything you've ever seen before, but it seems to be friendly. It smiles and waves at you.

    *** You made a new friend. ***

Would you like to RESTART, see some suggestions for AMUSING things to do, or QUIT?

* * *

I found a new friend underneath my pillow.

Fingertips: I Found a New Friend
A heart-warming story of friendship by Adri
Release 2 / Serial number 120514 / Inform 7 build 6G60 (I6/v6.32 lib 6/12N) SD

Bedroom
You've had a long day. All you want to do is climb into bed. But why is your pillow quivering like that?

>put pillow on wall
You pick up the pillow and throw it at the wall. Underneath it is a creature unlike anything you've ever seen before. It seems more afraid of you than you are of it, but you're so freaked out that you squash it.

*** You did not make a new friend. ***

Bedroom
You've had a long day. All you want to do is climb into bed. But why is your pillow quivering like that?

>put pillow on bed
You pick up the pillow and throw it at the wall. Underneath it is a creature unlike anything you've ever seen before. It seems more afraid of you than you are of it, but you're so freaked out that you squash it.

*** You did not make a new friend. ***

Bedroom
You've had a long day. All you want to do is climb into bed. But why is your pillow quivering like that?

* * *

>up
You are already standing.

* * *

I found a new friend underneath my pillow.

Fingertips: I Found a New Friend
A heart-warming story of friendship by Adri
Release 2 / Serial number 120514 / Inform 7 build 6G60 (I6/v6.32 lib 6/12N) SD

Bedroom
You've had a long day. All you want to do is climb into bed. But why is your pillow quivering like that?

>stand
You are already standing.

>stand on bed
I only understood you as far as wanting to stand.

* * *

I found a new friend underneath my pillow.

Fingertips: I Found a New Friend
A heart-warming story of friendship by Adri
Release 2 / Serial number 120514 / Inform 7 build 6G60 (I6/v6.32 lib 6/12N) SD

Bedroom
You've had a long day. All you want to do is climb into bed. But why is your pillow quivering like that?

>stand up
You decide to sleep on the sofa tonight. You look under the pillow in the morning, but find nothing.

*** You did not make a new friend. ***

Bedroom
You've had a long day. All you want to do is climb into bed. But why is your pillow quivering like that?

* * *

I found a new friend underneath my pillow.

Fingertips: I Found a New Friend
A heart-warming story of friendship by Adri
Release 2 / Serial number 120514 / Inform 7 build 6G60 (I6/v6.32 lib 6/12N) SD

Bedroom
You've had a long day. All you want to do is climb into bed. But why is your pillow quivering like that?

>hug me
You give yourself a hug. You feel better.

>hug bunnies
They're very cute, but you would probably crush them.

* * *

I found a new friend underneath my pillow.

Fingertips: I Found a New Friend
A heart-warming story of friendship by Adri
Release 2 / Serial number 120514 / Inform 7 build 6G60 (I6/v6.32 lib 6/12N) SD

Bedroom
You've had a long day. All you want to do is climb into bed. But why is your pillow quivering like that?

>pet bed
You pat the bed. You feel silly.

* * *

I found a new friend underneath my pillow.

Fingertips: I Found a New Friend
A heart-warming story of friendship by Adri
Release 2 / Serial number 120514 / Inform 7 build 6G60 (I6/v6.32 lib 6/12N) SD

Bedroom
You've had a long day. All you want to do is climb into bed. But why is your pillow quivering like that?

>poke me
You give yourself a quick jab. Ouch.

* * *

>poke bed
You give the bed a quick jab. Nothing happens.

>poke pillow
You give the pillow a quick jab. You hear an "eep" and the pillow stops moving for a moment. Then a strange creature walks out from behind it and shakes its head disapprovingly at you.

*** You did not make a new friend. ***

Bedroom
You've had a long day. All you want to do is climb into bed. But why is your pillow quivering like that?

* * *

I found a new friend underneath my pillow.

Fingertips: I Found a New Friend
A heart-warming story of friendship by Adri
Release 2 / Serial number 120514 / Inform 7 build 6G60 (I6/v6.32 lib 6/12N) SD

Bedroom
You've had a long day. All you want to do is climb into bed. But why is your pillow quivering like that?

>hint
What's the name of the game?

>help
What's the name of the game?

>xyzzy
A tired voice says, "Zzzzy".

>count sheep
You close your eyes and envision a fluffy white sheep jumping over a fence. One.

* * *

>count sheep
Another sheep jumps over the fence. Two.

>throw pillow
You pick up the pillow and throw it at the wall. Underneath it is a creature unlike anything you've ever seen before. It seems more afraid of you than you are of it, but you're so freaked out that you squash it.

*** You did not make a new friend. ***

* * *

Bedroom
You've had a long day. All you want to do is climb into bed. But why is your pillow quivering like that?

>throw pillow
You pick up the pillow and throw it at the wall. Underneath it is a creature unlike anything you've ever seen before. It seems more afraid of you than you are of it, but you're so freaked out that you squash it.

*** You did not make a new friend. ***

* * *

>count sheep
You close your eyes and envision a fluffy white sheep jumping over a fence. One.

>take pillow
You pick up the pillow. Underneath it is a creature unlike anything you've ever seen before, but it seems to be friendly. It smiles and waves at you.

    *** You made a new friend. ***

Would you like to RESTART, see some suggestions for AMUSING things to do, or QUIT?

Please give one of the answers above.

Would you like to RESTART, see some suggestions for AMUSING things to do, or QUIT?

>amusing
Have you tried...
- making a new friend?
- casting xyzzy?
- sleeping?
- counting sheep? Multiple times?
- looking at the sheep? Multiple times?
- looking at your pajamas?
- jumping on the bed?
- making the bed?
- looking under the bed?
- looking at the dust bunnies?
- counting the dust bunnies?
- hugging or petting the dust bunnies?
- cleaning under the bed?
- counting yourself?
- eating the pillow?
- attacking the pillow?
- throwing the pillow?
- singing and dancing?
- crying and screaming?
- crawling underneath the bed?
- jumping on the bed?
- throwing yourself?
- running away?
- hugging or petting the pillow?
- finding all twelve endings?

Would you like to RESTART, see some suggestions for AMUSING things to do, or QUIT?

>restart
I found a new friend underneath my pillow.

Fingertips: I Found a New Friend
A heart-warming story of friendship by Adri
Release 1 / Serial number 120220 / Inform 7 build 6G60 (I6/v6.32 lib 6/12N) SD

Bedroom
You've had a long day. All you want to do is climb into bed. But why is your pillow quivering like that?

* * *

I found a new friend underneath my pillow.

Fingertips: I Found a New Friend
A heart-warming story of friendship by Adri
Release 2 / Serial number 120514 / Inform 7 build 6G60 (I6/v6.32 lib 6/12N) SD

Bedroom
You've had a long day. All you want to do is climb into bed. But why is your pillow quivering like that?

>yell
Your pillow seems to cower in fear.

>run away
You run away screaming, never to return.

*** You did not make a new friend. ***

* * *

I found a new friend underneath my pillow.

Fingertips: I Found a New Friend
A heart-warming story of friendship by Adri
Release 2 / Serial number 120514 / Inform 7 build 6G60 (I6/v6.32 lib 6/12N) SD

Bedroom
You've had a long day. All you want to do is climb into bed. But why is your pillow quivering like that?

>point
(at the pillow)
That's an odd thing to do.

>show bed to pillow
That's an odd thing to do.

>take
(the pillow)
You pick up the pillow. Underneath it is a creature unlike anything you've ever seen before, but it seems to be friendly. It smiles and waves at you.

    *** You made a new friend. ***

Would you like to RESTART, see some suggestions for AMUSING things to do, or QUIT?

>restart
I found a new friend underneath my pillow.

Fingertips: I Found a New Friend
A heart-warming story of friendship by Adri
Release 1 / Serial number 120221 / Inform 7 build 6G60 (I6/v6.32 lib 6/12N) SD

Bedroom
You've had a long day. All you want to do is climb into bed. But why is your pillow quivering like that?

>talk
The pillow stops rustling for a moment and seems to listen to you.

>x pillow
There seems to be something underneath your pillow.

* * *

I found a new friend underneath my pillow.

Fingertips: I Found a New Friend
A heart-warming story of friendship by Adri
Release 2 / Serial number 120514 / Inform 7 build 6G60 (I6/v6.32 lib 6/12N) SD

Bedroom
You've had a long day. All you want to do is climb into bed. But why is your pillow quivering like that?

>z
You pause to assess the situation. You're tired, and there seems to be something underneath your pillow.

>z
You pause to assess the situation. You're very tired, and there seems to be something underneath your pillow.

>z
You pause to assess the situation. You're exhausted, and there seems to be something underneath your pillow.

>z
You spend so much time thinking about what to do that whatever was under your pillow decides to find a new friend elsewhere. You eventually look under the pillow, but find nothing.

*** You did not make a new friend. ***

Bedroom
You've had a long day. All you want to do is climb into bed. But why is your pillow quivering like that?

* * *

>z
You spend so much time thinking about what to do that whatever was under your pillow decides to find a new friend elsewhere. You eventually look under the pillow, but find nothing.

*** You did not make a new friend. ***

>r
Bedroom
You've had a long day. All you want to do is climb into bed. But why is your pillow quivering like that?

* * *

>z
You spend so much time thinking about what to do that whatever was under your pillow decides to find a new friend elsewhere. You eventually look under the pillow, but find nothing.

*** You did not make a new friend. ***

>z
You pause to assess the situation. You're exhausted, and there seems to be something underneath your pillow.

>z
You pause to assess the situation. You're exhausted, and there seems to be something underneath your pillow.

>z
You pause to assess the situation. You're exhausted, and there seems to be something underneath your pillow.

You're too tired to deal with this right now. You curl up in bed and fall fast asleep. You look under the pillow in the morning, but find nothing.

*** You did not make a new friend. ***

>z
Bedroom
You've had a long day. All you want to do is climb into bed. But why is your pillow quivering like that?

* * *

I found a new friend underneath my pillow.

Fingertips: I Found a New Friend
A heart-warming story of friendship by Adri
Release 2 / Serial number 120514 / Inform 7 build 6G60 (I6/v6.32 lib 6/12N) SD

Bedroom
You've had a long day. All you want to do is climb into bed. But why is your pillow quivering like that?

>look behind pillow
You pick up the pillow. Underneath it is a creature unlike anything you've ever seen before, but it seems to be friendly. It smiles and waves at you.

    *** You made a new friend. ***

Would you like to RESTART, see some suggestions for AMUSING things to do, or QUIT?

>restart
I found a new friend underneath my pillow.

Fingertips: I Found a New Friend
A heart-warming story of friendship by Adri
Release 1 / Serial number 120225 / Inform 7 build 6G60 (I6/v6.32 lib 6/12N) SD

Bedroom
You've had a long day. All you want to do is climb into bed. But why is your pillow quivering like that?

>look behind bed
You can't look behind the bed.

You can't look behind the bed.

* * *

I found a new friend underneath my pillow.

Fingertips: I Found a New Friend
A heart-warming story of friendship by Adri
Release 2 / Serial number 120514 / Inform 7 build 6G60 (I6/v6.32 lib 6/12N) SD

Bedroom
You've had a long day. All you want to do is climb into bed. But why is your pillow quivering like that?

>look behind me
You find nothing of interest.

>look behind bed
A family of dust bunnies peeks out at you.

>look behind wall
You find nothing of interest.

>push pillow
It is fixed in place.

>push bed
It is fixed in place.

* * *

I found a new friend underneath my pillow.

Fingertips: I Found a New Friend
A heart-warming story of friendship by Adri
Release 2 / Serial number 120514 / Inform 7 build 6G60 (I6/v6.32 lib 6/12N) SD

Bedroom
You've had a long day. All you want to do is climb into bed. But why is your pillow quivering like that?

>push pillow
You press down on the pillow. You hear a muffled scream, and the pillow stops moving.

*** You did not make a new friend. ***

Bedroom
You've had a long day. All you want to do is climb into bed. But why is your pillow quivering like that?

>pul pillow
That's not a verb I recognize.

>pull pillow
You pick up the pillow. Underneath it is a creature unlike anything you've ever seen before, but it seems to be friendly. It smiles and waves at you.

    *** You made a new friend. ***

Would you like to RESTART, see some suggestions for AMUSING things to do, or QUIT?

>restart
I found a new friend underneath my pillow.

Fingertips: I Found a New Friend
A heart-warming story of friendship by Adri
Release 1 / Serial number 120225 / Inform 7 build 6G60 (I6/v6.32 lib 6/12N) SD

Bedroom
You've had a long day. All you want to do is climb into bed. But why is your pillow quivering like that?

>turn the pillow over
I only understood you as far as wanting to turn the pillow.

* * *

I found a new friend underneath my pillow.

Fingertips: I Found a New Friend
A heart-warming story of friendship by Adri
Release 2 / Serial number 120514 / Inform 7 build 6G60 (I6/v6.32 lib 6/12N) SD

Bedroom
You've had a long day. All you want to do is climb into bed. But why is your pillow quivering like that?

>turn the pillow over
You pick up the pillow. Underneath it is a creature unlike anything you've ever seen before, but it seems to be friendly. It smiles and waves at you.

    *** You made a new friend. ***

Would you like to RESTART, see some suggestions for AMUSING things to do, or QUIT?

* * *

I found a new friend underneath my pillow.

Fingertips: I Found a New Friend
A heart-warming story of friendship by Adri
Release 2 / Serial number 120514 / Inform 7 build 6G60 (I6/v6.32 lib 6/12N) SD

Bedroom
You've had a long day. All you want to do is climb into bed. But why is your pillow quivering like that?

>chew on pillow
You nibble on your pillow. It tastes like marshmallow.

>pet bed
You pat the bed. You feel silly.

* * *

I found a new friend underneath my pillow.

Fingertips: I Found a New Friend
A heart-warming story of friendship by Adri
Release 2 / Serial number 120514 / Inform 7 build 6G60 (I6/v6.32 lib 6/12N) SD

Bedroom
You've had a long day. All you want to do is climb into bed. But why is your pillow quivering like that?

>about
"I Found a New Friend" was written for the Apollo 18+20 tribute album. Thanks so much to Kevin Jackson-Mead for organizing the compilation and inspiring me to finally write my first (and second!) game. Thank you to everyone in PR-IF and on ifMUD for just generally being encouraging and helpful. Special thanks to Johnny Rivera who was super helpful when I accidentally deleted my source code. Thank you to everyone who provided feedback on the game, especially cyberskunk, Lorenzo Batallones, Felix Plesoianu and jpt. And last, but not least, thanks to They Might Be Giants for making awesome music.

>hint
What's the name of the game?

* * *

I found a new friend underneath my pillow.

Fingertips: I Found a New Friend
A heart-warming story of friendship by Adri
Release 2 / Serial number 120514 / Inform 7 build 6G60 (I6/v6.32 lib 6/12N) SD

Bedroom
You've had a long day. All you want to do is climb into bed. But why is your pillow quivering like that?

>hit pillow
You press down on the pillow. You hear a muffled scream, and the pillow stops moving.

*** You did not make a new friend. ***

Bedroom
You've had a long day. All you want to do is climb into bed. But why is your pillow quivering like that?

>hit
(the pillow)
You press down on the pillow. You hear a muffled scream, and the pillow stops moving.

*** You did not make a new friend. ***

Bedroom
You've had a long day. All you want to do is climb into bed. But why is your pillow quivering like that?

>hit wall
Violence isn't the answer to this one.

* * *

I found a new friend underneath my pillow.

Fingertips: I Found a New Friend
A heart-warming story of friendship by Adri
Release 2 / Serial number 120514 / Inform 7 build 6G60 (I6/v6.32 lib 6/12N) SD

Bedroom
You've had a long day. All you want to do is climb into bed. But why is your pillow quivering like that?

>x wallpaper
You pause to admire the wallpaper. Delightful.

* * *

I found a new friend underneath my pillow.

Fingertips: I Found a New Friend
A heart-warming story of friendship by Adri
Release 2 / Serial number 120514 / Inform 7 build 6G60 (I6/v6.32 lib 6/12N) SD

Bedroom
You've had a long day. All you want to do is climb into bed. But why is your pillow quivering like that?

>x outlet
There is a blue canary in the outlet by the light switch.

The light switch is currently switched on.

>admire
That's not a verb I recognize.

* * *

>x outlet
There is a blue canary in the outlet by the light switch.

The light switch is currently switched on.

>turn out light
I only understood you as far as wanting to turn outside.

>turn off light
You switch the light switch off.

>x outlet
There is a blue canary in the outlet by the light switch.

The light switch is currently switched off.

* * *

I found a new friend underneath my pillow.

Fingertips: I Found a New Friend
A heart-warming story of friendship by Adri
Release 2 / Serial number 120514 / Inform 7 build 6G60 (I6/v6.32 lib 6/12N) SD

Bedroom
You've had a long day. All you want to do is climb into bed. But why is your pillow quivering like that?

>admire wallpaper
I only understood you as far as wanting to admire.

* * *

I found a new friend underneath my pillow.

Fingertips: I Found a New Friend
A heart-warming story of friendship by Adri
Release 2 / Serial number 120514 / Inform 7 build 6G60 (I6/v6.32 lib 6/12N) SD

Bedroom
You've had a long day. All you want to do is climb into bed. But why is your pillow quivering like that?

>admire
That's not a verb I recognize.

>x wallpaper
You pause to admire the wallpaper. Delightful.

>x canary
There is a blue canary in the outlet by the light switch.

>take wallpaper
That's hardly portable.

>throw wallpaper
That's hardly portable.

>throw outlet
That's hardly portable.

* * *

I found a new friend underneath my pillow.

Fingertips: I Found a New Friend
A heart-warming story of friendship by Adri
Release 2 / Serial number 120514 / Inform 7 build 6G60 (I6/v6.32 lib 6/12N) SD

Bedroom
You've had a long day. All you want to do is climb into bed. But why is your pillow quivering like that?

>clean under bed
You feel a pang of regret as you vacuum up the dust bunnies. You decide to go drown your sorrows in a pint of ice cream.

*** You did not make a new friend. ***

Bedroom
You've had a long day. All you want to do is climb into bed. But why is your pillow quivering like that?

* * *

I found a new friend underneath my pillow.

Fingertips: I Found a New Friend
A heart-warming story of friendship by Adri
Release 2 / Serial number 120514 / Inform 7 build 6G60 (I6/v6.32 lib 6/12N) SD

Bedroom
You've had a long day. All you want to do is climb into bed. But why is your pillow quivering like that?

>attack bunnies
Violence isn't the answer to this one.

>crush
(the pillow)
You can't crush the pillow.

* * *

I found a new friend underneath my pillow.

Fingertips: I Found a New Friend
A heart-warming story of friendship by Adri
Release 2 / Serial number 120514 / Inform 7 build 6G60 (I6/v6.32 lib 6/12N) SD

Bedroom
You've had a long day. All you want to do is climb into bed. But why is your pillow quivering like that?

>crush bunnies
Violence isn't the answer to this one.

>attack bunnies
Violence isn't the answer to this one.

* * *

>crush bunnies
Violence isn't the answer to this one.

>admire wallpaper
You pause to admire the wallpaper. Delightful.

>press pillow
You press down on the pillow. You hear a muffled scream, and the pillow stops moving.

*** You did not make a new friend. ***

Bedroom
You've had a long day. All you want to do is climb into bed. But why is your pillow quivering like that?

* * *

I found a new friend underneath my pillow.

Fingertips: I Found a New Friend
A heart-warming story of friendship by Adri
Release 2 / Serial number 120514 / Inform 7 build 6G60 (I6/v6.32 lib 6/12N) SD

Bedroom
You've had a long day. All you want to do is climb into bed. But why is your pillow quivering like that?

>press down on pillow
You press down on the pillow. You hear a muffled scream, and the pillow stops moving.

*** You did not make a new friend. ***

Bedroom
You've had a long day. All you want to do is climb into bed. But why is your pillow quivering like that?

* * *

I found a new friend underneath my pillow.

Fingertips: I Found a New Friend
A heart-warming story of friendship by Adri
Release 2 / Serial number 120514 / Inform 7 build 6G60 (I6/v6.32 lib 6/12N) SD

Bedroom
You've had a long day. All you want to do is climb into bed. But why is your pillow quivering like that?

>push down on pillow
You press down on the pillow. You hear a muffled scream, and the pillow stops moving.

*** You did not make a new friend. ***

Bedroom
You've had a long day. All you want to do is climb into bed. But why is your pillow quivering like that?

>kill pillow
You must supply a noun.

* * *

I found a new friend underneath my pillow.

Fingertips: I Found a New Friend
A heart-warming story of friendship by Adri
Release 2 / Serial number 120514 / Inform 7 build 6G60 (I6/v6.32 lib 6/12N) SD

Bedroom
You've had a long day. All you want to do is climb into bed. But why is your pillow quivering like that?

>smother friend
Violence isn't the answer to this one.

* * *

I found a new friend underneath my pillow.

Fingertips: I Found a New Friend
A heart-warming story of friendship by Adri
Release 2 / Serial number 120514 / Inform 7 build 6G60 (I6/v6.32 lib 6/12N) SD

Bedroom
You've had a long day. All you want to do is climb into bed. But why is your pillow quivering like that?

>x canary
There is a blue canary in the outlet by the light switch.

* * *

I found a new friend underneath my pillow.

Fingertips: I Found a New Friend
A heart-warming story of friendship by Adri
Release 2 / Serial number 120514 / Inform 7 build 6G60 (I6/v6.32 lib 6/12N) SD

Bedroom
You've had a long day. All you want to do is climb into bed. But why is your pillow quivering like that?

>attack friend
You press down on the pillow. You hear a muffled scream, and the pillow stops moving.

*** You did not make a new friend. ***

* * *

I found a new friend underneath my pillow.

Fingertips: I Found a New Friend
A heart-warming story of friendship by Adri
Release 2 / Serial number 120514 / Inform 7 build 6G60 (I6/v6.32 lib 6/12N) SD

Bedroom
You've had a long day. All you want to do is climb into bed. But why is your pillow quivering like that?

>vacuum under bed
You feel a pang of regret as you vacuum up the dust bunnies. You decide to go drown your sorrows in a pint of ice cream.

*** You did not make a new friend. ***

Bedroom
You've had a long day. All you want to do is climb into bed. But why is your pillow quivering like that?

* * *

>vacuum under bed
You feel a pang of regret as you vacuum up the dust bunnies. You decide to go drown your sorrows in a pint of ice cream.

*** You did not make a new friend. ***

>v
Bedroom
You've had a long day. All you want to do is climb into bed. But why is your pillow quivering like that?

>vacuum bunnies
You feel a pang of regret as you vacuum up the dust bunnies. You decide to go drown your sorrows in a pint of ice cream.

*** You did not make a new friend. ***

Bedroom
You've had a long day. All you want to do is climb into bed. But why is your pillow quivering like that?

* * *

I found a new friend underneath my pillow.

Fingertips: I Found a New Friend
A heart-warming story of friendship by Adri
Release 2 / Serial number 120514 / Inform 7 build 6G60 (I6/v6.32 lib 6/12N) SD

Bedroom
You've had a long day. All you want to do is climb into bed. But why is your pillow quivering like that?

>sleep
You're too tired to deal with this right now. You turn out the light, curl up in bed and fall fast asleep. You look under the pillow in the morning, but find nothing.

*** You did not make a new friend. ***

Bedroom
You've had a long day. All you want to do is climb into bed. But why is your pillow quivering like that?

* * *

>count sheep
You close your eyes and envision a fluffy white sheep jumping over a fence. One.

>z
You pause to assess the situation. You're tired, and there seems to be something underneath your pillow.

>count sheep
Another sheep jumps over the fence. Two.

>g
This sheep seems to struggle a bit, but finally makes it over the fence. Three.

>z.z.z
You pause to assess the situation. You're very tired, and there seems to be something underneath your pillow.

You pause to assess the situation. You're exhausted, and there seems to be something underneath your pillow.

You spend so much time thinking about what to do that whatever was under your pillow decides to find a new friend elsewhere. You eventually look under the pillow, but find nothing.

*** You did not make a new friend. ***

>r
Bedroom
You've had a long day. All you want to do is climb into bed. But why is your pillow quivering like that?

>count sheep.g.g.g.g.
You close your eyes and envision a fluffy white sheep jumping over a fence. One.

Another sheep jumps over the fence. Two.

This sheep seems to struggle a bit, but finally makes it over the fence. Three.

Another sheep jumps over the fence. Four.

The next sheep chooses to walk around the fence. Five.

>g
Another sheep jumps over the fence. Six.

>g
The next thing you know, the sun is shining. You must have fallen asleep. You look under your pillow, but find nothing there.

*** You did not make a new friend. ***

>g
Bedroom
You've had a long day. All you want to do is climb into bed. But why is your pillow quivering like that?

>go to bed
You're too tired to deal with this right now. You curl up in bed and fall fast asleep. You look under the pillow in the morning, but find nothing.

*** You did not make a new friend. ***

* * *

>sleep
You're too tired to deal with this right now. You turn out the light, curl up in bed and fall fast asleep. You look under the pillow in the morning, but find nothing.

*** You did not make a new friend. ***

>x
Bedroom
You've had a long day. All you want to do is climb into bed. But why is your pillow quivering like that?

* * *

I found a new friend underneath my pillow.

Fingertips: I Found a New Friend
A heart-warming story of friendship by Adri
Release 2 / Serial number 120514 / Inform 7 build 6G60 (I6/v6.32 lib 6/12N) SD

Bedroom
You've had a long day. All you want to do is climb into bed. But why is your pillow quivering like that?

>make new friend
You pick up the pillow. Underneath it is a creature unlike anything you've ever seen before, but it seems to be friendly. It smiles and waves at you.

    *** You made a new friend. ***

Would you like to RESTART, see some suggestions for AMUSING things to do, view available ENDINGS, or QUIT?

>amusing
 > Cult Revisions
   Military Revisions

   Cult Revisions
 > Military Revisions
   Cult Revisions
 > Military Revisions

 > Cult Revisions
   Military Revisions
 > Cult Revisions
   Military Revisions

>q
Would you like to RESTART, see some suggestions for AMUSING things to do, view available ENDINGS, or QUIT?

* * *

I found a new friend underneath my pillow.

Fingertips: I Found a New Friend
A heart-warming story of friendship by Adri
Release 2 / Serial number 120514 / Inform 7 build 6G60 (I6/v6.32 lib 6/12N) SD

Bedroom
You've had a long day. All you want to do is climb into bed. But why is your pillow quivering like that?

>amusing
That's not a verb I recognize.

>make friend
You pick up the pillow. Underneath it is a creature unlike anything you've ever seen before, but it seems to be friendly. It smiles and waves at you.

    *** You made a new friend. ***

Would you like to RESTART, see some suggestions for AMUSING things to do, view available ENDINGS, or QUIT?

>endings
There are no endings.

Would you like to RESTART, see some suggestions for AMUSING things to do, view available ENDINGS, or QUIT?

* * *

I found a new friend underneath my pillow.

Fingertips: I Found a New Friend
A heart-warming story of friendship by Adri
Release 2 / Serial number 120514 / Inform 7 build 6G60 (I6/v6.32 lib 6/12N) SD

Bedroom
You've had a long day. All you want to do is climb into bed. But why is your pillow quivering like that?

>make bed
You made the bed this morning when you got up.

>look under bed
A family of dust bunnies peeks out at you.

>hug sheep
You can't see any such thing.

* * *

>hug bunny
They're very cute, but you would probably crush them.

>kiss bunny
You can't see any such thing.

>kiss me
If you think that'll help.

>pet me
You give yourself a soothing pat on the back.

>hug me
You give yourself a hug. You feel better.

>hug pajamas
You can only do that to something animate.

>look under bed
A family of dust bunnies peeks out at you.

>eat pillow
You nibble on your pillow. It tastes like marshmallow.

>talk to bunny
You can't see any such thing.

>scream
Your pillow seems to cower in fear.

>fuck
Your pillow seems to cower in fear.

>talk to pillow
The pillow stops rustling for a moment and seems to listen to you.

>x wallpaper
You pause to admire the wallpaper. Delightful.

* * *

>x canary
There is a blue canary in the outlet by the light switch.

>listen
There's some rustling sounds coming from under your pillow.

>z
You pause to assess the situation. You're tired, and there seems to be something underneath your pillow.

* * *

>z
You pause to assess the situation. You're exhausted, and there seems to be something underneath your pillow.

>l
Bedroom
You've had a long day. All you want to do is climb into bed. But why is your pillow quivering like that?

>look around
You can't see any such thing.

>turn off light
You can't see any such thing.

>turn off light switch
That's not something you can switch.

* * *

I found a new friend underneath my pillow.

Fingertips: I Found a New Friend
A heart-warming story of friendship by Adri
Release 2 / Serial number 120514 / Inform 7 build 6G60 (I6/v6.32 lib 6/12N) SD

Bedroom
You've had a long day. All you want to do is climb into bed. But why is your pillow quivering like that?

>turn on light
That's already on.

>turn off light
You switch the outlet off.

>x light
There is a blue canary in the outlet by the light switch.

The outlet is currently switched off.

* * *

I found a new friend underneath my pillow.

Fingertips: I Found a New Friend
A heart-warming story of friendship by Adri
Release 2 / Serial number 120514 / Inform 7 build 6G60 (I6/v6.32 lib 6/12N) SD

Bedroom
You've had a long day. All you want to do is climb into bed. But why is your pillow quivering like that?

>flip light
You switch the light switch off.

>turn light on
You switch the light switch on.

>turn out light
I only understood you as far as wanting to turn outside.

* * *

I found a new friend underneath my pillow.

Fingertips: I Found a New Friend
A heart-warming story of friendship by Adri
Release 2 / Serial number 120514 / Inform 7 build 6G60 (I6/v6.32 lib 6/12N) SD

Bedroom
You've had a long day. All you want to do is climb into bed. But why is your pillow quivering like that?

>turn off light
You switch the light switch off.

>turn out light
That's already off.

>turn on light
You switch the light switch on.

>x light
There is a blue canary in the outlet by the light switch.

The light switch is currently switched on.

* * *

>turn off light
You switch the light switch off.

>x light
There is a blue canary in the outlet by the light switch. It watches over you.

>vacuum under bed
You feel a pang of regret as you vacuum up the dust bunnies. You decide to go drown your sorrows in a pint of ice cream.

*** You did not make a new friend. ***

* * *

Bedroom
You've had a long day. All you want to do is climb into bed. But why is your pillow quivering like that?

>x light
There is a blue canary in the outlet by the light switch. It watches over you.

* * *

I found a new friend underneath my pillow.

Fingertips: I Found a New Friend
A heart-warming story of friendship by Adri
Release 2 / Serial number 120514 / Inform 7 build 6G60 (I6/v6.32 lib 6/12N) SD

Bedroom
You've had a long day. All you want to do is climb into bed. But why is your pillow quivering like that?

>x light
There is a blue canary in the outlet by the light switch. The light is turned on.

>turn off light
You switch the light switch off.

* * *

>x light
There is a blue canary in the outlet by the light switch. It watches over you.

>take canary
That's fixed in place.

* * *

I found a new friend underneath my pillow.

Fingertips: I Found a New Friend
A heart-warming story of friendship by Adri
Release 2 / Serial number 120514 / Inform 7 build 6G60 (I6/v6.32 lib 6/12N) SD

Bedroom
You've had a long day. All you want to do is climb into bed. But why is your pillow quivering like that?

>take outlet
You should leave that where it is.

>eat outlet
That's an odd thing to do.

>lick outlet
That's not a verb I recognize.

>x surroundings
You can't see any such thing.

>make friend
You pick up the pillow. Underneath it is a creature unlike anything you've ever seen before, but it seems to be friendly. It smiles and waves at you.

    *** You made a new friend. ***

Would you like to RESTART, see some suggestions for AMUSING things to do, view available ENDINGS, or QUIT?

* * *

>endings
- Making a new friend
- Hugging the pillow
- Petting the pillow
- Cleaning under the bed
- Going to bed
- Waiting four times
- Counting sheep seven times
- Examining sheep eight times
- Throwing the pillow at something
- Crawling under the bed
- Running away
- Leaving the room
- Jumping on the bed
- Poking the pillow
- Attacking the pillow

Would you like to RESTART, see some suggestions for AMUSING things to do, view available ENDINGS, or QUIT?

>amusing
Have you tried...
- counting sheep?
- looking at the sheep?
- looking under the bed?
- interacting with the dust bunnies?
- examining your surroundings?
- vocalizing?
- throwing yourself?
- finding all fifteen endings?

Would you like to RESTART, see some suggestions for AMUSING things to do, view available ENDINGS, or QUIT?

* * *

I found a new friend underneath my pillow.

Fingertips: I Found a New Friend
A heart-warming story of friendship by Adri
Release 2 / Serial number 120514 / Inform 7 build 6G60 (I6/v6.32 lib 6/12N) SD

Bedroom
You've had a long day. All you want to do is climb into bed. But why is your pillow quivering like that?

>turn off light.vacuum under bed.
You switch the light switch off.

You feel a pang of regret as you vacuum up the dust bunnies. You decide to go drown your sorrows in a pint of ice cream.

*** You did not make a new friend. ***

Bedroom
You've had a long day. All you want to do is climb into bed. But why is your pillow quivering like that?

>x light
There is a blue canary in the outlet by the light switch. The light is turned on.