'Twas the night before Christmas when all through the house, the only creature stirring was a hippo the size of a mouse.

This year you're going to stay awake long enough to see Santa Claws. You have set up a temporary nest in the hallway closet, and it just needs a few final touches. You intend to venture out to have a snack and look at the tree one more time, and then you will go hide in the closet and wait.

And A Hippo New Year
an interactive holiday tale by Adri ("Erin Gigglecreek")
Release 1 / Serial number 130108 / Inform 7 build 6G60 (I6/v6.32 lib 6/12N) SD

If you are unfamiliar with Interactive Fiction, type HELP for a quick introduction on how to play. 

Living Room
There is a tree here, decorated with ornaments and surrounded by piles of presents. There is also a table off to one side. The hallway closet is to the southeast.

>x me
You are a very fine specimen of Hippopotamus domestica.

>i
You are carrying nothing.

>x hat
You can't see any such thing.

>take hat
Taken.

>i
You are carrying:
  a santa hat

>wear hat
You wear the hat.

You are a hungry, hungry hippo.

* * *

>search presents
You find a tiny santa hat.

You slip the hat on over your ears. You look adorable!

>show hat to at
You can't see any such thing.

>show hat to cat
The cat could not care less about your santa hat

* * *

>help
 > About "And A Hippo New Year"
   How to Play
   Credits

"And A Hippo New Year" was created for Yuletide 2012, an annual fanfiction exchange. It is based in the world of the House Hippo, a PSA by the Concerned Children's Advertisers.

Please press SPACE to continue.

 > About "And A Hippo New Year"
   How to Play
   Credits
 > About "And A Hippo New Year"
   How to Play
   Credits

   About "And A Hippo New Year"
 > How to Play
   Credits
   About "And A Hippo New Year"
 > How to Play
   Credits

 > About Interactive Fiction
   What to do with >
   Getting Started
   Rooms and Travel
   Objects
   Controlling the Game
   How the World is Assembled
   If You Get Stuck

>q
   About "And A Hippo New Year"
 > How to Play
   Credits

 > About Interactive Fiction
   What to do with >
   Getting Started
   Rooms and Travel
   Objects
   Controlling the Game
   How the World is Assembled
   If You Get Stuck

* * *

>q
   About "And A Hippo New Year"
 > How to Play
   Credits

   About "And A Hippo New Year"
   How to Play
 > Credits
   About "And A Hippo New Year"
   How to Play
 > Credits

Yuletide offerings are anonymous until New Year's Day. Until then, "Erin" can be contacted with feedback at gigglecreek@gmail.com.

The house hippo was created by the Concerned Children's Advertisers, and appears here without permission. The original PSA can be viewed on CCA's official YouTube channel:  http://www.youtube.com/watch?v=G9hJK4fCq4U.

Please press SPACE to continue.

* * *

>about
 > About "And A Hippo New Year"
   How to Play
   Credits

"And A Hippo New Year" was created for Yuletide 2012, an annual fanfiction exchange. It is based in the world of the House Hippo, a PSA by the Concerned Children's Advertisers.

Please press SPACE to continue.

* * *

 > About "And A Hippo New Year"
   How to Play
   Credits
 > About "And A Hippo New Year"
   How to Play
   Credits

* * *

   About "And A Hippo New Year"
   How to Play
 > Credits
   About "And A Hippo New Year"
   How to Play
 > Credits

Credits will go here. Beta testers, Yuletide, owner of House Hippo, Emily's menu system, etc

Please press SPACE to continue.

   About "And A Hippo New Year"
   How to Play
 > Credits
   About "And A Hippo New Year"
   How to Play
 > Credits

* * *

   About "And A Hippo New Year"
 > How to Play
   Credits
   About "And A Hippo New Year"
 > How to Play
   Credits

   About "And A Hippo New Year"
   How to Play
 > Credits
   About "And A Hippo New Year"
   How to Play
 > Credits

The author can be contacted at <genericgeekgirl@gmail.com>.

Thanks so much to my beta testers, who were happy to provide feedback on incredibly short notice: Jacqueline A. Lott, Matthew Miller, Ryan Spicer, Scott McCasland and Zach.

The house hippo was created by the Concerned Children's Advertisers, and appears here without permission.

Please press SPACE to continue.

* * *

   About "And A Hippo New Year"
   How to Play
 > Credits
   About "And A Hippo New Year"
   How to Play
 > Credits

>q
Living Room
There is a tree here.

>xyzzy
I want a hippopotamus for Christmas.
Only a hippopotamus will do.

* * *

The author can be contacted at <genericgeekgirl@gmail.com>.

Thanks so much to my beta testers, who were happy to provide feedback on incredibly short notice: Jacqueline A. Lott, Matthew Miller, Ryan Spicer, Scott McCasland and Zach.

The house hippo was created by the Concerned Children's Advertisers, and appears here without permission.

Please press SPACE to continue.

   About "And A Hippo New Year"
   How to Play
 > Credits
   About "And A Hippo New Year"
   How to Play
 > Credits

   About "And A Hippo New Year"
 > How to Play
   Credits
   About "And A Hippo New Year"
 > How to Play
   Credits

>p
 > About "And A Hippo New Year"
   How to Play
   Credits
 > About "And A Hippo New Year"
   How to Play
   Credits

"And A Hippo New Year" was created for Yuletide 2012, an annual fanfiction exchange. It is based in the world of the House Hippo, a PSA by the Concerned Children's Advertisers.

Please press SPACE to continue.

   About "And A Hippo New Year"
   How to Play
 > Credits
   About "And A Hippo New Year"
   How to Play
 > Credits

Yuletide offerings are anonymous until New Year's Day. Until then, "Erin" can be contacted with feedback at gigglecreek@gmail.com.

The house hippo was created by the Concerned Children's Advertisers, and appears here without permission. The original PSA is short and super cute, and can be viewed on CCA's YouTube channel at http://www.youtube.com/watch?v=G9hJK4fCq4U.

Please press SPACE to continue.

* * *

   About "And A Hippo New Year"
   How to Play
 > Credits
   About "And A Hippo New Year"
   How to Play
 > Credits

>q
Living Room
There is a tree here, decorated with ornaments and surrounded by piles of presents. The hallway closet is to the southeast.

>LOOK
Living Room
There is a tree here, decorated with ornaments and surrounded by piles of presents. The hallway closet is to the southeast.

>test me
(Testing.)

>[1] x presents
There are piles of presents surrounding the tree. There is one rather tall pile of presents in a neat stack.

>[2] push presents
You don't have any reason to push those around. Yet.

>[3] look under tree
You don't see much with all the presents in the way.

>[4] wear hat
You can't see any such thing.

>[5] up
You climb to the top of the presents. You seem to be about level with a table, on which stands a glass of milk and a plate of cookies. The pile starts to wobble, and you quickly make your way back down.

Living Room
There is a tree here, decorated with ornaments and surrounded by piles of presents. There is also a table, about the same height as the stack of presents under the tree. The hallway closet is to the southeast.

>[6] eat cookie
You can't see any such thing.

>[7] push milk
You can't see any such thing.

>[8] look under table
You find the remains of a melted icicle.

>[9] drink puddle
You lap at the cold water and feel instantly refreshed.

[Your score has just gone up by three points.]

>[10] se

Hallway Closet
This is the closet where you will be spending the night. It is full of things that you don't need to think about right now.

You can see your nest and a mitten here.

>[11] take mitten
You pick up the wet mitten. Ick. Soggy mittens don't make good bedding material.

>[12] nw

Living Room
There is a tree here, decorated with ornaments and surrounded by piles of presents. There is also a table, about the same height as the stack of presents under the tree. The hallway closet is to the southeast.

>[13] put mitten on lights
You lay the mitten across the string of lights where it nearly touches the floor.

>[14] take garland
You tug on a dangling bit of garland with your teeth. A piece breaks off, about as long as you are.

[Your score has just gone up by one point.]

>[15] se

Hallway Closet
This is the closet where you will be spending the night. It is full of things that you don't need to think about right now.

You can see your nest here.

>[16] drop mitten
You can't see any such thing.

>[17] nw

Living Room
There is a tree here, decorated with ornaments and surrounded by piles of presents. There is also a table, about the same height as the stack of presents under the tree. The hallway closet is to the southeast.

The mitten starts to smoke. You'd better go get it before you burn down the house.

>[18] take mitten
You quickly retrieve the mitten. It is now dry, and almost too hot to touch.

You can only carry one thing in your mouth at a time. But some items can be pushed around or worn.

[Your score has just gone up by three points.]

>[19] se

Hallway Closet
This is the closet where you will be spending the night. It is full of things that you don't need to think about right now.

You can see your nest here.

>[20] drop mitten
You can't see any such thing.

* * *

>push presents
You try with all your might, but it barely moves.

>up
You scramble up the pile of presents.

High above the Living Room
You can see a cookie and a glass of milk here.

>take cookie
Taken.

You find yourself staring at nothing and wondering how it would taste.

>down
You carefully climb back down the stack of presents.

Living Room
Description, blah blah blah, tree and presents and cookies and milk and so on.

You can see a cat here.

>search presents
You find a tiny santa hat.

You slip the hat on over your ears. You look adorable!

>remove hat
But it looks so cute on you!

You find yourself staring at the Christmas tree and wondering how it would taste.

>g
You shake off the santa hat. It falls to the floor.

>show hat to cat
You aren't holding the santa hat.

* * *

>push presents
You try with all your might, but it barely moves.

>x presents
There are piles of presents surrounding the tree. There is one rather tall pile of presents in a neat stack.

>push presents
You don't have any reason to push those around. Maybe you can climb them first.

>look under table
You find the remains of a melted icicle.

* * *

>take presents
Those don't appear to be for you.

>g
What would santa think?

>g
Those don't appear to be for you.

You are a hungry, hungry hippo.

>g
Those don't appear to be for you.

* * *

>look presents
A pile of presents stacked neatly under the tree, with the largest package on the bottom and the smallest at the top.

>climb presents
You climb to the top of the presents. You seem to be about level with the table, on which stands a glass of milk and a plate of cookies. The pile starts to wobble, and you quickly make your way back down.

>take presents
Those don't appear to be for you. Maybe Santa will bring you something nice if you're good.

Your tummy makes a rumbling sound.

>g
Stop it. What would Santa think?

>g
Naughty hippos don't receive presents.

>g
Just leave the presents alone, ok? Maybe you can PUSH or PULL them instead.

You are a hungry, hungry hippo.

>g
Just leave the presents alone, ok? Maybe you can PUSH or PULL them instead.

>pull presents
You grip the lowest package in your teeth and give it a tug. The entire stack wobbles. Maybe you would have more luck if you pushed from the other side.

>push presents
You push the bottom package with your head, being careful to prevent the pile from falling over. It's hard work, but eventually you move the entire stack over to the table.

You find yourself staring at the presents and wondering how they would taste.

>up
You scramble up the pile of presents.

High above the Living Room
You can see a cookie and a glass of milk here.

>down
You carefully climb back down the stack of presents.

Living Room
Description, blah blah blah, tree and presents and cookies and milk and so on.

You can see a cat here.

>push presents
You decide to leave the presents where they are.

You find yourself staring at the presents and wondering how they would taste.

>take presents
Just leave the presents alone, ok? Maybe you can PUSH or PULL them instead.

>knock oer
That's not a verb I recognize.

>knock over
If you can see an object, you can usually just interact with it directly without worrying about your position. Try a command like EXAMINE CAT for a closer look at something, LOOK to get a new description of this location, or a direction like UP (or U) to move to a different location.

To stop these messages entirely, type NOVICE OFF.

* * *

>knock over presents
You rear up with the intention of pushing over the pile of presents, and then you stop. It seems that they would be more useful to you in a neat pile.

* * *

>open present
You pick out the prettiest present in the pile and tug on the ribbon with your teeth. The ribbon slips ever so slightly, and you feel a sudden burst of shame.

>unwrap present
You pick out the prettiest present in the pile and tug on the ribbon with your teeth. The ribbon slips ever so slightly, and you feel a sudden burst of shame.

>eat present
You give the presents a lick. Bleh! That doesn't appear to be food.

You find yourself staring at the Christmas tree and wondering how they would taste.

* * *

>lick present
You give the present. a lick. Bleh! That doesn't appear to be food.

* * *

>lick presents
You give the pile of presents a lick. Bleh! That doesn't appear to be food.

>push presents
You push the bottom package with your head, being careful to prevent the pile from falling over. It's hard work, but eventually you move the entire stack over to the table.

* * *

>lick presents
You give the pile of presents a lick. Bleh! That doesn't appear to be food.

>push tree
You try with all your might, but it barely moves.

>pull tree
You try with all your might, but it barely moves.

You find yourself staring at the cat and wondering how it would taste.

>take tree
There's no way you could lift that.

* * *

>take tree
What on earth are you going to do with that?

>search presents
You find a tiny santa hat.

You slip the hat on over your ears. You look adorable!

>take tree
You may be wearing a Santa hat, but the Grinch you are not.

You are a hungry, hungry hippo.

>i
You are carrying:
  a santa hat (being worn)

>l
Living Room
Description, blah blah blah, tree and presents and cookies and milk and so on.

You can see a cat here.

* * *

>push cat
Nothing obvious happens.

>push cat north
The cat cannot be pushed from place to place.

>push presents north
The pile of presents cannot be pushed from place to place.

You are a hungry, hungry hippo.

* * *

>push presents north
There is nowhere else to go.

>push presents up
Not that way you can't.

>push presents
You push the bottom package with your head, being careful to prevent the pile from falling over. It's hard work, but eventually you move the entire stack over to the table.

You are a hungry, hungry hippo.

>push presents
You decide to leave the presents where they are.

>push presents to table
I only understood the first part of that-- trying anyway.

Retrying as:
>PUSH PRESENTS

Type UNDO if this isn't what you wanted to do, or CORRECT OFF to stop automatically correcting commands.

To stop these messages entirely, type NOVICE OFF.

You decide to leave the presents where they are.

>push cat
Nothing obvious happens.

Your tummy makes a rumbling sound.

* * *

>push presents n
There is nowhere else to go.

* * *

>n
There's no need to explore the rest of the house.

>up
You climb to the top of the presents. You seem to be about level with the table, on which stands a glass of milk and a plate of cookies. The pile starts to wobble, and you quickly make your way back down.

>push presents
You push the bottom package with your head, being careful to prevent the pile from falling over. It's hard work, but eventually you move the entire stack over to the table.

You find yourself staring at the cat and wondering how they would taste.

>up
You scramble up the pile of presents.

High above the Living Room
You can see a cookie and a glass of milk here.

>n
The only way down is well.. DOWN.

>down
You carefully climb back down the stack of presents.

Living Room
Description, blah blah blah, tree and presents and cookies and milk and so on.

You can see a cat here.

Your tummy makes a rumbling sound.

>up
You scramble up the pile of presents.

High above the Living Room
You can see a cookie and a glass of milk here.

>take cookie
Taken.

>down
You carefully climb back down the stack of presents.

Living Room
Description, blah blah blah, tree and presents and cookies and milk and so on.

You can see a cat here.

You find yourself staring at the cat and wondering how it would taste.

>show cookie to cat
You can only do that to something animate.

* * *

>talk to cat
If the cat can understand you, it does not deign to respond.

>lick cat
You give the cat a lick. Bleh! That doesn't appear to be food.

>touch cat
Another thing.

You are a hungry, hungry hippo.

>kiss me
One thing.

* * *

>attack me
Nah. You've been a good hippo this year.

>attack presents
There's no need to be so destructive!

* * *

>attack me
Nah. You've been a good hippo this year.

>attack cat
You growl menacingly at the cat.

>attack presents
There's no need to be so destructive!

Your tummy makes a rumbling sound.

>pet me
If you think that'll help.

>pet cat
Keep your hands to yourself!

>think
What a good idea.

Your tummy makes a rumbling sound.

>think about cat
I only understood you as far as wanting to think.

>hug cat
Keep your mind on the game.

* * *

>hug cat
That seems unwise. Maybe you should keep your distance.

>kiss cat
That seems unwise. Maybe you should keep your distance.

>lick cat
You're a vegetarian. Unlike the cat...

Your tummy makes a rumbling sound.

>hug me
Unfortunately you don't bend that way.

>kiss me
Unfortunately you don't bend that way.

>touch me
Unfortunately you don't bend that way.

You find yourself staring at the pile of presents and wondering how it would taste.

>eat presents
You give the pile of presents a lick. Bleh! That doesn't appear to be food.

>attack cat
You growl menacingly at the cat.

>growl at cat
That's not a verb I recognize.

* * *

>growl
You growl menacingly at nothing in particular. You feel a little silly.

>growl at cat
You can't see any such thing.

>up
You climb to the top of the presents. You seem to be about level with the table, on which stands a glass of milk and a plate of cookies. The pile starts to wobble, and you quickly make your way back down.

You are a hungry, hungry hippo.

>growl
(at the cat)
You growl menacingly at the cat.

>push presents
You push the bottom package with your head, being careful to prevent the pile from falling over. It's hard work, but eventually you move the entire stack over to the table.

>up
You scramble up the pile of presents.

High above the Living Room
You can see a cookie and a glass of milk here.

You find yourself staring at nothing and wondering how it would taste.

>growl
What do you want to growl at?

* * *

>growl at cat
You can't see any such thing.

>growl at me
You growl menacingly at yourself.

You find yourself staring at the pile of presents and wondering how it would taste.

* * *

>growl at cat
You can't see any such thing.

>x presents.up.push presents.look under tree.wear hat
There are piles of presents surrounding the tree. There is one rather tall pile of presents in a neat stack.

You climb to the top of the presents. You seem to be about level with a table, on which stands a glass of milk and a plate of cookies. The pile starts to wobble, and you quickly make your way back down.

Living Room
There is a tree here, decorated with ornaments and surrounded by piles of presents. There is also a table, about the same height as the stack of presents under the tree. The hallway closet is to the southeast.

You push the bottom package with your head, being careful to prevent the pile from falling over. It's hard work, but eventually you move the entire stack over to the table.

You find a tiny santa hat. It must have fallen off one of the ornaments.

[Your score has just gone up by one point.]

You slip the hat on over your ears. You look adorable!

You are a hungry, hungry hippo.

>LOOK
Living Room
There is a tree here, decorated with ornaments and surrounded by piles of presents. There is also a table, next to which is a neat stack of presents, forming a staircase to the top. The hallway closet is to the southeast.

>up.eat cookie.down.growl.growl at cat
You scramble up the pile of presents onto the table top.

High above the Living Room
You are standing on top of the table.

You can see a plate of cookies and a glass of milk here.

You nibble hungrily at the cookie.

[Your score has just gone up by five points.]

The cat of the house pads into the room, the bell on its collar jingling softly. It immediately takes notice of you.

The cat hisses at you.

You growl menacingly at the cat. The cat hisses at you, arching its back.

You feeling very thirsty.

The cat hisses at you.

You can't reach into the Living Room.

The cat hisses at you.

* * *

>growl
You growl menacingly at nothing in particular. You feel a little silly.

>growl at me
You growl menacingly at yourself.

>growl at cat
You growl menacingly at the cat.
 It hisses at you.
Your tummy makes a rumbling sound.

>growl at tree
You growl menacingly at the Christmas tree.

* * *

>growl at me
You growl menacingly at nothing in particular. You feel a little silly.

You growl menacingly at yourself.

* * *

>growl at tree
You growl menacingly at the Christmas tree.

>growl at cat
You growl menacingly at the cat.
 It hisses at you.

>grow at me
That's not a verb I recognize.

* * *

>growl at cat
You growl menacingly at the cat.

The cat hisses at you, arching its back.

>growl at tree
You growl menacingly at the Christmas tree.

>growl at me
You growl menacingly at yourself. 
You find yourself staring at the pile of presents and wondering how it would taste.

* * *

>growl at cat
You growl menacingly at the cat.

The cat hisses at you, arching its back.

>growl
You growl menacingly at nothing in particular. You feel a little silly.

* * *

>hiss at cat
I only understood you as far as wanting to hiss.

>hiss
You are a house hippo. House hippos do not hiss.

>growl
You growl menacingly at nothing in particular. You feel a little silly.

>growl at cat
You growl menacingly at the cat.

The cat hisses at you, arching its back.
Your tummy makes a rumbling sound.

>growl at cat
You growl menacingly at the cat.

The cat hisses at you, arching its back.

* * *

>hiss at cqat
You can't see any such thing.

>hiss at cat
You growl menacingly at the cat.

The cat hisses at you, arching its back.

* * *

>hiss
You are a house hippo. House hippos do not hiss.

>hiss at cat
You are a house hippo. House hippos do not hiss.

>hiss back
You are a house hippo. House hippos do not hiss.

Your tummy makes a rumbling sound.

* * *

>shout
You let out a loud roar. HIPPO!

The cat cringes at the sound.

>shout
(hello to yourself)
You mumble incoherently to yourself. It sounds suspiciously like "hippo hippo hippo."

>scream
That's not a verb I recognize.

* * *

>shout
You let out a loud roar. HIPPO!

The cat cringes at the sound.

>speak
(hello to yourself)
You mumble incoherently to yourself. It sounds suspiciously like "hippo hippo hippo."

>talk
(to yourself)
You mumble incoherently to yourself. It sounds suspiciously like "hippo hippo hippo."

>scream
That's not a verb I recognize.

* * *

>shout
You let out a loud roar. HIPPO!

The cat cringes at the sound.

>growl
You growl menacingly at the cat.

The cat hisses at you, arching its back.

>growl at cat
You growl menacingly at the cat.

The cat hisses at you, arching its back.

You find yourself staring at the pile of presents and wondering how it would taste.

>shout
You let out a loud roar.

The cat cringes at the sound.

>push presents
You push the bottom package with your head, being careful to prevent the pile from falling over. It's hard work, but eventually you move the entire stack over to the table.

* * *

>up
You scramble up the pile of presents.

High above the Living Room
You can see a cookie and a glass of milk here.

You find yourself staring at nothing and wondering how it would taste.

>shout
You let out a loud roar.

The cat cringes at the sound.

* * *

>shout
You let out a loud roar. HIPPO!

The cat cringes at the sound.

>search presents
You find a tiny santa hat.

You slip the hat on over your ears. You look adorable!

>drop hat
(first taking the santa hat off)
But it looks so cute on you!

You are a hungry, hungry hippo.

>drop hat
(first taking the santa hat off)
You shake off the santa hat. It falls to the floor.

Dropped.

>show hat to cat
(first taking the santa hat)
The cat could not care less about your santa hat.

* * *

>up
You briefly eye the tree, wondering how long it would take to climb it. Maybe you'll try it tomorrow.

>push presents
You can't see any such thing.

>up
You scramble up the pile of presents.

High above the Living Room
You can see a cookie and a glass of milk here.

You are a hungry, hungry hippo.

>d
You carefully climb back down the stack of presents.

NO.

* * *

>push presents
You can't see any such thing.

>x tree
It's a Holiday tree.

>push presents
Where would you like to push that?

You are a hungry, hungry hippo.

>up
You climb to the top of the presents. You seem to be about level with a table, on which stands a glass of milk and a plate of cookies. The pile starts to wobble, and you quickly make your way back down.

Living Room
There is a tree here, under which is a stack of presents. There is also a table,.

* * *

>up
You briefly eye the tree, wondering how long it would take to climb it. Maybe you'll try it tomorrow.

>l
Living Room
Tree. Table.

You can see a cat here.

>down
There's no need to explore the rest of the house.

You are a hungry, hungry hippo.

>l
Living Room
Tree.

You can see a cat here.

* * *

>l
Living Room
Tree. Table.

You can see a cat here.

>x tree
It's a Holiday tree.

You find yourself staring at the table and wondering how it would taste.

>l
Living Room
Tree, under which is a stack of presents. Table.

You can see a cat here.

>push presents
You push the bottom package with your head, being careful to prevent the pile from falling over. It's hard work, but eventually you move the entire stack over to the table.

>l
Living Room
Tree. Table, next to which is a stack of presents, reaching up to the very top.

You can see a cat here.

You are a hungry, hungry hippo.

* * *

>up
You briefly eye the tree, wondering how long it would take to climb it. Maybe you'll try it tomorrow.

>down
There's no need to explore the rest of the house.

>push presents
You can't see any such thing.

>up
You climb to the top of the presents. You seem to be about level with the table, on which stands a glass of milk and a plate of cookies. The pile starts to wobble, and you quickly make your way back down.

You are a hungry, hungry hippo.

>down
There's no need to explore the rest of the house.

>x tree
It's a Holiday tree.

>push presents
You push the bottom package with your head, being careful to prevent the pile from falling over. It's hard work, but eventually you move the entire stack over to the table.

Your tummy makes a rumbling sound.

>up
You scramble up the pile of presents.

High above the Living Room
You can see a cookie and a glass of milk here.

>down
Not yet.

* * *

>up
You briefly eye the tree, wondering how long it would take to climb it. Maybe you'll try it tomorrow.

>x presents
There are piles of presents surrounding the tree. There is one rather tall pile of presents in a neat stack.

>x tree
It's a Holiday tree.

>x presents
A pile of presents stacked neatly under the tree, with the largest package on the bottom and the smallest at the top.

Your tummy makes a rumbling sound.

>up
You climb to the top of the presents. You seem to be about level with the table, on which stands a glass of milk and a plate of cookies. The pile starts to wobble, and you quickly make your way back down.

>undo
Living Room
[Previous turn undone.]

>climb presents
You climb to the top of the presents. You seem to be about level with the table, on which stands a glass of milk and a plate of cookies. The pile starts to wobble, and you quickly make your way back down.

* * *

>x presents
There are piles of presents surrounding the tree. There is one rather tall pile of presents in a neat stack.

>x table
You can't see any such thing.

>x tree
It's a Holiday tree.

* * *

>x presents
A pile of presents stacked neatly under the tree, with the largest package on the bottom and the smallest at the top.

Your tummy makes a rumbling sound.

>climb presents
(first opening the pile of presents)
You must supply a noun.

>climb tree
You briefly eye the tree, wondering how long it would take to climb it. Maybe you'll try it tomorrow.

* * *

>x presents
There are piles of presents surrounding the tree. There is one rather tall pile of presents in a neat stack.

>up
You climb to the top of the presents. You seem to be about level with a table, on which stands a glass of milk and a plate of cookies. The pile starts to wobble, and you quickly make your way back down.

Living Room
There is a tree here, decorated with ornaments and surrounded by piles of presents. There is also a table,.

* * *

>up
You briefly eye the tree, wondering how long it would take to climb it. Maybe you'll try it tomorrow.

>x tree
It's a Holiday tree.

>up
You climb to the top of the presents. You seem to be about level with a table, on which stands a glass of milk and a plate of cookies. The pile starts to wobble, and you quickly make your way back down.

Living Room
Tree, under which is a stack of presents. Table.

(You can't reach the table top from here. Maybe you can try climbing something.)

Your tummy makes a rumbling sound.

>up
(onto the table)
You don't know how to fly. Maybe there's something that can help you reach the table top.

>climb presents
(onto the table)
You don't know how to fly. Maybe there's something that can help you reach the table top.

* * *

>up
You climb to the top of the presents. You seem to be about level with a table, on which stands a glass of milk and a plate of cookies. The pile starts to wobble, and you quickly make your way back down.

Living Room
Tree, under which is a stack of presents. Table.

(You can't reach the table top from here. Maybe you can try climbing something.)

Your tummy makes a rumbling sound.

>climb table
That doesn't seem feasible. Maybe there's another way up.

>take presents
Those don't appear to be for you. Maybe Santa will bring you something nice if you're good.

>g
Stop it. What would Santa think?

You find yourself staring at the pile of presents and wondering how they would taste.

>g
Naughty hippos don't receive presents.

>g
Just leave the presents alone, ok? Maybe you can PUSH or PULL them instead.

* * *

>x tree
It's a Holiday tree.

>x presents
A pile of presents stacked neatly under the tree, with the largest package on the bottom and the smallest at the top.

You find yourself staring at the Christmas tree and wondering how they would taste.

>climb presents
(first opening the pile of presents)
You must supply a noun.

>undo
Living Room
[Previous turn undone.]

>open presents
You pick out the prettiest present in the pile and tug on the ribbon with your teeth. The ribbon slips ever so slightly, and you feel a sudden burst of shame.

>undo
Living Room
[Previous turn undone.]

>up
You climb to the top of the presents. You seem to be about level with a table, on which stands a glass of milk and a plate of cookies. The pile starts to wobble, and you quickly make your way back down.

Living Room
There is a tree here, under which is a stack of presents. There is also a table,.

You can see some pile of presents here.

>undo
Living Room
[Previous turn undone.]

>enter presents
(first opening the pile of presents)
You must supply a noun.

* * *

>up
You briefly eye the tree, wondering how long it would take to climb it. Maybe you'll try it tomorrow.

>climb tree
You briefly eye the tree, wondering how long it would take to climb it. Maybe you'll try it tomorrow.

>x tree
It's a Holiday tree.

You are a hungry, hungry hippo.

>x presents
A pile of presents stacked neatly under the tree, with the largest package on the bottom and the smallest at the top.

>x table
You can't see any such thing.

>up
You climb to the top of the presents. You seem to be about level with a table, on which stands a glass of milk and a plate of cookies. The pile starts to wobble, and you quickly make your way back down.

Living Room
Tree, under which is a stack of presents. Table.

>up
You climb to the top of the presents. You seem to be about level with a table, on which stands a glass of milk and a plate of cookies. The pile starts to wobble, and you quickly make your way back down.

Living Room
Tree, under which is a stack of presents. Table.

Your tummy makes a rumbling sound.

* * *

>up
You briefly eye the tree, wondering how long it would take to climb it. Maybe you'll try it tomorrow.

>x tree.up
It's a Holiday tree.

You climb to the top of the presents. You seem to be about level with a table, on which stands a glass of milk and a plate of cookies. The pile starts to wobble, and you quickly make your way back down.

Living Room
Tree, under which is a stack of presents. Table.

You find yourself staring at the pile of presents and wondering how it would taste.

>up
You climb to the top of the presents. You seem to be about level with a table, on which stands a glass of milk and a plate of cookies. The pile starts to wobble, and you quickly make your way back down.

Living Room
Tree, under which is a stack of presents. Table.

>up
You climb to the top of the presents. You seem to be about level with a table, on which stands a glass of milk and a plate of cookies. The pile starts to wobble, and you quickly make your way back down.

Living Room
Tree, under which is a stack of presents. Table.

>push presents
You push the bottom package with your head, being careful to prevent the pile from falling over. It's hard work, but eventually you move the entire stack over to the table.

Your tummy makes a rumbling sound.

* * *

>up
You briefly eye the tree, wondering how long it would take to climb it. Maybe you'll try it tomorrow.

>up
You briefly eye the tree, wondering how long it would take to climb it. Maybe you'll try it tomorrow.

>x tree
It's a Holiday tree.

You find yourself staring at the pile of presents and wondering how it would taste.

>up
You climb to the top of the presents. You seem to be about level with a table, on which stands a glass of milk and a plate of cookies. The pile starts to wobble, and you quickly make your way back down.

Living Room
Tree, under which is a stack of presents. Table.

* * *

>up
You briefly eye the tree, wondering how long it would take to climb it. Maybe you'll try it tomorrow.

>climb presents
You can't see any such thing.

>climb tree
You briefly eye the tree, wondering how long it would take to climb it. Maybe you'll try it tomorrow.

>x tree
It's a Holiday tree.

Your tummy makes a rumbling sound.

>up
You briefly eye the tree, wondering how long it would take to climb it. Maybe you'll try it tomorrow.

>climb presents
You briefly eye the tree, wondering how long it would take to climb it. Maybe you'll try it tomorrow.

>x presents
A pile of presents stacked neatly under the tree, with the largest package on the bottom and the smallest at the top.

Your tummy makes a rumbling sound.

>push presents
You push the bottom package with your head, being careful to prevent the pile from falling over. It's hard work, but eventually you move the entire stack over to the table.

>up
You briefly eye the tree, wondering how long it would take to climb it. Maybe you'll try it tomorrow.

>push presents
You decide to leave the presents where they are.

Your tummy makes a rumbling sound.

* * *

>up
You briefly eye the tree, wondering how long it would take to climb it. Maybe you'll try it tomorrow.

>enter presents
You can't see any such thing.

>climb presents
You can't see any such thing.

* * *

>climb tree
You briefly eye the tree, wondering how long it would take to climb it. Maybe you'll try it tomorrow.

>x tree
It's a Holiday tree.

You find yourself staring at the pile of presents and wondering how it would taste.

>enter presnts
You can't see any such thing.

>enter presents
You climb to the top of the presents. You seem to be about level with a table, on which stands a glass of milk and a plate of cookies. The pile starts to wobble, and you quickly make your way back down.

Living Room
There is a tree here, under which is a stack of presents. There is also a table,.

You can see some pile of presents here.

>undo
Living Room
[Previous turn undone.]

* * *

>up
You briefly eye the tree, wondering how long it would take to climb it. Maybe you'll try it tomorrow.

>x tre
You can't see any such thing.

>x tree
It's a Holiday tree.

>up
You climb to the top of the presents. You seem to be about level with a table, on which stands a glass of milk and a plate of cookies. The pile starts to wobble, and you quickly make your way back down.

Living Room
There is a tree here, under which is a stack of presents. There is also a table,.

Your tummy makes a rumbling sound.

>undo
Living Room
[Previous turn undone.]

>climb presents
You climb to the top of the presents. You seem to be about level with a table, on which stands a glass of milk and a plate of cookies. The pile starts to wobble, and you quickly make your way back down.

Living Room
There is a tree here, under which is a stack of presents. There is also a table,.

You find yourself staring at the Christmas tree and wondering how it would taste.

>climb presents
You climb to the top of the presents. You seem to be about level with a table, on which stands a glass of milk and a plate of cookies. The pile starts to wobble, and you quickly make your way back down.

Living Room
There is a tree here, under which is a stack of presents. There is also a table,.

>x table
Table.

>climb table
That doesn't seem feasible. Maybe there's another way up.

You are a hungry, hungry hippo.

>climb tree
You briefly eye the tree, wondering how long it would take to climb it. Maybe you'll try it tomorrow.

>climb
What do you want to climb?

>tree
compass (5) 
  the north
  the northeast
  the northwest
  the south
  the southeast
  the southwest
  the east
  the west
  the up
  the down
  the inside
  the outside
(LibraryMessages) (6) 
(darkness object) (7) 
(Inform Parser) (8) 
(Inform Library) (9) 
(property_numberspace_forcer) (10) 
(ValuePropertyHolder_39) (12) 
Living Room (44) 
  a table
  a pile of presents
  yourself
  Santa
  a Christmas tree
santa hat (45) 
High above the Living Room (49) 
  a cookie
  a glass of milk
cat (53)

>climb
What do you want to climb?

>table
That doesn't seem feasible. Maybe there's another way up.

>tree
compass (5) 
  the north
  the northeast
  the northwest
  the south
  the southeast
  the southwest
  the east
  the west
  the up
  the down
  the inside
  the outside
(LibraryMessages) (6) 
(darkness object) (7) 
(Inform Parser) (8) 
(Inform Library) (9) 
(property_numberspace_forcer) (10) 
(ValuePropertyHolder_39) (12) 
Living Room (44) 
  a table
  a pile of presents
  yourself
  Santa
  a Christmas tree
santa hat (45) 
High above the Living Room (49) 
  a cookie
  a glass of milk
cat (53)

* * *

>up
You briefly eye the tree, wondering how long it would take to climb it. Maybe you'll try it tomorrow.

>x presents.up.push presents.up.take cookie
There are piles of presents surrounding the tree. There is one rather tall pile of presents in a neat stack.

You climb to the top of the presents. You seem to be about level with a table, on which stands a glass of milk and a plate of cookies. The pile starts to wobble, and you quickly make your way back down.

Living Room
There is a tree here, decorated with ornaments and surrounded by piles of presents. There is also a table, about the same height as the stack of presents under the tree. The hallway closet is to the southeast.

You push the bottom package with your head, being careful to prevent the pile from falling over. It's hard work, but eventually you move the entire stack over to the table.

You scramble up the pile of presents onto the table top.

High above the Living Room
You are standing on top of the table.

You can see a plate of cookies and a glass of milk here.

That cookie is larger than you are. Maybe you can roll it.

Visions of raisins dance in your head.

>roll cookie
You push the cookie off the table. It falls to the floor below. It bounces twice, but does not shatter.

* * *

>x table
There is a tall table off to one side.

>up
You climb to the top of the presents. You seem to be about level with the table, on which stands a glass of milk and a plate of cookies. The pile starts to wobble, and you quickly make your way back down.

>x table
Table.

>x cookies
You can't see any such thing.

* * *

>x table
There is a tall table off to one side.

>climb table
That doesn't seem feasible. Maybe there's another way up.

>x up
You peer up at the holiday tree.

>x presents
There are piles of presents surrounding the tree. There is one rather tall pile of presents in a neat stack.

>l
Living Room
There is a tree here, decorated with ornaments and surrounded by piles of presents. There is also a table, about the same height as the stack of presents under the tree. The hallway closet is to the southeast.

>x up
You peer up at the holiday tree.

>push presents
You push the bottom package with your head, being careful to prevent the pile from falling over. It's hard work, but eventually you move the entire stack over to the table.

* * *

>x table
There is a tall table off to one side.

>x presents
There are piles of presents surrounding the tree. There is one rather tall pile of presents in a neat stack.

>x table
There is a tall table off to one side. It appears to be about the same height as the stack of presents.

>l
Living Room
There is a tree here, decorated with ornaments and surrounded by piles of presents. There is also a table, about the same height as the stack of presents under the tree. The hallway closet is to the southeast.

>up
You climb to the top of the presents. You seem to be about level with the table, on which stands a glass of milk and a plate of cookies. The pile starts to wobble, and you quickly make your way back down.

Living Room
There is a tree here, decorated with ornaments and surrounded by piles of presents. There is also a table, about the same height as the stack of presents under the tree. The hallway closet is to the southeast.

>x presents
A pile of presents stacked neatly under the tree, with the largest package on the bottom and the smallest at the top.

>push presents
You push the bottom package with your head, being careful to prevent the pile from falling over. It's hard work, but eventually you move the entire stack over to the table.

* * *

>x table
There is a tall table off to one side. It appears to be about the same height as the stack of presents.

>up
You climb to the top of the presents. You seem to be about level with the table, on which stands a glass of milk and a plate of cookies. The pile starts to wobble, and you quickly make your way back down.

Living Room
There is a tree here, decorated with ornaments and surrounded by piles of presents. There is also a table, about the same height as the stack of presents under the tree. The hallway closet is to the southeast.

>x table
There is a tall table off to one side. It appears to be about the same height as the stack of presents.

* * *

>x table
There is a tall table off to one side.

>x presents.x table
There are piles of presents surrounding the tree. There is one rather tall pile of presents in a neat stack.

There is a tall table off to one side. It appears to be about the same height as the stack of presents.

>up.x table
You climb to the top of the presents. You seem to be about level with the table, on which stands a glass of milk and a plate of cookies. The pile starts to wobble, and you quickly make your way back down.

Living Room
There is a tree here, decorated with ornaments and surrounded by piles of presents. There is also a table, about the same height as the stack of presents under the tree. The hallway closet is to the southeast.

There is a tall table off to one side. It appears to be about the same height as the stack of presents, and you recall seeing cookies and milk at the top.

* * *

>look under table
Under the table.

>look under tree
You find nothing of interest.

* * *

>x presents
There are piles of presents surrounding the tree. There is one rather tall pile of presents in a neat stack.

>look under tree
You find nothing of interest.

* * *

>x tree
It's a Holiday tree.

>x presents
A pile of presents stacked neatly under the tree, with the largest package on the bottom and the smallest at the top.

>look under tree
Presents.

You find yourself staring at the pile of presents and wondering how it would taste.

>x presents
A pile of presents stacked neatly under the tree, with the largest package on the bottom and the smallest at the top.

>restart
Are you sure you want to restart?

>y
'Twas the night before Christmas when all through the house, the only creature stirring was a hippo the size of a mouse.

More text!

And A Hippo New Year
an interactive holiday tale by Erin Gigglecreek
Release 1 / Serial number 121224 / Inform 7 build 6G60 (I6/v6.32 lib 6/12N) SD

If you are unfamiliar with Interactive Fiction, type HELP for a quick introduction on how to play. 

Living Room
Tree

You can see a cat here.

>x presents
You can't see any such thing.

>look under tree
Presents.

>x presents
A pile of presents stacked neatly under the tree, with the largest package on the bottom and the smallest at the top.

>x tree
It's a Holiday tree.

Your tummy makes a rumbling sound.

>l
Living Room
Tree, under which is a stack of presents.

You can see a cat here.

* * *

>x presents
There are piles of presents surrounding the tree. There is one rather tall pile of presents in a neat stack.

>up
You briefly eye the tree, wondering how long it would take to climb it. Maybe you'll try it tomorrow.

>down
Not yet.

>restart
Are you sure you want to restart?

>y
'Twas the night before Christmas when all through the house, the only creature stirring was a hippo the size of a mouse.

More text!

And A Hippo New Year
an interactive holiday tale by Erin Gigglecreek
Release 1 / Serial number 121224 / Inform 7 build 6G60 (I6/v6.32 lib 6/12N) SD

If you are unfamiliar with Interactive Fiction, type HELP for a quick introduction on how to play. 

Living Room
Tree.

>down
There's no need to explore the rest of the house.

* * *

>up
You briefly eye the tree, wondering how long it would take to climb it. Maybe you'll try it tomorrow.

>climb presents
You briefly eye the tree, wondering how long it would take to climb it. Maybe you'll try it tomorrow.

You are a hungry, hungry hippo.

* * *

>x presents
There are piles of presents surrounding the tree. There is one rather tall pile of presents in a neat stack.

>push presents
You don't have any reason to push those around. Yet.

>up
You climb to the top of the presents. You seem to be about level with a table, on which stands a glass of milk and a plate of cookies. The pile starts to wobble, and you quickly make your way back down.

Living Room
There is a tree here, decorated with ornaments and surrounded by piles of presents. There is also a table.

>push presnts
You can't see any such thing.

>push presnts
You can't see any such thing.

>push gifts
You push the bottom package with your head, being careful to prevent the pile from falling over. It's hard work, but eventually you move the entire stack over to the table.

>look under tree
You find a tiny santa hat. It must have fallen off one of the ornaments.

[Your score has just gone up by one point.]

>x ornaments
Ornaments

You find yourself staring at the Christmas tree and wondering how they would taste.

* * *

>x presents
There are piles of presents surrounding the tree. There is one rather tall pile of presents in a neat stack.

>x presents
A pile of presents stacked neatly under the tree, with the largest package on the bottom and the smallest at the top.

>up
You climb to the top of the presents. You seem to be about level with a table, on which stands a glass of milk and a plate of cookies. The pile starts to wobble, and you quickly make your way back down.

Living Room
There is a tree here, decorated with ornaments and surrounded by piles of presents. There is also a table, about the same height as the stack of presents under the tree. The hallway closet is to the southeast.

>push presents
You push the bottom package with your head, being careful to prevent the pile from falling over. It's hard work, but eventually you move the entire stack over to the table.

>look under tree
You find a tiny santa hat. It must have fallen off one of the ornaments.

>wear hat
You slip the hat on over your ears. You look adorable!

Your tummy makes a rumbling sound.

[Your score has just gone up by one point.]

>up
You scramble up the pile of presents onto the table top.

High above the Living Room
You are standing on top of the table.

You can see a plate of cookies and a glass of milk here.

>eat cookie
You nibble hungrily at the cookie.

[Your score has just gone up by five points.]

>push milk
The glass of milk goes crashing to the floor. A light goes on in the hallway, and you quickly dash back down the pile of presents and hide behind a table leg.

One of the big humans of the house wanders sleepily into the room. She cleans up the milk and broken glass, mutters something about the cat and goes back to bed.

Living Room
There is a tree here, decorated with ornaments and surrounded by piles of presents. There is also a table, next to which is a neat stack of presents, forming a staircase to the top. The hallway closet is to the southeast.

>look under table
You find the remains of a melted icicle.

>drink puddle
You lap at the cold water and feel instantly refreshed.

[Your score has just gone up by three points.]

>se
Hallway Closet
This is the closet where you will be spending the night. It is full of things that you don't need to think about right now.

You can see your nest and a mitten here.

>take mitten
You pick up the wet mitten. Ick. Soggy mittens don't make good bedding material.

>nw
Living Room
There is a tree here, decorated with ornaments and surrounded by piles of presents. There is also a table, next to which is a neat stack of presents, forming a staircase to the top. The hallway closet is to the southeast.

>mitten on lights
I only understood you as far as wanting to do something to the mitten.

>put mitten on lights
You lay the mitten across the string of lights where it nearly touches the floor.

>take garland
You tug on a dangling bit of garland with your teeth. A piece breaks off, about as long as you are.

[Your score has just gone up by one point.]

>se
Hallway Closet
This is the closet where you will be spending the night. It is full of things that you don't need to think about right now.

You can see your nest here.

>drop garland
You add the piece of garland to your nest.

The mitten starts to smoke. You'd better go get it before you burn down the house.

[Your score has just gone up by one point.]

>nw
Living Room
There is a tree here, decorated with ornaments and surrounded by piles of presents. There is also a table, next to which is a neat stack of presents, forming a staircase to the top. The hallway closet is to the southeast.

>take mitten
You quickly retrieve the mitten. It is now dry, and almost too hot to touch.

[Your score has just gone up by three points.]

>se
Hallway Closet
This is the closet where you will be spending the night. It is full of things that you don't need to think about right now.

You can see your nest (on which is a piece of garland) here.

>drop mitten
You add the mitten to your nest.

You are struggling to keep your eyes open.

[Your score has just gone up by one point.]

>score
You have so far scored 15 out of a possible 15, in 23 turns.

>z
Time passes.

You are feeling very tired. Maybe you could just take a quick nap.

>z
Time passes.

You are struggling to keep your eyes open.

>z
Time passes.

You are struggling to keep your eyes open.

>z
Time passes.

You are feeling very tired. Maybe you could just take a quick nap.

* * *

>l
Living Room
There is a tree here, decorated with ornaments and surrounded by piles of presents. There is also a table, about the same height as the stack of presents under the tree. The hallway closet is to the southeast.

>up.push presents
You climb to the top of the presents. You seem to be about level with a table, on which stands a glass of milk and a plate of cookies. The pile starts to wobble, and you quickly make your way back down.

Living Room
There is a tree here, decorated with ornaments and surrounded by piles of presents. There is also a table, about the same height as the stack of presents under the tree. The hallway closet is to the southeast.

You push the bottom package with your head, being careful to prevent the pile from falling over. It's hard work, but eventually you move the entire stack over to the table.

>l
Living Room
There is a tree here, decorated with ornaments and surrounded by piles of presents. There is also a table, next to which is a neat stack of presents, forming a staircase to the top. The hallway closet is to the southeast.

* * *

>x presents
You can't see any such thing.

>look under tree
You find nothing of interest.

>i
You are carrying nothing.

* * *

>look under
(the cat)
You find nothing of interest.

* * *

>look under tree
Presents.

>x tree
It's a Holiday tree.

* * *

>look under tree
Presents.

>push presents
You don't have any reason to push those around. Yet.

>climb presents
You climb to the top of the presents. You seem to be about level with a table, on which stands a glass of milk and a plate of cookies. The pile starts to wobble, and you quickly make your way back down.

Living Room
There is a tree here, under which is a stack of presents. There is also a table,.

You find yourself staring at the Christmas tree and wondering how it would taste.

>push presents
You push the bottom package with your head, being careful to prevent the pile from falling over. It's hard work, but eventually you move the entire stack over to the table.

* * *

>look under tree
You find a tiny santa hat. It must have fallen off one of the ornaments.

>i
You are carrying nothing.

You are a hungry, hungry hippo.

>l
Living Room
There is a tree here, under which is a stack of presents. There is also a table,, next to which is a neat stack of presents, forming a staircase to the top.

You can see a santa hat here.

>x hat
It's the tiniest santa hat. It looks like it would fit you.

* * *

>look under tre
If you can see an object, you can usually just interact with it directly without worrying about your position. Try a command like EXAMINE CHRISTMAS TREE for a closer look at something, LOOK to get a new description of this location, or a direction like UP (or U) to move to a different location.

To stop these messages entirely, type NOVICE OFF.

>look under tree
Hi there.

>look under table
You find nothing of interest.

* * *

>listen
You hear only the sound of your heart beating.

>search presents
You find a tiny santa hat.

You slip the hat on over your ears. You look adorable!

* * *

>take tree
You may be wearing a Santa hat, but the Grinch you are not.

You are a hungry, hungry hippo.

>remove hat
But it looks so cute on you!

>remove hat
You shake off the santa hat. It falls to the floor.

>take tree
What on earth are you going to do with that?

You are a hungry, hungry hippo.

* * *

>litsen
That's not a verb I recognize.

>listen
You hear a bell jingling somewhere in the house.

* * *

>x tree
It's a rather lovely Christmas tree, covered with rainbow lights, a silver garland and colorful, shiny ornaments. There is a collection of presents underneath the tree.

>l
Living Room
Tree, under which is a stack of presents.
Table.

You can see a cat here.

>push presents
You push the bottom package with your head, being careful to prevent the pile from falling over. It's hard work, but eventually you move the entire stack over to the table.

You are a hungry, hungry hippo.

>l
Living Room
Tree.
Table, next to which is a stack of presents, reaching up to the very top.

You can see a cat here.

* * *

>x tree
It's a rather lovely Christmas tree, covered with rainbow lights, a silver garland and colorful, shiny ornaments. There is a collection of presents underneath the tree.

>x presents
There are piles of presents surrounding the tree. There is one rather tall pile of presents in a neat stack.

>climb presents
You climb to the top of the presents. You seem to be about level with a table, on which stands a glass of milk and a plate of cookies. The pile starts to wobble, and you quickly make your way back down.

Living Room
There is a tree here, under which is a stack of presents. There is also a table,.

You are a hungry, hungry hippo.

>undo
Living Room
[Previous turn undone.]

>up
(first opening the pile of presents)
You must supply a noun.

You find yourself staring at the pile of presents and wondering how it would taste.

* * *

>x presents
There are piles of presents surrounding the tree. There is one rather tall pile of presents in a neat stack.

>x ornaments
Ornaments

>x pile
A pile of presents stacked neatly under the tree, with the largest package on the bottom and the smallest at the top.

>climb
What do you want to climb?

>climb pile
You climb to the top of the presents. You seem to be about level with a table, on which stands a glass of milk and a plate of cookies. The pile starts to wobble, and you quickly make your way back down.

Living Room
There is a tree here, decorated with ornaments and surrounded by piles of presents.
. There is also a table,.

>x presents
A pile of presents stacked neatly under the tree, with the largest package on the bottom and the smallest at the top.

* * *

>x tree
It's a rather lovely Christmas tree, covered with rainbow lights, a silver garland and colorful, shiny ornaments. There is a collection of presents underneath the tree.

>push presents
You push the bottom package with your head, being careful to prevent the pile from falling over. It's hard work, but eventually you move the entire stack over to the table.

>g
You decide to leave the presents where they are.

You are a hungry, hungry hippo.

>climb presents
You scramble up the pile of presents onto the table top.

High above the Living Room
You can see a cookie and a glass of milk here.

>undo
Living Room
[Previous turn undone.]

>climb table
You can't see any such thing.

>up
You scramble up the pile of presents onto the table top.

High above the Living Room
You can see a cookie and a glass of milk here.

>down
A wild cat appears. It has not noticed you yet.

* * *

>x tree
It's a rather lovely Christmas tree, covered with rainbow lights, a silver garland and colorful, shiny ornaments. There is a collection of presents underneath the tree.

>se
One at a time! You are only a tiny hippo.

Hallway Closet
This is the closet where you will be spending the night. It is full of things that you don't need to think about right now.

You can see your nest and a mitten here.

>take mitten
You can only carry one thing at a time!

* * *

>x tree
It's a rather lovely Christmas tree, covered with rainbow lights, a silver garland and colorful, shiny ornaments. There is a collection of presents underneath the tree.

>x all
One at a time! You are only a tiny hippo.

>se
Hallway Closet
This is the closet where you will be spending the night. It is full of things that you don't need to think about right now.

You can see your nest and a mitten here.

* * *

>take mitten
You pick up the wet mitten. Ick. Soggy mittens don't make good bedding material.

>drop mitten
Dropped.

>take all
mitten: You pick up the wet mitten. Ick. Soggy mittens don't make good bedding material.

>cd
That's not a verb I recognize.

>attack all
One at a time! You are only a tiny hippo.

>look
Hallway Closet
This is the closet where you will be spending the night. It is full of things that you don't need to think about right now.

You can see your nest here.

>ne
The only way out is back to the northwest.

>nw
Living Room
There is a tree here, decorated with ornaments and surrounded by piles of presents. There is also a table off to one side. The hallway closet is to the southeast.

* * *

>undo
Hallway Closet
[Previous turn undone.]

>take all
mitten: Taken.
piece of garland: You can only carry one thing in your mouth at a time. But some items can be pushed around or worn. You drop the mitten to pick up the piece of garland.

Taken.

You are struggling to keep your eyes open.

* * *

>l
Living Room
There is a tree here, decorated with ornaments and surrounded by piles of presents. There is also a table off to one side. The hallway closet is to the southeast.

>up
You climb to the top of the presents. You seem to be about level with the table, on which stands a glass of milk and a plate of cookies. The pile starts to wobble, and you quickly make your way back down.

>l
Living Room
 Tree.Table.

You can see a cat here.

Your tummy makes a rumbling sound.

* * *

>l
Living Room
There is a tree here, decorated with ornaments and surrounded by piles of presents. There is also a table off to one side. The hallway closet is to the southeast.

>x presents
You can't see any such thing.

>x tree
It's a Holiday tree.

>x presents
A pile of presents stacked neatly under the tree, with the largest package on the bottom and the smallest at the top.

You are a hungry, hungry hippo.

>up
You climb to the top of the presents. You seem to be about level with the table, on which stands a glass of milk and a plate of cookies. The pile starts to wobble, and you quickly make your way back down.

* * *

>x table
Table.

>up
(onto the table)
You don't know how to fly. Maybe there's something that can help you reach the table top.

High above the Living Room
You can see a cookie and a glass of milk here.

You find yourself staring at nothing and wondering how it would taste.

* * *

>l
Living Room
There is a tree here, decorated with ornaments and surrounded by piles of presents. There is also a table off to one side. The hallway closet is to the southeast.

>examine all
One at a time! You are only a tiny hippo.

* * *

>x tree.x presents
It's a Holiday tree.

A pile of presents stacked neatly under the tree, with the largest package on the bottom and the smallest at the top.

>x table
You can't see any such thing.

>up
You climb to the top of the presents. You seem to be about level with the table, on which stands a glass of milk and a plate of cookies. The pile starts to wobble, and you quickly make your way back down.

You find yourself staring at the Christmas tree and wondering how it would taste.

* * *

>climb table
You can't see any such thing.

>x table
You can't see any such thing.

* * *

>x cat
You can't see any such thing.

>x tree.push presents.up
It's a Holiday tree.

You push the bottom package with your head, being careful to prevent the pile from falling over. It's hard work, but eventually you move the entire stack over to the table.

You scramble up the pile of presents onto the table top.

High above the Living Room
You can see a cookie and a glass of milk here.

You are a hungry, hungry hippo.

>x cat
You can't see any such thing.

>down
Not yet.

>l
High above the Living Room
You can see a cookie and a glass of milk here.

>x cat
You can't see any such thing.

>break
What do you want to break?

>break tree
There's no need to be so destructive!

* * *

>x tree.up
It's a Holiday tree.

You climb to the top of the presents. You seem to be about level with a table, on which stands a glass of milk and a plate of cookies. The pile starts to wobble, and you quickly make your way back down.

Living Room
Tree, under which is a stack of presents. Table.

>push presents.up
You push the bottom package with your head, being careful to prevent the pile from falling over. It's hard work, but eventually you move the entire stack over to the table.

Your tummy makes a rumbling sound.

You scramble up the pile of presents onto the table top.

High above the Living Room
You can see a cookie and a glass of milk here.

>x cat
It is a cat.

>down
Not yet.

Your tummy makes a rumbling sound.

>x cat
It is a cat.

* * *

>x tree.push presents.up
It's a Holiday tree.

You push the bottom package with your head, being careful to prevent the pile from falling over. It's hard work, but eventually you move the entire stack over to the table.

You scramble up the pile of presents onto the table top.

High above the Living Room
You can see a cookie and a glass of milk here.

You find yourself staring at the pile of presents and wondering how it would taste.

>x tree
It's a Holiday tree.

>x cookie
cookies!

>x milk
milk

Your tummy makes a rumbling sound.

>x presents
A pile of presents stacked neatly under the tree, with the largest package on the bottom and the smallest at the top.

>x cat
It is a cat.

>down
Not yet.

You find yourself staring at the pile of presents and wondering how it would taste.

* * *

>x tree.push presents.up.down
It's a Holiday tree.

You push the bottom package with your head, being careful to prevent the pile from falling over. It's hard work, but eventually you move the entire stack over to the table.

You scramble up the pile of presents onto the table top.

High above the Living Room
You can see a cookie and a glass of milk here.

Your tummy makes a rumbling sound.

A wild cat appears. It has not noticed you yet.
The cat hisses at you.

>d
The cat hisses at you.

* * *

>x tree.push presents.up.down.x cat.down
It's a Holiday tree.

You push the bottom package with your head, being careful to prevent the pile from falling over. It's hard work, but eventually you move the entire stack over to the table.

You scramble up the pile of presents onto the table top.

High above the Living Room
You can see a cookie and a glass of milk here.

You find yourself staring at the pile of presents and wondering how it would taste.

A wild cat appears. It has not noticed you yet.

It is a cat.

The cat hisses at you. You will need to find a way to distract the cat if you want to get down safely.

Your tummy makes a rumbling sound.

* * *

>climb presents
You can't see any such thing.

>up
You briefly eye the tree, wondering how long it would take to climb it. Maybe you'll try it tomorrow.

* * *

>x tree
It's a Holiday tree.

>climb presents
You briefly eye the tree, wondering how long it would take to climb it. Maybe you'll try it tomorrow.

You are a hungry, hungry hippo.

* * *

>x tree.up.push presents
It's a Holiday tree.

You climb to the top of the presents. You seem to be about level with a table, on which stands a glass of milk and a plate of cookies. The pile starts to wobble, and you quickly make your way back down.

Living Room
There is a tree here, under which is a stack of presents. There is also a table,.

You push the bottom package with your head, being careful to prevent the pile from falling over. It's hard work, but eventually you move the entire stack over to the table.

Your tummy makes a rumbling sound.

>l
Living Room
There is a tree here, under which is a stack of presents. There is also a table,, next to which is a neat stack of presents, forming a staircase to the top.

>look under tree
You find a tiny santa hat. It must have fallen off one of the ornaments.

>i
You are carrying:
  a Christmas tree

You are a hungry, hungry hippo.

* * *

>x tree.up.push presents
It's a Holiday tree.

You climb to the top of the presents. You seem to be about level with a table, on which stands a glass of milk and a plate of cookies. The pile starts to wobble, and you quickly make your way back down.

Living Room
There is a tree here, under which is a stack of presents. There is also a table,.

You push the bottom package with your head, being careful to prevent the pile from falling over. It's hard work, but eventually you move the entire stack over to the table.

Your tummy makes a rumbling sound.

>look under tree
You find a tiny santa hat. It must have fallen off one of the ornaments.

>i
You are carrying:
  a santa hat

>l
Living Room
There is a tree here, under which is a stack of presents. There is also a table,, next to which is a neat stack of presents, forming a staircase to the top.

You are a hungry, hungry hippo.

>x hat
It's the tiniest santa hat. It looks like it would fit you.

>wear hat
You slip the hat on over your ears. You look adorable!

>up
You scramble up the pile of presents onto the table top.

High above the Living Room
You can see a cookie and a glass of milk here.

You find yourself staring at the santa hat and wondering how it would taste.

>take cookie
Taken.

>remove hat
But it looks so cute on you!

>remove hat
You shake off the santa hat. It falls to the floor.

You find yourself staring at the Christmas tree and wondering how it would taste.

>i
You are carrying:
  a cookie

>l
High above the Living Room
You can see a santa hat and a glass of milk here.

* * *

>x tree.up.push presents.
It's a Holiday tree.

You climb to the top of the presents. You seem to be about level with a table, on which stands a glass of milk and a plate of cookies. The pile starts to wobble, and you quickly make your way back down.

Living Room
There is a tree here, under which is a stack of presents. There is also a table,.

You push the bottom package with your head, being careful to prevent the pile from falling over. It's hard work, but eventually you move the entire stack over to the table.

Your tummy makes a rumbling sound.

>i
You are carrying nothing.

>l
Living Room
There is a tree here, under which is a stack of presents. There is also a table,, next to which is a neat stack of presents, forming a staircase to the top.

>look under tree
You find a tiny santa hat. It must have fallen off one of the ornaments.

Taken.

You are a hungry, hungry hippo.

* * *

>x tree.up.push presents.look under tree
It's a Holiday tree.

You climb to the top of the presents. You seem to be about level with a table, on which stands a glass of milk and a plate of cookies. The pile starts to wobble, and you quickly make your way back down.

Living Room
There is a tree here, under which is a stack of presents. There is also a table,.

You push the bottom package with your head, being careful to prevent the pile from falling over. It's hard work, but eventually you move the entire stack over to the table.

You find yourself staring at the Christmas tree and wondering how it would taste.

You find a tiny santa hat. It must have fallen off one of the ornaments.

>up
You scramble up the pile of presents onto the table top.

High above the Living Room
You can see a cookie and a glass of milk here.

>take cookie
You're carrying too many things already.

You are a hungry, hungry hippo.

* * *

>x tree.up.push presents.look under tree.up
It's a Holiday tree.

You climb to the top of the presents. You seem to be about level with a table, on which stands a glass of milk and a plate of cookies. The pile starts to wobble, and you quickly make your way back down.

Living Room
There is a tree here, under which is a stack of presents. There is also a table,.

You push the bottom package with your head, being careful to prevent the pile from falling over. It's hard work, but eventually you move the entire stack over to the table.

You are a hungry, hungry hippo.

You find a tiny santa hat. It must have fallen off one of the ornaments.

You scramble up the pile of presents onto the table top.

High above the Living Room
You can see a cookie and a glass of milk here.

>i
You are carrying:
  a santa hat

Your tummy makes a rumbling sound.

>take cookie
You're carrying too many things already.

* * *

>take cookie
You can only carry one thing in your mouth at a time. But some items can be pushed around or worn.

You are a hungry, hungry hippo.

>wear hat
You slip the hat on over your ears. You look adorable!

>take cookie
Taken.

>remove hat
But it looks so cute on you!

You are a hungry, hungry hippo.

>remove hat
You shake off the santa hat. It falls to the table.

>take hat
You can only carry one thing in your mouth at a time. But some items can be pushed around or worn.

>wear hat
You slip the hat on over your ears. You look adorable!

Your tummy makes a rumbling sound.

>push cookie
Nothing obvious happens.

>push cookie down
Not that way you can't.

* * *

>x tree.up.push presents.up
It's a Holiday tree.

You climb to the top of the presents. You seem to be about level with a table, on which stands a glass of milk and a plate of cookies. The pile starts to wobble, and you quickly make your way back down.

Living Room
There is a tree here, under which is a stack of presents. There is also a table,.

You push the bottom package with your head, being careful to prevent the pile from falling over. It's hard work, but eventually you move the entire stack over to the table.

You find yourself staring at the ornaments and wondering how it would taste.

You scramble up the pile of presents onto the table top.

High above the Living Room
You can see a plate of cookies and a glass of milk here.

>push cookie
You push the cookie off the table.

>push milk
CRASH.

You are a hungry, hungry hippo.

>down
You carefully climb back down the stack of presents.

Living Room
There is a tree here, under which is a stack of presents. There is also a table,, next to which is a neat stack of presents, forming a staircase to the top.

You can see a cookie here.

* * *

>x milk
milk

>x cookie
cookies!

You find yourself staring at the Christmas tree and wondering how it would taste.

>eat cookie
You eat the cookie.

>i
You are carrying nothing.

>l
High above the Living Room
You can see a glass of milk here.

Your tummy makes a rumbling sound.

>eat milk
You do not drink the milk.

>l
High above the Living Room

* * *

>eat milk
You do not drink the milk.

>l
High above the Living Room
You can see a cookie and a glass of milk here.

You are a hungry, hungry hippo.

>i
You are carrying nothing.

>l
High above the Living Room
You can see a cookie and a glass of milk here.

>eat cookie
You eat the cookie.

Your tummy makes a rumbling sound.

>l
High above the Living Room
You can see a glass of milk here.

>i
You are carrying nothing.

* * *

>z
Time passes.

>z
Time passes.

You are a hungry, hungry hippo.

>LOOK
High above the Living Room
You can see a cookie and a glass of milk here.

>eat cookie
You nibble at the cookie.

You eat the cookie. Not bad.

>z
Time passes.

>z
Time passes.

>eat cookie
You can't see any such thing.

* * *

>z
Time passes.

You are a hungry, hungry hippo.

>z
Time passes.

>z.z.z.z.z.z.
Time passes.

Time passes.

Your tummy makes a rumbling sound.

Time passes.

Time passes.

Time passes.

You find yourself staring at the Christmas tree and wondering how it would taste.

Time passes.

>down
A wild cat appears. It has not noticed you yet.

Meow

>z.z.z.z.z
Time passes.

Your tummy makes a rumbling sound.

Hiss

Time passes.

Hiss

Time passes.

Hiss

Time passes.

You find yourself staring at the Christmas tree and wondering how it would taste.

Hiss

Time passes.

Hiss

* * *

>drink milk
The glass is too tall. You couldn't possibly drink the milk without knocking it over.

>eat milk
The glass is too tall. You couldn't possibly drink the milk without knocking it over.

Your tummy makes a rumbling sound.

* * *

>knock over milk
CRASH.

* * *

>d
A wild cat appears. It has not noticed you yet.

>x cat
It is a cat.

You are a hungry, hungry hippo.

* * *

>down
A wild cat appears. It immediately notices you.

The cat hisses at you.

>take milk
The glass is too big. You couldn't possibly take it without knocking it over.

Your tummy makes a rumbling sound.

>drink milk
Little known fact: house hippos are lactose intolerant.

>down
The cat hisses at you. You will need to find a way to distract the cat if you want to get down safely.

>knock over milk
CRASH.

Living Room
There is a tree here, under which is a stack of presents. There is also a table,, next to which is a neat stack of presents, forming a staircase to the top.

Living Room
There is a tree here, under which is a stack of presents. There is also a table,, next to which is a neat stack of presents, forming a staircase to the top.

You are a hungry, hungry hippo.

* * *

>down
A wild cat appears. It immediately notices you.

The cat hisses at you.

>push milk
CRASH.

Living Room
There is a tree here, under which is a stack of presents. There is also a table,, next to which is a neat stack of presents, forming a staircase to the top.

You find yourself staring at the pile of presents and wondering how it would taste.

>up
You scramble up the pile of presents onto the table top.

High above the Living Room
You can see a cookie here.

>down
You carefully climb back down the stack of presents.

Living Room
There is a tree here, under which is a stack of presents. There is also a table,, next to which is a neat stack of presents, forming a staircase to the top.

>restart
Are you sure you want to restart?

>y
'Twas the night before Christmas when all through the house, the only creature stirring was a hippo the size of a mouse.

More text!

And A Hippo New Year
an interactive holiday tale by Erin Gigglecreek
Release 1 / Serial number 121224 / Inform 7 build 6G60 (I6/v6.32 lib 6/12N) SD

If you are unfamiliar with Interactive Fiction, type HELP for a quick introduction on how to play. 

Living Room
There is a tree here.

>x tree.up.push presents.up
It's a Holiday tree.

You climb to the top of the presents. You seem to be about level with a table, on which stands a glass of milk and a plate of cookies. The pile starts to wobble, and you quickly make your way back down.

Living Room
There is a tree here, under which is a stack of presents. There is also a table,.

You push the bottom package with your head, being careful to prevent the pile from falling over. It's hard work, but eventually you move the entire stack over to the table.

Your tummy makes a rumbling sound.

You scramble up the pile of presents onto the table top.

High above the Living Room
You can see a cookie and a glass of milk here.

>push milk
CRASH.
The cat comes running. Blah.

Living Room
There is a tree here, under which is a stack of presents. There is also a table,, next to which is a neat stack of presents, forming a staircase to the top.

>up
You scramble up the pile of presents onto the table top.

High above the Living Room
You can see a cookie here.

Your tummy makes a rumbling sound.

>up
The only way down is well.. DOWN.

>push cookie
You push the cookie off the table. It falls to the floor below.

>z
Time passes.

You find yourself staring at the Christmas tree and wondering how it would taste.

>z
Time passes.

>z
Time passes.

Your tummy makes a rumbling sound.

>z
Time passes.

>z.z.z.z.z
Time passes.

Your tummy makes a rumbling sound.

Time passes.

Time passes.

Time passes.

You find yourself staring at the Christmas tree and wondering how it would taste.

Time passes.

>z.z.z.z
Time passes.

Time passes.

Your tummy makes a rumbling sound.

Time passes.

Time passes.

>z.z.z.z
Time passes.

You are a hungry, hungry hippo.

Time passes.

Time passes.

Time passes.

You find yourself staring at the Christmas tree and wondering how it would taste.

* * *

>down
A wild cat appears. It immediately notices you.

The cat hisses at you.

>d
You will need to find a way to distract the cat if you want to get down safely.

You find yourself staring at the Christmas tree and wondering how it would taste.

The cat hisses at you.

>d
You will need to find a way to distract the cat if you want to get down safely.

The cat hisses at you.

>d
You will need to find a way to distract the cat if you want to get down safely.

The cat hisses at you.

* * *

>x cookie
cookies!

>x milk
milk

You find yourself staring at the pile of presents and wondering how it would taste.

>take milk
The glass is too big. You couldn't possibly take it without knocking it over.

>takle cookie
That's not a verb I recognize.

>take cookie
You take a cookie. It's larger than you are.

>l
High above the Living Room
You can see a cookie and a glass of milk here.

You find yourself staring at the pile of presents and wondering how it would taste.

* * *

>take plate
You should save some cookies for Santa!

>i
You are carrying nothing.

You are a hungry, hungry hippo.

>l
High above the Living Room
You can see a plate of cookies and a glass of milk here.

>take cookie
You take a cookie. It's larger than you are.

>i
You are carrying nothing.

Your tummy makes a rumbling sound.

* * *

>take cookie
You take a cookie. It's larger than you are.

Taken.

>i
You are carrying:
  a cookie

You are a hungry, hungry hippo.

>eat cookie
You nibble at the cookie.

>g
You're not hungry right now.

>take cookie
You take a cookie. It's larger than you are.

You can only carry one thing in your mouth at a time. But some items can be pushed around or worn.

>i
You are carrying:
  a cookie

* * *

>x tree.up.x presents.up.eat cookie
It's a Holiday tree.

You climb to the top of the presents. You seem to be about level with a table, on which stands a glass of milk and a plate of cookies. The pile starts to wobble, and you quickly make your way back down.

Living Room
There is a tree here, under which is a stack of presents. There is also a table,.

A pile of presents stacked neatly under the tree, with the largest package on the bottom and the smallest at the top.

Your tummy makes a rumbling sound.

You climb to the top of the presents. You seem to be about level with a table, on which stands a glass of milk and a plate of cookies. The pile starts to wobble, and you quickly make your way back down.

Living Room
There is a tree here, under which is a stack of presents. There is also a table,.

You can't see any such thing.

>push presents.up
You push the bottom package with your head, being careful to prevent the pile from falling over. It's hard work, but eventually you move the entire stack over to the table.

You scramble up the pile of presents onto the table top.

High above the Living Room
You can see a cookie and a glass of milk here.

You are a hungry, hungry hippo.

>eat cookie
You nibble at the cookie.

>eat cookie
You're full. Save some for Santa.

>x cookie
Nibbled.

>take cookie
Taken.

>eat milk
You do not drink the milk.

>drink milk
There's nothing suitable to drink here.

* * *

>z.z.z.z.z
Time passes.

Time passes.

Time passes.

You find yourself staring at the Christmas tree and wondering how it would taste.

Time passes.

Time passes.

>z.z.z.z
Time passes.

You are a hungry, hungry hippo.

Time passes.

Time passes.

Time passes.

You find yourself staring at the Christmas tree and wondering how it would taste.

>x tree.up.push presents.up
It's a Holiday tree.

You climb to the top of the presents. You seem to be about level with a table, on which stands a glass of milk and a plate of cookies. The pile starts to wobble, and you quickly make your way back down.

Living Room
There is a tree here, under which is a stack of presents. There is also a table,.

You push the bottom package with your head, being careful to prevent the pile from falling over. It's hard work, but eventually you move the entire stack over to the table.

Your tummy makes a rumbling sound.

You scramble up the pile of presents onto the table top.

High above the Living Room
You can see a cookie and a glass of milk here.

>down
A wild cat appears. It immediately notices you.

The cat hisses at you.

>d
You will need to find a way to distract the cat if you want to get down safely.

Your tummy makes a rumbling sound.

The cat hisses at you.

>d
You will need to find a way to distract the cat if you want to get down safely.

The cat hisses at you.

* * *

>xyzzy
I want a hippopotamus for Christmas.
Only a hippopotamus will do.

>plugh
Gesundheit!

>plover
Gesundheit!

Your tummy makes a rumbling sound.

* * *

>z
Time passes.

>x presents
There are piles of presents surrounding the tree. There is one rather tall pile of presents in a neat stack.

>up
You climb to the top of the presents. You seem to be about level with a table, on which stands a glass of milk and a plate of cookies. The pile starts to wobble, and you quickly make your way back down.

Living Room
There is a tree here, decorated with ornaments and surrounded by piles of presents. There is also a table.

* * *

>push presnts
You can't see any such thing.

>push presents
You push the bottom package with your head, being careful to prevent the pile from falling over. It's hard work, but eventually you move the entire stack over to the table.

>z.z.z.z.z.z
Time passes.

Your tummy makes a rumbling sound.

Time passes.

Time passes.

Do you need a HINT?

You find yourself staring at the table and wondering how it would taste.

Time passes.

Time passes.

>z.z.z.z
Time passes.

You find yourself staring at the packages and wondering how it would taste.

Time passes.

Time passes.

Time passes.

Your tummy makes a rumbling sound.

>z.z.z.z.z.z
Time passes.

Time passes.

Time passes.

You find yourself staring at the lights and wondering how it would taste.

Time passes.

Time passes.

Time passes.

Your tummy makes a rumbling sound.

>z.z.z.z.z
Time passes.

Time passes.

Time passes.

Your tummy makes a rumbling sound.

Time passes.

Time passes.

* * *

>count tree
There's just the one.

>count garland
You can't see any such thing.

>count ornaments
There are 69,105 ornaments on the tree.

>l
Living Room
There is a tree here.

You find yourself staring at the ornaments and wondering how it would taste.

>kijklj
That's not a verb I recognize.

* * *

>count tree
There's just the one.

>count ornaments
There are 69,105 ornaments on the tree.

That's not a verb I recognize.

* * *

>count tree
There's just the one.

>count me
You are truly one of a kind.

>count cat
He isn't available.

You find yourself staring at the ornaments and wondering how it would taste.

>x cat
It is a cat.

>count ornaments
There are 69,105 ornaments on the tree.

There is more than one.

* * *

>count ornaments
There are 69,105 ornaments on the tree.

>take ornaments
You tug on a dangling bit of garland with your teeth. A piece breaks off, about as long as you are.

* * *

>take ornaments
You tug on a dangling bit of garland with your teeth. A piece breaks off, about as long as you are.

>take ornaments
You can't reach any more ornaments.

* * *

>take ornaments
You tug on a dangling bit of garland with your teeth. A piece breaks off, about as long as you are.

>push garland
You give the garland a nudge, pushing it along ahead of you.

>i
You are carrying:
  a garland

>push garland north
The garland cannot be pushed from place to place.

* * *

>take ornaments
You tug on a dangling bit of garland with your teeth. A piece breaks off, about as long as you are.

>i
You are carrying:
  a garland

>se
Hallway Closet
HIPPO SHACK!

You can see your nest here.

>put garland on nest
You put the garland on the nest.

>undo
Hallway Closet
[Previous turn undone.]

>put garland in nest
That can't contain things.

>undo
Hallway Closet
[Previous turn undone.]

>add garland to test
That's not a verb I recognize.

* * *

>take ornaments
You tug on a dangling bit of garland with your teeth. A piece breaks off, about as long as you are.

>se
Hallway Closet
HIPPO SHACK!

You can see your nest here.

* * *

>undo
Hallway Closet
[Previous turn undone.]

>put garland in nest
You put the garland on the nest.

>undo
Hallway Closet
[Previous turn undone.]

>drop garland
You put the garland on the nest.

* * *

>steal garland
That's not a verb I recognize.

* * *

>hint
You need help.

>z.z.z.z.z.z.z
There's no time for that!

There's no time for that!

There's no time for that!

Your tummy makes a rumbling sound.

There's no time for that!

There's no time for that!

There's no time for that!

You are a hungry, hungry hippo.

There's no time for that!

>z
There's no time for that!

>z
There's no time for that!

Your tummy makes a rumbling sound.

>z
There's no time for that!

>z
There's no time for that!

>z.z.z.z
There's no time for that!

There's no time for that!

You are a hungry, hungry hippo.

There's no time for that!

There's no time for that!

>LOOK
Living Room
There is a tree here.

Your tummy makes a rumbling sound.

>LOOK
Living Room
There is a tree here.

>z
There's no time for that!

>LOOK
Living Room
There is a tree here.

Your tummy makes a rumbling sound.

>yes
(addressing the cat)
If the cat can understand you, it does not deign to respond.

* * *

>z.z.z.z.z.z.z.z
Time passes.

Time passes.

Time passes.

Your tummy makes a rumbling sound.

Time passes.

Time passes.

Time passes.

You are a hungry, hungry hippo.

Time passes.

Time passes.

>z
Time passes.

You are a hungry, hungry hippo.

>z
Do you need a HINT?

>z
Time passes.

>z
There's no time for that!

Your tummy makes a rumbling sound.

* * *

>z
Time passes.

>y
(addressing the cat)
You need help.

You are a hungry, hungry hippo.

>l
Living Room
There is a tree here.

>z.z.z.z.z
Time passes.

Time passes.

Your tummy makes a rumbling sound.

Time passes.

Time passes.

Time passes.

Your tummy makes a rumbling sound.

>z
Time passes.

* * *

>y
(addressing the cat)
If the cat can understand you, it does not deign to respond.

>z.z.z.z.z
Time passes.

Time passes.

Your tummy makes a rumbling sound.

Time passes.

Time passes.

Do you need a HINT?

You find yourself staring at the Christmas tree and wondering how it would taste.

>y
You need help.

>yes
If the cat can understand you, it does not deign to respond.

>hint
You need help.

>think
You need help.

You find yourself staring at the ornaments and wondering how it would taste.

* * *

>think
What a good idea.

>think
What a good idea.

* * *

>think.z.think.z
What a good idea.

Time passes.

What a good idea.

Your tummy makes a rumbling sound.

Time passes.

>think
What a good idea.

>think
What a good idea.

Your tummy makes a rumbling sound.

>z
Time passes.

>sit
What do you want to sit on?

>z
Time passes.

* * *

>z.z.z.z
Time passes.

Time passes.

Time passes.

You are a hungry, hungry hippo.

Time passes.

>z
Do you need a HINT?

>yes
You need help.

You find yourself staring at the ornaments and wondering how it would taste.

* * *

>stick tongue
That's not a verb I recognize.

* * *

>stick out tongue
You stick your tongue out at yourself. The insult goes unnoticed.

>stick tongue out
You stick your tongue out at the ornaments. The insult goes unnoticed.

* * *

>stick out tongue
You stick your tongue out at yourself. The insult goes unnoticed.

>stick out tongue
You stick your tongue out at the ornaments. The insult goes unnoticed.

>stick out tongue
You stick your tongue out at the ornaments. The insult goes unnoticed.

>stick out tongue
You stick your tongue out at the cat. The insult goes unnoticed.

>x cat
It is a cat.

>l
Living Room
There is a tree here.

* * *

>stick tongue  uot
I didn't understand that sentence.

>stick tongue out
I didn't understand that sentence.

* * *

>x tree.up.push presents.up.take cookie
It's a Holiday tree.

You climb to the top of the presents. You seem to be about level with a table, on which stands a glass of milk and a plate of cookies. The pile starts to wobble, and you quickly make your way back down.

Living Room
There is a tree here, under which is a stack of presents. There is also a table,.

You push the bottom package with your head, being careful to prevent the pile from falling over. It's hard work, but eventually you move the entire stack over to the table.

You are a hungry, hungry hippo.

You scramble up the pile of presents onto the table top.

High above the Living Room
You can see a plate of cookies and a glass of milk here.

You take a cookie. It's larger than you are.

You take a cookie. It's larger than you are.

You take a cookie. It's larger than you are.

You take a cookie. It's larger than you are.

You take a cookie. It's larger than you are.

You take a cookie. It's larger than you are.

You take a cookie. It's larger than you are.

You take a cookie. It's larger than you are.

You take a cookie. It's larger than you are.

You take a cookie. It's larger than you are.

You take a cookie. It's larger than you are.

You take a cookie. It's larger than you are.

You take a cookie. It's larger than you are.

You take a cookie. It's larger than you are.

You take a cookie. It's larger than you are.

You take a cookie. It's larger than you are.

You take a cookie. It's larger than you are.

You take a cookie. It's larger than you are.

* * *

>push tree
You try with all your might, but it barely moves.

>push ornaments
You try with all your might, but it barely moves.

>push hat
You can't see any such thing.

>push garland
You can't see any such thing.

>take ornaments
You tug on a dangling bit of garland with your teeth. A piece breaks off, about as long as you are.

>push garland
Nothing obvious happens.

* * *

>sigh
That's not a verb I recognize.

>yawn
That's not a verb I recognize.

* * *

>se
Hallway Closet
This is the closet where you will be spending the night. It is full of things that you don't need to think about right now.

You can see your nest and a mitten here.

>out
But you aren't in anything at the moment.

>go home
You can't see any such thing.

* * *

>se
Hallway Closet
This is the closet where you will be spending the night. It is full of things that you don't need to think about right now.

You can see your nest and a mitten here.

>n
There's no need to explore the rest of the house.

>n
There's no need to explore the rest of the house.

* * *

>se
Hallway Closet
This is the closet where you will be spending the night. It is full of things that you don't need to think about right now.

You can see your nest and a mitten here.

>nw
Living Room
There is a tree here.

>se
Inside the Closet.

>l
Inside the Closet.

* * *

>se
Hallway Closet
This is the closet where you will be spending the night. It is full of things that you don't need to think about right now.

You can see your nest and a mitten here.

>x nest
It is a warm, comfortable mass of dryer lint and bits of string.

* * *

>se
Hallway Closet
This is the closet where you will be spending the night. It is full of things that you don't need to think about right now.

You can see your nest and a mitten here.

>take nest
That's fixed in place.

* * *

>se
Hallway Closet
This is the closet where you will be spending the night. It is full of things that you don't need to think about right now.

You can see your nest and a mitten here.

>x mitten
It's a small mitten. It is sopping wet, and the mate is nowhere to be seen.

>take mitten
Taken.

* * *

>x wall
Unless specifically mentioned by the text, avoid general concepts like the floor and ceiling. Try typing LOOK and then using verbs like TAKE or EXAMINE on the things you see mentioned.

To stop these messages entirely, type NOVICE OFF.

>novice off
Novice mode disabled.

>novice off
I only understood you as far as wanting to novice.

>x wall
You can't see any such thing.

* * *

>x up
You peer up at the holiday tree.

>x n
You don't see anything in that direction.

>x se
You see the inside the closet in that direction.

>nw
There's no need to explore the rest of the house.

>se
Inside the Closet
HIPPO SHACK!

>x ne
You don't see anything in that direction.

>s nw
I only understood you as far as wanting to s.

>x nw
You see the living room in that direction.

* * *

>x up
You peer up at the holiday tree.

>x se
You see the hallway closet in that direction.

* * *

>s se
I only understood you as far as wanting to s.

>s sw
I only understood you as far as wanting to s.

>x se
You see nothing unexpected in that direction.

>x up
You peer up at the holiday tree.

>x closet
You see nothing special about the closet.

>x se
You see nothing unexpected in that direction.

>x sw
You see nothing unexpected in that direction.

* * *

>x se
The Hallway Closet lies in that direction.

>x nest
You can't see any such thing.

>x closet
Your nest is in there.

>x presents.up
There are piles of presents surrounding the tree. There is one rather tall pile of presents in a neat stack.

You climb to the top of the presents. You seem to be about level with a table, on which stands a glass of milk and a plate of cookies. The pile starts to wobble, and you quickly make your way back down.

Living Room
There is a tree here, decorated with ornaments and surrounded by piles of presents. There is also a table.. Your home is in the closet to the southeast.

* * *

>x tree.up.x table
It's a Holiday tree.

You climb to the top of the presents. You seem to be about level with a table, on which stands a glass of milk and a plate of cookies. The pile starts to wobble, and you quickly make your way back down.

Living Room
There is a tree here, under which is a stack of presents. There is also a table,.

Table.

>look under table
You find the remains of a melted icicle.

>l
Living Room
There is a tree here, under which is a stack of presents. There is also a table,.

>drink icicle
You lap at the cold water and feel instantly refreshed.

>take icicle
Don't be ridiculous.

* * *

>swim
There is nothing to swim in.

>x tree.up.look under table
It's a Holiday tree.

You climb to the top of the presents. You seem to be about level with a table, on which stands a glass of milk and a plate of cookies. The pile starts to wobble, and you quickly make your way back down.

Living Room
There is a tree here, under which is a stack of presents. There is also a table,.

You find the remains of a melted icicle.

>swim
The puddle is not deep enough to swim in, but you splash around for a bit.

>lick puddle
You give the puddle of water. a lick. Bleh! That doesn't appear to be food.

* * *

>x tree.up.look under table
It's a Holiday tree.

You climb to the top of the presents. You seem to be about level with a table, on which stands a glass of milk and a plate of cookies. The pile starts to wobble, and you quickly make your way back down.

Living Room
There is a tree here, under which is a stack of presents. There is also a table,.

You find the remains of a melted icicle.

>lick puddle
You must supply a noun.

* * *

>LOOK
Living Room
There is a tree here, decorated with ornaments and surrounded by piles of presents. There is also a table off to one side. The hallway closet is to the southeast.

>LOOK
Living Room
There is a tree here.

>LOOK
Living Room
There is a tree here.

* * *

>LOOK
Living Room
There is a tree here, decorated with ornaments and surrounded by piles of presents. There is also a table off to one side. The hallway closet is to the southeast.

>look
Living Room
There is a tree here, decorated with ornaments and surrounded by piles of presents. There is also a table off to one side. The hallway closet is to the southeast.

>attack all
You can't use multiple objects with that verb.

>examine all
You can't use multiple objects with that verb.

>se
One at a time! You are only a tiny hippo.

Hallway Closet
This is the closet where you will be spending the night. It is full of things that you don't need to think about right now.

You can see your nest and a mitten here.

>take all
You can only carry one thing at a time!

>LOOK
Hallway Closet
This is the closet where you will be spending the night. It is full of things that you don't need to think about right now.

You can see your nest and a mitten here.

* * *

>x lights
The tree is covered with tiny rainbow lights. The string of lights trails down from the lower branches to the power outet. It is emitting quite a bit of heat.

>se
Hallway Closet
HIPPO SHACK!

You can see your nest and a mitten here.

>x mitten
It's a child's mitten. It is sopping wet, and the mate is nowhere to be seen.

>take mitten
Taken.

>nw
Living Room
There is a tree here, decorated with ornaments and surrounded by piles of presents.

* * *

>x lights
The tree is covered with tiny rainbow lights. The string of lights trails down from the lower branches to the power outet. It is emitting quite a bit of heat.

>x outlet
It's a typical power outlet. The Christmas lights are plugged into it.

* * *

>se.take mitten.nw
Hallway Closet
HIPPO SHACK!

You can see your nest and a mitten here.

Taken.

Living Room
There is a tree here, decorated with ornaments and surrounded by piles of presents.

>put mitten under lights
If you can see an object, you can usually just interact with it directly without worrying about your position. Try a command like EXAMINE LIGHTS for a closer look at something, LOOK to get a new description of this location, or a direction like UP (or U) to move to a different location.

To stop these messages entirely, type NOVICE OFF.

>put mitten on lights
You lay the mitten across the strand of lights where it nearly touches the floor.

>z.z
Time passes.

Time passes.

>z
Time passes.

The mitten starts to smoke. You'd better go get it.

>take mitten
That seems to be a part of the lights.

* * *

>se.take mitten.nw.put mitten on lights.z.z.z
Hallway Closet
HIPPO SHACK!

You can see your nest and a mitten here.

Taken.

Living Room
There is a tree here, decorated with ornaments and surrounded by piles of presents.

You lay the mitten across the strand of lights where it nearly touches the floor.

Time passes.

Time passes.

Time passes.

The mitten starts to smoke. You'd better go get it.

>x mitten
It's a child's mitten. It looks very warm and soft.

>x lights
The tree is covered with tiny rainbow lights. The strand of lights trails down from the lower branches to the power outet. It is emitting quite a bit of heat.

>take mitten
You quickly retrieve the mitten. It is now dry, and almost too hot to touch.

[Your score has just gone up by three points.]

* * *

>x presents.up.push presents.up
There are piles of presents surrounding the tree. There is one rather tall pile of presents in a neat stack.

You climb to the top of the presents. You seem to be about level with a table, on which stands a glass of milk and a plate of cookies. The pile starts to wobble, and you quickly make your way back down.

Living Room
There is a tree here, decorated with ornaments and surrounded by piles of presents. There is also a table, about the same height as the stack of presents under the tree. Your home is in the closet to the southeast.

You push the bottom package with your head, being careful to prevent the pile from falling over. It's hard work, but eventually you move the entire stack over to the table.

Your tummy makes a rumbling sound.

You scramble up the pile of presents onto the table top.

High above the Living Room
You are standing on top of the table.

You can see a plate of cookies and a glass of milk here.

>push milk
The glass of milk goes crashing to the floor. A light goes on in the hallway, and you quickly dash back down the pile of presents and hide behind a table leg.
One of the big humans of the house comes running. . She cleans up the milk and broken glass. The big humans doesn't appear to notice anything else out of order. She mutters something about the cat and goes back to bed.

Living Room
There is a tree here, decorated with ornaments and surrounded by piles of presents. There is also a table, next to which is a neat stack of presents, forming a staircase to the top.

* * *

>x presents.up.push presents.up.push milk
There are piles of presents surrounding the tree. There is one rather tall pile of presents in a neat stack.

You climb to the top of the presents. You seem to be about level with a table, on which stands a glass of milk and a plate of cookies. The pile starts to wobble, and you quickly make your way back down.

Living Room
There is a tree here, decorated with ornaments and surrounded by piles of presents. There is also a table.

You push the bottom package with your head, being careful to prevent the pile from falling over. It's hard work, but eventually you move the entire stack over to the table.

You are a hungry, hungry hippo.

You scramble up the pile of presents onto the table top.

High above the Living Room
Table description.

You can see a plate of cookies and a glass of milk here.

The glass of milk goes crashing to the floor. A light goes on in the hallway, and you quickly dash back down the pile of presents and hide behind a table leg.

One of the big humans of the house wanders sleepily into the room. She cleans up the milk and broken glass, mutters something about the cat and goes back to bed.

Living Room
There is a tree here, decorated with ornaments and surrounded by piles of presents. There is also a table, next to which is a neat stack of presents, forming a staircase to the top.

>restart
Are you sure you want to restart?

>y
'Twas the night before Christmas when all through the house, the only creature stirring was a hippo the size of a mouse.

More text!

And A Hippo New Year
an interactive holiday tale by Erin Gigglecreek
Release 1 / Serial number 121224 / Inform 7 build 6G60 (I6/v6.32 lib 6/12N) SD

If you are unfamiliar with Interactive Fiction, type HELP for a quick introduction on how to play. 

Living Room
There is a tree here, decorated with ornaments and surrounded by piles of presents.

>x gifts.up.push gifts.up.down
There are piles of presents surrounding the tree. There is one rather tall pile of presents in a neat stack.

You climb to the top of the presents. You seem to be about level with a table, on which stands a glass of milk and a plate of cookies. The pile starts to wobble, and you quickly make your way back down.

Living Room
There is a tree here, decorated with ornaments and surrounded by piles of presents. There is also a table.

You push the bottom package with your head, being careful to prevent the pile from falling over. It's hard work, but eventually you move the entire stack over to the table.

You are a hungry, hungry hippo.

You scramble up the pile of presents onto the table top.

High above the Living Room
Table description.

You can see a plate of cookies and a glass of milk here.

The cat of the house pads into the room, the bell on its collar jingling softly. It immediately takes notice of you.

The cat hisses at you.

>push milk
The glass of milk goes crashing to the floor. A light goes on in the hallway, and you quickly dash back down the pile of presents and hide behind a table leg.

One of the big humans of the house wanders sleepily into the room. The cat looks up guiltily and slinks off towards the bedroom. She cleans up the milk and broken glass, scolds the cat and goes back to bed.

Living Room
There is a tree here, decorated with ornaments and surrounded by piles of presents. There is also a table, next to which is a neat stack of presents, forming a staircase to the top.

You would give anything right now for a pile of potato chip crumbs.

* * *

>z.z.z.z.z.z.z.z.z
Time passes.

Time passes.

Time passes.

Time passes.

Time passes.

Do you need a HINT?

Time passes.

Time passes.

Time passes.

>z.z.z.z
Time passes.

Time passes.

You feeling very thirsty.

Time passes.

Time passes.

* * *

>x presents.up.l
There are piles of presents surrounding the tree. There is one rather tall pile of presents in a neat stack.

You climb to the top of the presents. You seem to be about level with a table, on which stands a glass of milk and a plate of cookies. The pile starts to wobble, and you quickly make your way back down.

Living Room
There is a tree here, decorated with ornaments and surrounded by piles of presents. There is also a table.

Living Room
There is a tree here, decorated with ornaments and surrounded by piles of presents. There is also a table.

* * *

>x closet
Your nest is in there.

>x southeast
the hallway closet lies in that direction.

* * *

>x sw
You don't see anything in that direction.

>x se
The the hallway closet lies in that direction.

* * *

>x presents.up
There are piles of presents surrounding the tree. There is one rather tall pile of presents in a neat stack.

You climb to the top of the presents. You seem to be about level with a table, on which stands a glass of milk and a plate of cookies. The pile starts to wobble, and you quickly make your way back down.

Living Room
There is a tree here, decorated with ornaments and surrounded by piles of presents. There is also a table, about the same height as the stack of presents under the tree. The hallway closet is to the southeast.

>push presents
You push the bottom package with your head, being careful to prevent the pile from falling over. It's hard work, but eventually you move the entire stack over to the table.

You find yourself staring at the closet and wondering how it would taste.

>l
Living Room
There is a tree here, decorated with ornaments and surrounded by piles of presents. There is also a table, next to which is a neat stack of presents, forming a staircase to the top. Your home is in the closet to the southeast.

* * *

>x presents.up
There are piles of presents surrounding the tree. There is one rather tall pile of presents in a neat stack.

You climb to the top of the presents. You seem to be about level with a table, on which stands a glass of milk and a plate of cookies. The pile starts to wobble, and you quickly make your way back down.

Living Room
There is a tree here, decorated with ornaments and surrounded by piles of presents. There is also a table, about the same height as the stack of presents under the tree. The hallway closet is to the southeast.

>se
Hallway Closet
This is the closet where you will be spending the night. It is full of things that you don't need to think about right now.

You can see your nest and a mitten here.

>n
The only way out is back to the northwest.

>enter nest
You get onto the nest.

>sleep
You aren't feeling especially drowsy.

* * *

>se.take mitten
Hallway Closet
This is the closet where you will be spending the night. It is full of things that you don't need to think about right now.

You can see your nest and a mitten here.

Ick. Soggy mittens don't make good bedding material.

* * *

>close eyes
You can't go to sleep yet! Besides, you're too thirsty to sleep.

>nap
You can't go to sleep yet!Besides, you're too thirsty to sleep.

* * *

>close eyes
You can't go to sleep yet! Besides, you're too thirsty to sleep.

>stay away
I didn't understand that sentence.

>stay awake
But it's so late, and you've been a very busy hippo tonight.

* * *

>x presents.up.push presents.look under tree.wear hat.up
There are piles of presents surrounding the tree. There is one rather tall pile of presents in a neat stack.

You climb to the top of the presents. You seem to be about level with a table, on which stands a glass of milk and a plate of cookies. The pile starts to wobble, and you quickly make your way back down.

Living Room
There is a tree here, decorated with ornaments and surrounded by piles of presents. There is also a table, about the same height as the stack of presents under the tree. The hallway closet is to the southeast.

You push the bottom package with your head, being careful to prevent the pile from falling over. It's hard work, but eventually you move the entire stack over to the table.

You find yourself staring at the garland-strand and wondering how it would taste.

You find a tiny santa hat. It must have fallen off one of the ornaments.

[Your score has just gone up by one point.]

You slip the hat on over your ears. You look adorable!

You scramble up the pile of presents onto the table top.

High above the Living Room
You are standing on top of the table.

You can see a plate of cookies and a glass of milk here.

Your tummy makes a rumbling sound.

>down.eat cookie.take cookie.down.growl
The cat of the house pads into the room, the bell on its collar jingling softly. It immediately takes notice of you.

The cat hisses at you.

You nibble hungrily at the cookie.

The cat hisses at you.

[Your score has just gone up by five points.]

That cookie is larger than you are. Maybe you can roll it.

The cat hisses at you.

You will need to find a way to distract the cat if you want to get down safely.

The cat hisses at you.

You can't reach into the Living Room.

You feeling very thirsty.

The cat hisses at you.

>growl at cat
You can't reach into the Living Room.

The cat hisses at you.

>hiss
You are a house hippo. House hippos do not hiss.

The cat hisses at you.

* * *

>x presents.up.push presents.up.down.growl at cat
There are piles of presents surrounding the tree. There is one rather tall pile of presents in a neat stack.

You climb to the top of the presents. You seem to be about level with a table, on which stands a glass of milk and a plate of cookies. The pile starts to wobble, and you quickly make your way back down.

Living Room
There is a tree here, decorated with ornaments and surrounded by piles of presents. There is also a table, about the same height as the stack of presents under the tree. The hallway closet is to the southeast.

You push the bottom package with your head, being careful to prevent the pile from falling over. It's hard work, but eventually you move the entire stack over to the table.

Visions of raisins dance in your head.

You scramble up the pile of presents onto the table top.

High above the Living Room
You are standing on top of the table.

You can see a plate of cookies and a glass of milk here.

The cat of the house pads into the room, the bell on its collar jingling softly. It immediately takes notice of you.

The cat hisses at you.

You growl menacingly at the cat. The cat hisses at you, arching its back.

You would give anything right now for a pile of potato chip crumbs.

The cat hisses at you.

>growl
You growl menacingly at the cat. The cat hisses at you, arching its back.

The cat hisses at you.

>growl at cat
You growl menacingly at the cat. The cat hisses at you, arching its back.

The cat hisses at you.

>hiss
You are a house hippo. House hippos do not hiss.

You are a hungry, hungry hippo.

The cat hisses at you.

>hiss at cat
You are a house hippo. House hippos do not hiss.

The cat hisses at you.

>push milk
The glass of milk goes crashing to the floor. A light goes on in the hallway, and you quickly dash back down the pile of presents and hide behind a table leg.

One of the big humans of the house wanders sleepily into the room. The cat looks up guiltily and slinks off towards the bedroom. She cleans up the milk and broken glass, scolds the cat and goes back to bed.

Living Room
There is a tree here, decorated with ornaments and surrounded by piles of presents. There is also a table, next to which is a neat stack of presents, forming a staircase to the top. The hallway closet is to the southeast.

You feeling very thirsty.

>look under table
You find the remains of a melted icicle.

You would give anything right now for a pile of potato chip crumbs.

>drink puddle
You lap at the cold water and feel instantly refreshed.

[Your score has just gone up by three points.]

>eat cookie
You can't see any such thing.

>up.eat cookie
You scramble up the pile of presents onto the table top.

High above the Living Room
You are standing on top of the table.

You can see a plate of cookies here.

You nibble hungrily at the cookie.

[Your score has just gone up by five points.]

>down
You carefully climb back down the stack of presents.

Living Room
There is a tree here, decorated with ornaments and surrounded by piles of presents. There is also a table, next to which is a neat stack of presents, forming a staircase to the top. The hallway closet is to the southeast.

>se.take mitten.nw
Hallway Closet
This is the closet where you will be spending the night. It is full of things that you don't need to think about right now.

You can see your nest and a mitten here.

You pick up the wet mitten. Ick. Soggy mittens don't make good bedding material.

Living Room
There is a tree here, decorated with ornaments and surrounded by piles of presents. There is also a table, next to which is a neat stack of presents, forming a staircase to the top. The hallway closet is to the southeast.

>x tree.x ornaments.x lights
It's a rather lovely Christmas tree, covered with rainbow lights, a silver garland and colorful, shiny ornaments. There is a collection of presents underneath the tree.

There are many different ornaments on the tree, many of which have been made by the small humans of the house.

The tree is covered with tiny rainbow lights. The string of lights trails down from the lower branches to the power outet. It is emitting quite a bit of heat.

>take ornaments
You tug on a dangling bit of garland with your teeth. A piece breaks off, about as long as you are.

You can only carry one thing in your mouth at a time. But some items can be pushed around or worn.

[Your score has just gone up by one point.]

>put mitten on lights
You lay the mitten across the string of lights where it nearly touches the floor.

>take mitten
The mitten isn't dry yet.

>z
Time passes.

>z
Time passes.

The mitten starts to smoke. You'd better go get it.

>take mitten
You quickly retrieve the mitten. It is now dry, and almost too hot to touch.

[Your score has just gone up by three points.]

>se
Hallway Closet
This is the closet where you will be spending the night. It is full of things that you don't need to think about right now.

You can see your nest here.

>drop mitten
You add the mitten to your nest.

>drop garland
You can't see any such thing.

>i
You are carrying nothing.

* * *

>take garland
You tug on a dangling bit of garland with your teeth. A piece breaks off, about as long as you are.

[Your score has just gone up by one point.]

>se
Hallway Closet
This is the closet where you will be spending the night. It is full of things that you don't need to think about right now.

You can see your nest and a mitten here.

>put garland on nest
[Your score has just gone up by one point.]

>nw.x presents.up.look under table
Living Room
There is a tree here, decorated with ornaments and surrounded by piles of presents. The hallway closet is to the southeast.

There are piles of presents surrounding the tree. There is one rather tall pile of presents in a neat stack.

You climb to the top of the presents. You seem to be about level with a table, on which stands a glass of milk and a plate of cookies. The pile starts to wobble, and you quickly make your way back down.

Living Room
There is a tree here, decorated with ornaments and surrounded by piles of presents. There is also a table, about the same height as the stack of presents under the tree. The hallway closet is to the southeast.

You find the remains of a melted icicle.

>se.take mitten.nw.put mitten on lights
Hallway Closet
This is the closet where you will be spending the night. It is full of things that you don't need to think about right now.

You can see your nest (on which is a garland) and a mitten here.

You pick up the wet mitten. Ick. Soggy mittens don't make good bedding material.

Living Room
There is a tree here, decorated with ornaments and surrounded by piles of presents. There is also a table, about the same height as the stack of presents under the tree. The hallway closet is to the southeast.

You lay the mitten across the string of lights where it nearly touches the floor.

You feeling very thirsty.

>z
Time passes.

>z
Time passes.

The mitten starts to smoke. You'd better go get it before you burn down the house.

>take mitten.se.drop mitten
You quickly retrieve the mitten. It is now dry, and almost too hot to touch.

[Your score has just gone up by three points.]

Hallway Closet
This is the closet where you will be spending the night. It is full of things that you don't need to think about right now.

You can see your nest (on which is a garland) here.

[Your score has just gone up by one point.]

>x nest
It is a warm, comfortable mass of dryer lint and bits of string. It's not as nice as your nest in the bedroom closet, but it will do for tonight.

On the nest are a mitten and a garland.

>nw.look under tree.wear hat.up.eat cookie
Living Room
There is a tree here, decorated with ornaments and surrounded by piles of presents. There is also a table, about the same height as the stack of presents under the tree. The hallway closet is to the southeast.

You don't see much with all the presents in the way.

I only understood the first part of that-- trying anyway.

Retrying as:
>WEAR HAT

Type UNDO if this isn't what you wanted to do, or CORRECT OFF to stop automatically correcting commands.

To stop these messages entirely, type NOVICE OFF.

You can't see any such thing.

>push presents.look under tree.wear hat.up.eat cookie
You push the bottom package with your head, being careful to prevent the pile from falling over. It's hard work, but eventually you move the entire stack over to the table.

You find yourself staring at the garland-strand and wondering how it would taste.

You find a tiny santa hat. It must have fallen off one of the ornaments.

You feeling very thirsty.

[Your score has just gone up by one point.]

You slip the hat on over your ears. You look adorable!

You scramble up the pile of presents onto the table top.

High above the Living Room
You are standing on top of the table.

You can see a plate of cookies and a glass of milk here.

Visions of raisins dance in your head.

You nibble hungrily at the cookie.

[Your score has just gone up by five points.]

>push milk.drink puddle
The glass of milk goes crashing to the floor. A light goes on in the hallway, and you quickly dash back down the pile of presents and hide behind a table leg.

One of the big humans of the house wanders sleepily into the room. She cleans up the milk and broken glass, mutters something about the cat and goes back to bed.

Living Room
There is a tree here, decorated with ornaments and surrounded by piles of presents. There is also a table, next to which is a neat stack of presents, forming a staircase to the top. The hallway closet is to the southeast.

You lap at the cold water and feel instantly refreshed.

Maybe you could just take a quick nap.

[Your score has just gone up by three points.]

* * *

>test me
(Testing.)

>[1] x presents
There are piles of presents surrounding the tree. There is one rather tall pile of presents in a neat stack.

>[2] up
You climb to the top of the presents. You seem to be about level with a table, on which stands a glass of milk and a plate of cookies. The pile starts to wobble, and you quickly make your way back down.

Living Room
There is a tree here, decorated with ornaments and surrounded by piles of presents. There is also a table, about the same height as the stack of presents under the tree. The hallway closet is to the southeast.

>[3] push presents
You push the bottom package with your head, being careful to prevent the pile from falling over. It's hard work, but eventually you move the entire stack over to the table.

Visions of raisins dance in your head.

>[4] up
You scramble up the pile of presents onto the table top.

High above the Living Room
You are standing on top of the table.

You can see a plate of cookies and a glass of milk here.

>[5] take cookie
That cookie is larger than you are. Maybe you can roll it.

>[6] push milk
The glass of milk goes crashing to the floor. A light goes on in the hallway, and you quickly dash back down the pile of presents and hide behind a table leg.

One of the big humans of the house wanders sleepily into the room. She cleans up the milk and broken glass, mutters something about the cat and goes back to bed.

Living Room
There is a tree here, decorated with ornaments and surrounded by piles of presents. There is also a table, next to which is a neat stack of presents, forming a staircase to the top. The hallway closet is to the southeast.

Visions of raisins dance in your head.

>score
You have so far scored 9 out of a possible 15, in 18 turns.

* * *

>restart
Are you sure you want to restart?

>y
'Twas the night before Christmas when all through the house, the only creature stirring was a hippo the size of a mouse.

This year you're going to stay awake long enough to see Santa Claws. You have set up a temporary nest in the hallway closet, and it just needs a few final touches. You intend to venture out to have a snack and look at the tree one more time, and then you will go hide in the closet and wait.

And A Hippo New Year
an interactive holiday tale by Erin Gigglecreek
Release 1 / Serial number 121224 / Inform 7 build 6G60 (I6/v6.32 lib 6/12N) SD

If you are unfamiliar with Interactive Fiction, type HELP for a quick introduction on how to play. 

Living Room
There is a tree here, decorated with ornaments and surrounded by piles of presents. The hallway closet is to the southeast.

>x presents.push presents.look under tree.wear hat
There are piles of presents surrounding the tree. There is one rather tall pile of presents in a neat stack.

You don't have any reason to push those around. Yet.

You don't see much with all the presents in the way.

You can't see any such thing.

* * *

>x cookie
You can't see any such thing.

>up
You scramble up the pile of presents onto the table top.

High above the Living Room
You are standing on top of the table.

You can see a plate of cookies here.

>push cookie.down
You push the cookie off the table. It falls to the floor below. It bounces twice, but does not shatter.

You carefully climb back down the stack of presents.

Living Room
There is a tree here, decorated with ornaments and surrounded by piles of presents. There is also a table, next to which is a neat stack of presents, forming a staircase to the top. The hallway closet is to the southeast.

You can see a cookie here.

You find yourself staring at the ornaments and wondering how it would taste.

>push cookie se
You roll the cookie southeast to the Hallway Closet.

Hallway Closet
This is the closet where you will be spending the night. It is full of things that you don't need to think about right now.

You can see your nest and a mitten here.

>l
Hallway Closet
This is the closet where you will be spending the night. It is full of things that you don't need to think about right now.

You can see a cookie, your nest, and a mitten here.

You are feeling very thirsty.

* * *

>up.push cookie.down.push cookie se
You scramble up the pile of presents onto the table top.

High above the Living Room
You are standing on top of the table.

You can see a plate of cookies here.

You push the cookie off the table. It falls to the floor below. It bounces twice, but does not shatter.

You carefully climb back down the stack of presents.

Living Room
There is a tree here, decorated with ornaments and surrounded by piles of presents. There is also a table, next to which is a neat stack of presents, forming a staircase to the top. The hallway closet is to the southeast.

You can see a cookie here.

You would give anything right now for a pile of potato chip crumbs.

You roll the cookie southeast.

Hallway Closet
This is the closet where you will be spending the night. It is full of things that you don't need to think about right now.

You can see your nest and a mitten here.

>l
Hallway Closet
This is the closet where you will be spending the night. It is full of things that you don't need to think about right now.

You can see a cookie, your nest, and a mitten here.

You are feeling very thirsty.

* * *

>x presents.up.push presents
There are piles of presents surrounding the tree. There is one rather tall pile of presents in a neat stack.

You climb to the top of the presents. You seem to be about level with a table, on which stands a glass of milk and a plate of cookies. The pile starts to wobble, and you quickly make your way back down.

Living Room
There is a tree here, decorated with ornaments and surrounded by piles of presents. There is also a table, about the same height as the stack of presents under the tree. The hallway closet is to the southeast.

You push the bottom package with your head, being careful to prevent the pile from falling over. It's hard work, but eventually you move the entire stack over to the table.

You would give anything right now for a pile of potato chip crumbs.

>look under tree
You find a tiny santa hat. It must have fallen off one of the ornaments.

[Your score has just gone up by one point.]

>g
You find nothing of interest.

* * *

>x presents.up.push presents.look under tree.wear hat
There are piles of presents surrounding the tree. There is one rather tall pile of presents in a neat stack.

You climb to the top of the presents. You seem to be about level with a table, on which stands a glass of milk and a plate of cookies. The pile starts to wobble, and you quickly make your way back down.

Living Room
There is a tree here, decorated with ornaments and surrounded by piles of presents. There is also a table, about the same height as the stack of presents under the tree. The hallway closet is to the southeast.

You push the bottom package with your head, being careful to prevent the pile from falling over. It's hard work, but eventually you move the entire stack over to the table.

Your tummy makes a rumbling sound.

You find a tiny santa hat. It must have fallen off one of the ornaments.

[Your score has just gone up by one point.]

You slip the hat on over your ears. You look adorable!

* * *

>x presents.up.push presents.look under tree
There are piles of presents surrounding the tree. There is one rather tall pile of presents in a neat stack.

You climb to the top of the presents. You seem to be about level with a table, on which stands a glass of milk and a plate of cookies. The pile starts to wobble, and you quickly make your way back down.

Living Room
There is a tree here, decorated with ornaments and surrounded by piles of presents. There is also a table, about the same height as the stack of presents under the tree. The hallway closet is to the southeast.

You push the bottom package with your head, being careful to prevent the pile from falling over. It's hard work, but eventually you move the entire stack over to the table.

You would give anything right now for a pile of potato chip crumbs.

You find a tiny santa hat. It must have fallen off one of the ornaments.

>wear hat
[Your score has just gone up by one point.]

* * *

>take hat
You already have that.

>look under table
You find the remains of a melted icicle.

Visions of raisins dance in your head.

>se
Hallway Closet
This is the closet where you will be spending the night. It is full of things that you don't need to think about right now.

You can see your nest and a mitten here.

>take mitten
You can only carry one thing in your mouth at a time. But some items can be pushed around or worn. You drop the santa hat to pick up the noun
You add the santa hat to your nest.

You pick up the wet mitten. Ick. Soggy mittens don't make good bedding material.

You already have that.

* * *

>x presents.up.push presents.up.take cookie.roll cookie.push milk.roll cookie
There are piles of presents surrounding the tree. There is one rather tall pile of presents in a neat stack.

You climb to the top of the presents. You seem to be about level with a table, on which stands a glass of milk and a plate of cookies. The pile starts to wobble, and you quickly make your way back down.

Living Room
There is a tree here, decorated with ornaments and surrounded by piles of presents. There is also a table, about the same height as the stack of presents under the tree. The hallway closet is to the southeast.

You push the bottom package with your head, being careful to prevent the pile from falling over. It's hard work, but eventually you move the entire stack over to the table.

Your tummy makes a rumbling sound.

You scramble up the pile of presents onto the table top.

High above the Living Room
You are standing on top of the table.

You can see a plate of cookies and a glass of milk here.

That cookie is larger than you are. Maybe you can roll it.

You push the cookie off the table. It falls to the floor below. It bounces twice, but does not shatter.

Visions of raisins dance in your head.

The glass of milk goes crashing to the floor. A light goes on in the hallway, and you quickly dash back down the pile of presents and hide behind a table leg.

One of the big humans of the house wanders sleepily into the room. She cleans up the milk and broken glass, mutters something about the cat and goes back to bed.

Living Room
There is a tree here, decorated with ornaments and surrounded by piles of presents. There is also a table, next to which is a neat stack of presents, forming a staircase to the top. The hallway closet is to the southeast.

You can't see any such thing.

>l
Living Room
There is a tree here, decorated with ornaments and surrounded by piles of presents. There is also a table, next to which is a neat stack of presents, forming a staircase to the top. The hallway closet is to the southeast.

* * *

>z
Time passes.

You yawn loudly. It is getting late.

>z
Time passes.

You are feeling very tired. Maybe you could just take a quick nap.

>.z.z.z.z
That's not a verb I recognize.

>z.z.z.z
Time passes.

You are feeling very tired. Maybe you could just take a quick nap.

Time passes.

You are feeling very tired. Maybe you could just take a quick nap.

Time passes.

You are struggling to keep your eyes open.

You can't go to sleep yet! You close your eyes, just for a moment... When you awaken, it is daytime and there is a tiny wrapped present next to your nest. Oh well. Maybe next year!

    *** Happy Holidays! ***

In that game you scored 15 out of a possible 15, in 27 turns.

Would you like to RESTART, RESTORE a saved game, QUIT, or UNDO the last command?

* * *

>LOOK
Hallway Closet (on the nest)
This is the closet where you will be spending the night. It is full of things that you don't need to think about right now.

On the nest you can see a mitten and a piece of garland.

You are feeling very tired. Maybe you could just take a quick nap.

>LOOK
Hallway Closet (on the nest)
This is the closet where you will be spending the night. It is full of things that you don't need to think about right now.

On the nest you can see a mitten and a piece of garland.

You are struggling to keep your eyes open.

>z.z.z.z.z
Time passes.

You are feeling very tired. Maybe you could just take a quick nap.

Time passes.

You are struggling to keep your eyes open.

Time passes.

You are feeling very tired. Maybe you could just take a quick nap.

You close your eyes, just for a moment... When you awaken, it is daytime and there is a tiny wrapped present next to your nest. Oh well. Maybe next year!

    *** Happy Holidays! ***

In that game you scored 15 out of a possible 15, in 27 turns.

Would you like to RESTART, RESTORE a saved game, QUIT, or UNDO the last command?

* * *

>restart
Are you sure you want to restart?

Please answer yes or no.

>y
'Twas the night before Christmas when all through the house, the only creature stirring was a hippo the size of a mouse.

This year you're going to stay awake long enough to see Santa Claws. You have set up a temporary nest in the hallway closet, and it just needs a few final touches. You intend to venture out to have a snack and look at the tree one more time, and then you will go hide in the closet and wait.

And A Hippo New Year
an interactive holiday tale by Erin Gigglecreek
Release 1 / Serial number 121225 / Inform 7 build 6G60 (I6/v6.32 lib 6/12N) SD

If you are unfamiliar with Interactive Fiction, type HELP for a quick introduction on how to play. 

Living Room
There is a tree here, decorated with ornaments and surrounded by piles of presents. There is also a table off to one side. The hallway closet is to the southeast.

>x table
There is a tall table off to one side.

>push presents
You try with all your might, but it barely moves.

* * *

>push presents
You don't have any reason to push those around. Maybe you can climb them first.

>up
You climb to the top of the presents. You seem to be about level with the table, on which stands a glass of milk and a plate of cookies. The pile starts to wobble, and you quickly make your way back down.

Living Room
There is a tree here, decorated with ornaments and surrounded by piles of presents. There is also a table, about the same height as the stack of presents under the tree. The hallway closet is to the southeast.

>push presnts
You can't see any such thing.

>push presents
You don't have any reason to push those around. Maybe you can climb them first.

* * *

>score
You have so far scored 15 out of a possible 15, in 23 turns.

>sleep
You close your eyes, just for a moment... When you awaken, it is daytime and there is a tiny wrapped present next to your nest. Oh well. Maybe next year!

    *** Happy Holidays! ***

In that game you scored 15 out of a possible 15, in 23 turns.

Would you like to RESTART, RESTORE a saved game, QUIT, or UNDO the last command?

* * *

>h
That's not a verb I recognize.

* * *

>x presents.up.push presents.look under tree.take hat
There are piles of presents surrounding the tree. There is one rather tall pile of presents in a neat stack.

You climb to the top of the presents. You seem to be about level with a table, on which stands a glass of milk and a plate of cookies. The pile starts to wobble, and you quickly make your way back down.

Living Room
There is a tree here, decorated with ornaments and surrounded by piles of presents. There is also a table, about the same height as the stack of presents under the tree. The hallway closet is to the southeast.

You push the bottom package with your head, being careful to prevent the pile from falling over. It's hard work, but eventually you move the entire stack over to the table.

Visions of raisins dance in your head.

You find a tiny santa hat. It must have fallen off one of the ornaments.

(first dropping santa hat to make room)
You can only carry one thing in your mouth at a time. But some items can be pushed around or worn.

Taken.

* * *

>x presents.up.push presents.take hat
There are piles of presents surrounding the tree. There is one rather tall pile of presents in a neat stack.

You climb to the top of the presents. You seem to be about level with a table, on which stands a glass of milk and a plate of cookies. The pile starts to wobble, and you quickly make your way back down.

Living Room
There is a tree here, decorated with ornaments and surrounded by piles of presents. There is also a table, about the same height as the stack of presents under the tree. The hallway closet is to the southeast.

You push the bottom package with your head, being careful to prevent the pile from falling over. It's hard work, but eventually you move the entire stack over to the table.

Visions of raisins dance in your head.

You can't see any such thing.

>look under tree
You find a tiny santa hat. It must have fallen off one of the ornaments.

* * *

>x presents.up.push presents.look under tree.se
There are piles of presents surrounding the tree. There is one rather tall pile of presents in a neat stack.

You climb to the top of the presents. You seem to be about level with a table, on which stands a glass of milk and a plate of cookies. The pile starts to wobble, and you quickly make your way back down.

Living Room
There is a tree here, decorated with ornaments and surrounded by piles of presents. There is also a table, about the same height as the stack of presents under the tree. The hallway closet is to the southeast.

You push the bottom package with your head, being careful to prevent the pile from falling over. It's hard work, but eventually you move the entire stack over to the table.

You would give anything right now for a pile of potato chip crumbs.

You find a tiny santa hat. It must have fallen off one of the ornaments.

Hallway Closet
This is the closet where you will be spending the night. It is full of things that you don't need to think about right now.

You can see your nest and a mitten here.

>i
You are carrying:
  a santa hat

You would give anything right now for a pile of potato chip crumbs.

>take mitten
You can only carry one thing in your mouth at a time. But some items can be pushed around or worn. You drop the santa hat to pick up the mitten.

You add the santa hat to your nest.

You pick up the wet mitten. Ick. Soggy mittens don't make good bedding material.

You already have that.

* * *

>test carry
(Testing.)

>[1] x presents
There are piles of presents surrounding the tree. There is one rather tall pile of presents in a neat stack.

>[2] up
You climb to the top of the presents. You seem to be about level with a table, on which stands a glass of milk and a plate of cookies. The pile starts to wobble, and you quickly make your way back down.

Living Room
There is a tree here, decorated with ornaments and surrounded by piles of presents. There is also a table, about the same height as the stack of presents under the tree. The hallway closet is to the southeast.

>[3] push presents
You push the bottom package with your head, being careful to prevent the pile from falling over. It's hard work, but eventually you move the entire stack over to the table.

Your tummy makes a rumbling sound.

>[4] look under tree
You find a tiny santa hat. It must have fallen off one of the ornaments.

>[5] se

Hallway Closet
This is the closet where you will be spending the night. It is full of things that you don't need to think about right now.

You can see your nest and a mitten here.

>[6] take mitten
You can only carry one thing in your mouth at a time. But some items can be pushed around or worn. You drop the santa hat to pick up the mitten.

You pick up the wet mitten. Ick. Soggy mittens don't make good bedding material.

You find yourself staring at the mitten and wondering how it would taste.

>nw.take garland
Living Room
There is a tree here, decorated with ornaments and surrounded by piles of presents. There is also a table, next to which is a neat stack of presents, forming a staircase to the top. The hallway closet is to the southeast.

You can only carry one thing in your mouth at a time. But some items can be pushed around or worn. You drop the mitten to pick up the garland..

You tug on a dangling bit of garland with your teeth. A piece breaks off, about as long as you are.

[Your score has just gone up by one point.]

>se
Hallway Closet
This is the closet where you will be spending the night. It is full of things that you don't need to think about right now.

You can see your nest (on which is a santa hat) here.

You are a hungry, hungry hippo.

>put garland on nest
You put the piece of garland on the nest.

[Your score has just gone up by one point.]

>enter nest
You get onto the nest.

On the nest you can see a piece of garland and a santa hat.

You are feeling very thirsty.

>take garland
Taken.

Your tummy makes a rumbling sound.

>take hat
You can only carry one thing in your mouth at a time. But some items can be pushed around or worn. You drop the piece of garland to pick up the santa hat.

*** Run-time problem P7: Too many rulebooks in simultaneous use.

>l
Hallway Closet (on the nest)
This is the closet where you will be spending the night. It is full of things that you don't need to think about right now.

On the nest you can see a santa hat.

>i
You are carrying:
  a piece of garland

>LOOK
Hallway Closet (on the nest)
This is the closet where you will be spending the night. It is full of things that you don't need to think about right now.

On the nest you can see a santa hat.

You find yourself staring at the piece of garland and wondering how it would taste.

>exit nest
I only understood the first part of that-- trying anyway.

Retrying as:
>EXIT

Type UNDO if this isn't what you wanted to do, or CORRECT OFF to stop automatically correcting commands.

To stop these messages entirely, type NOVICE OFF.

You get off the nest.

Hallway Closet
This is the closet where you will be spending the night. It is full of things that you don't need to think about right now.

You can see your nest (on which is a santa hat) here.

>drop hat
(first taking the santa hat)

You can only carry one thing in your mouth at a time. But some items can be pushed around or worn. You drop the piece of garland to pick up the santa hat.

You put the santa hat on the nest.

* * *

>get garland.se.
You tug on a dangling bit of garland with your teeth. A piece breaks off, about as long as you are.

[Your score has just gone up by one point.]

Hallway Closet
This is the closet where you will be spending the night. It is full of things that you don't need to think about right now.

You can see your nest and a mitten here.

>drop garland
Dropped.

>take garland
Taken.

>enter nest
You get onto the nest.

>put garland on nest
Dropped.

[Your score has just gone up by one point.]

>LOOK
Hallway Closet (on the nest)
This is the closet where you will be spending the night. It is full of things that you don't need to think about right now.

You can see a mitten here.

On the nest you can see a piece of garland.

>restart
Are you sure you want to restart?

* * *

Please answer yes or no.

>y
'Twas the night before Christmas when all through the house, the only creature stirring was a hippo the size of a mouse.

This year you're going to stay awake long enough to see Santa Claws. You have set up a temporary nest in the hallway closet, and it just needs a few final touches. You intend to venture out to have a snack and look at the tree one more time, and then you will go hide in the closet and wait.

And A Hippo New Year
an interactive holiday tale by Erin Gigglecreek
Release 1 / Serial number 121224 / Inform 7 build 6G60 (I6/v6.32 lib 6/12N) SD

If you are unfamiliar with Interactive Fiction, type HELP for a quick introduction on how to play. 

Living Room
There is a tree here, decorated with ornaments and surrounded by piles of presents. The hallway closet is to the southeast.

* * *

>suck
That's not a verb I recognize.

* * *

>se.suck mitten
Hallway Closet
This is the closet where you will be spending the night. It is full of things that you don't need to think about right now.

You can see your nest and a mitten here.

Surely you can find a more sanitary source of water.

>unplug
That's not a verb I recognize.

* * *

>x outlet
It's a typical power outlet. The Christmas lights are plugged into it.

>unplug lights
Don't do that.

* * *

>x table.x presents.x table.up.x table
There is a tall table off to one side.

There are piles of presents surrounding the tree. There is one rather tall pile of presents in a neat stack.

There is a tall table off to one side. It appears to be about the same height as the stack of presents.

You climb to the top of the presents. You seem to be about level with the table, on which stands a glass of milk and a plate of cookies. The pile starts to wobble, and you quickly make your way back down.

Living Room
There is a tree here, decorated with ornaments and surrounded by piles of presents. There is also a table, about the same height as the stack of presents under the tree. The hallway closet is to the southeast.

There is a tall table off to one side. It appears to be about the same height as the stack of presents, and you recall seeing cookies and milk at the top.

>push presents.x table
You push the bottom package with your head, being careful to prevent the pile from falling over. It's hard work, but eventually you move the entire stack over to the table.

You would give anything right now for a pile of potato chip crumbs.

There is a tall table off to one side. It appears to be about the same height as the stack of presents, and you recall seeing cookies and milk at the top.

>l
Living Room
There is a tree here, decorated with ornaments and surrounded by piles of presents. There is also a table, next to which is a neat stack of presents, forming a staircase to the top. The hallway closet is to the southeast.

* * *

>push presents.x table.x presents.push presents.x table
You try with all your might, but it barely moves.

There is a tall table off to one side.

There are piles of presents surrounding the tree. There is one rather tall pile of presents in a neat stack.

You don't have any reason to push those around. Maybe you can climb them first.

There is a tall table off to one side. It appears to be about the same height as the stack of presents.

>up.x table.push presents.x table
You climb to the top of the presents. You seem to be about level with the table, on which stands a glass of milk and a plate of cookies. The pile starts to wobble, and you quickly make your way back down.

Living Room
There is a tree here, decorated with ornaments and surrounded by piles of presents. There is also a table, about the same height as the stack of presents under the tree. The hallway closet is to the southeast.

There is a tall table off to one side. It appears to be about the same height as the stack of presents, and you recall seeing cookies and milk at the top.

You push the bottom package with your head, being careful to prevent the pile from falling over. It's hard work, but eventually you move the entire stack over to the table.

There is a tall table off to one side. It appears to be about the same height as the stack of presents, and you recall seeing cookies and milk at the top.

Visions of raisins dance in your head.

* * *

>x table.x presents.x table.up.x table.push presents.x table
There is a tall table off to one side.

There are piles of presents surrounding the tree. There is one rather tall pile of presents in a neat stack.

There is a tall table off to one side. It appears to be about the same height as the stack of presents under the tree.

You climb to the top of the presents. You seem to be about level with the table, on which stands a glass of milk and a plate of cookies. The pile starts to wobble, and you quickly make your way back down.

Living Room
There is a tree here, decorated with ornaments and surrounded by piles of presents. There is also a table, about the same height as the stack of presents under the tree. The hallway closet is to the southeast.

There is a tall table off to one side. It appears to be about the same height as the stack of presents under the tree, and you recall seeing cookies and milk at the top.

You push the bottom package with your head, being careful to prevent the pile from falling over. It's hard work, but eventually you move the entire stack over to the table.

Visions of raisins dance in your head.

There is a tall table off to one side. It appears to be about the same height as the stack of presents next to it, and you recall seeing cookies and milk at the top.

* * *

>restart
'Twas the night before Christmas when all through the house, the only creature stirring was a hippo the size of a mouse.

This year you're going to stay awake long enough to see Santa Claws. You have set up a temporary nest in the hallway closet, and it just needs a few final touches. You intend to venture out to have a snack and look at the tree one more time, and then you will go hide in the closet and wait.

And A Hippo New Year
an interactive holiday tale by Erin Gigglecreek
Release 1 / Serial number 121225 / Inform 7 build 6G60 (I6/v6.32 lib 6/12N) SD

If you are unfamiliar with Interactive Fiction, type HELP for a quick introduction on how to play. 

Living Room
There is a tree here, decorated with ornaments and surrounded by piles of presents. There is also a table off to one side. The hallway closet is to the southeast.

>push presents
You try with all your might, but it barely moves.

* * *

>x presents
There are piles of presents surrounding the tree. There is one rather tall pile of presents in a neat stack.

>up
You climb to the top of the presents. You seem to be about level with the table, on which stands a glass of milk and a plate of cookies. The pile starts to wobble, and you quickly make your way back down.

Living Room
There is a tree here, decorated with ornaments and surrounded by piles of presents. There is also a table, about the same height as the stack of presents under the tree. The hallway closet is to the southeast.

>LOOK
Living Room
There is a tree here, decorated with ornaments and surrounded by piles of presents. There is also a table, about the same height as the stack of presents under the tree. The hallway closet is to the southeast.

>push presents
You push the bottom package with your head, being careful to prevent the pile from falling over. It's hard work, but eventually you move the entire stack over to the table.

>restart
Are you sure you want to restart?

>y
'Twas the night before Christmas when all through the house, the only creature stirring was a hippo the size of a mouse.

This year you're going to stay awake long enough to see Santa Claws. You have set up a temporary nest in the hallway closet, and it just needs a few final touches. You intend to venture out to have a snack and look at the tree one more time, and then you will go hide in the closet and wait.

And A Hippo New Year
an interactive holiday tale by Erin Gigglecreek
Release 1 / Serial number 121225 / Inform 7 build 6G60 (I6/v6.32 lib 6/12N) SD

If you are unfamiliar with Interactive Fiction, type HELP for a quick introduction on how to play. 

Living Room
There is a tree here, decorated with ornaments and surrounded by piles of presents. There is also a table off to one side. The hallway closet is to the southeast.

* * *

>credits
 > About "And A Hippo New Year"
   How to Play
   Credits

>n
   About "And A Hippo New Year"
 > How to Play
   Credits
   About "And A Hippo New Year"
 > How to Play
   Credits

>n
   About "And A Hippo New Year"
   How to Play
 > Credits
   About "And A Hippo New Year"
   How to Play
 > Credits

The author can be contacted at <genericgeekgirl@gmail.com>. Thanks so much to my beta testers, who were happy to give me feedback on incredibly short notice: Jacqueline A. Lott, Matthew Miller, Ryan Spicer, Scott McCasland and Zach.

The house hippo was created by the Concerned Children's Advertisers, and appears here without permission. The original PSA is short and super cute, and can be viewed on CCA's YouTube channel at http://www.youtube.com/watch?v=G9hJK4fCq4U.

Please press SPACE to continue.

* * *

>take all
You can only carry one thing at a time.

>examine all
You can't use multiple objects with that verb.

>attack all
You can't use multiple objects with that verb.

>se
One at a time! You are only a tiny hippo.

Hallway Closet
This is the closet where you will be spending the night. It is full of things that you don't need to think about right now.

You can see your nest and a mitten here.

* * *

>take all
You can only carry one thing at a time!

>LOOK
One at a time! You are only a tiny hippo.

Hallway Closet
This is the closet where you will be spending the night. It is full of things that you don't need to think about right now.

You can see your nest and a mitten here.

>LOOK
One at a time! You are only a tiny hippo.

Hallway Closet
This is the closet where you will be spending the night. It is full of things that you don't need to think about right now.

You can see your nest and a mitten here.

* * *

>take all
You can only carry one thing at a time.

>take everything
You can only carry one thing at a time.

>take
What do you want to take?

>lick all
One at a time! You are only a tiny hippo.

>eat all
One at a time! You are only a tiny hippo.

>x tree
It's a rather lovely Christmas tree, covered with rainbow lights, a silver garland and colorful, shiny ornaments. There is a collection of presents underneath the tree.

>x lights
The tree is covered with tiny rainbow lights. The string of lights trails down from the lower branches to the power outlet. The wire is emitting quite a bit of heat.

>x garland
It's a strand of puffy silver garland. It looks very soft.

* * *

>take all
You can only carry one thing at a time.

>se
Hallway Closet
This is the closet where you will be spending the night. It is full of things that you don't need to think about right now.

You can see your nest and a mitten here.

>take all.take mitten.x nest.x all
You can only carry one thing at a time.

You pick up the wet mitten. Ick. Soggy mittens don't make good bedding material.

It is a warm, comfortable mass of dryer lint and bits of string. It's not as nice as your nest in the bedroom closet, but it will do for tonight.

There is just so much to look at, you can't take it all in at once!

>attack all
One at a time! You are only a tiny hippo.

>eat all
(the mitten)
You give the mitten a lick. Bleh! That doesn't appear to be food.

>ne
The only way out is back to the northwest.

* * *

>nw
Living Room
There is a tree here, decorated with ornaments and surrounded by piles of presents. There is also a table off to one side. The hallway closet is to the southeast.

>eat all
(the mitten)
You give the mitten a lick. Bleh! That doesn't appear to be food.

>restart
Are you sure you want to restart?

>y
'Twas the night before Christmas when all through the house, the only creature stirring was a hippo the size of a mouse.

This year you're going to stay awake long enough to see Santa Claws. You have set up a temporary nest in the hallway closet, and it just needs a few final touches. You intend to venture out to have a snack and look at the tree one more time, and then you will go hide in the closet and wait.

And A Hippo New Year
an interactive holiday tale by Adri ("Erin Gigglecreek")
Release 1 / Serial number 130108 / Inform 7 build 6G60 (I6/v6.32 lib 6/12N) SD

If you are unfamiliar with Interactive Fiction, type HELP for a quick introduction on how to play. 

Living Room
There is a tree here, decorated with ornaments and surrounded by piles of presents. There is also a table off to one side. The hallway closet is to the southeast.

* * *

>x all
There is just so much to look at, you can't take it all in at once!

>take all
There are none at all available!

>attack all
One at a time! You are only a tiny hippo.

>attack
What do you want to attack?

>look
Living Room
There is a tree here, decorated with ornaments and surrounded by piles of presents. There is also a table off to one side. The hallway closet is to the southeast.