Please pass the milk, please.
Please pass the milk, please.
Please pass the milk, please.

Fingertips: Please Pass the Milk Please
An interactive snack by Adri
Release 3 / Serial number 140312 / Inform 7 build 6G60 (I6/v6.32 lib 6/12N) SD

Kitchen (on the chair)
On the table are a milk carton, a plate of brownies, your glass, and Sam's cup.

Your brother Sam is sitting across from you.

>x c
It's missing.

>quit
Are you sure you want to quit?

>y
[ The game has finished ]

* * *

Please pass the milk, please.
Please pass the milk, please.
Please pass the milk, please.

Fingertips: Please Pass the Milk Please
An interactive snack by Adri
Release 3 / Serial number 140312 / Inform 7 build 6G60 (I6/v6.32 lib 6/12N) SD

Kitchen (on the chair)
On the table are a milk carton, a plate of brownies, your glass, and Sam's cup.

Your brother Sam is sitting across from you.

>dont pass the milk
That's not a verb I recognize.

>don't pass the milk
You pour the last of the milk into your glass. Sam looks like he's about to cry.

*** You did not pass the milk. ***

Kitchen
Your brother Sam is sitting across from you.

On the table are a carton of milk, a plate of brownies, and two cups.

* * *

Please pass the milk, please.
Please pass the milk, please.
Please pass the milk, please.

Fingertips: Please Pass the Milk Please
An interactive snack by Adri
Release 3 / Serial number 140312 / Inform 7 build 6G60 (I6/v6.32 lib 6/12N) SD

Kitchen (on the chair)
On the table are a milk carton, a plate of brownies, your glass, and Sam's cup.

Your brother Sam is sitting across from you.

>dont pass milk
You pour the last of the milk into your glass. Sam looks like he's about to cry.

*** You did not pass the milk. ***

Kitchen
Your brother Sam is sitting across from you.

On the table are a carton of milk, a plate of brownies, and two cups.

* * *

Please pass the milk, please.
Please pass the milk, please.
Please pass the milk, please.

Fingertips: Please Pass the Milk Please
An interactive snack by Adri
Release 3 / Serial number 140312 / Inform 7 build 6G60 (I6/v6.32 lib 6/12N) SD

Kitchen (on the chair)
On the table are a milk carton, a plate of brownies, your glass, and Sam's cup.

Your brother Sam is sitting across from you.

>run n
You stand up and walk away. Sam throws his cup at you.

*** You did not pass the milk. ***

Kitchen
Your brother Sam is sitting across from you.

On the table are a carton of milk, a plate of brownies, and two cups.

>run away
You're not allowed to run in the house!

* * *

Please pass the milk, please.
Please pass the milk, please.
Please pass the milk, please.

Fingertips: Please Pass the Milk Please
An interactive snack by Adri
Release 3 / Serial number 140312 / Inform 7 build 6G60 (I6/v6.32 lib 6/12N) SD

Kitchen (on the chair)
On the table are a milk carton, a plate of brownies, your glass, and Sam's cup.

Your brother Sam is sitting across from you.

>run
You're not allowed to run in the house!

>run n
I only understood you as far as wanting to run.

>run away
You're not allowed to run in the house!

>walk
You stand up and walk away. Sam throws his cup at you.

*** You did not pass the milk. ***

Kitchen
Your brother Sam is sitting across from you.

On the table are a carton of milk, a plate of brownies, and two cups.

>walk away
You stand up and walk away. Sam throws his cup at you.

*** You did not pass the milk. ***

Kitchen
Your brother Sam is sitting across from you.

On the table are a carton of milk, a plate of brownies, and two cups.

>x his glass
Sam's plastic cup has a robot on the front. It's empty.

>x my cup
It used to be a jelly jar. There's a wrap-around scene of a panda with an easel and a parade of penguins.

* * *

Please pass the milk, please.
Please pass the milk, please.
Please pass the milk, please.

Fingertips: Please Pass the Milk Please
An interactive snack by Adri
Release 3 / Serial number 140312 / Inform 7 build 6G60 (I6/v6.32 lib 6/12N) SD

Kitchen (on the chair)
On the table are a milk carton, a plate of brownies, your glass, and Sam's cup.

Your brother Sam is sitting across from you.

>x me
You're wearing the "Science is Real" t-shirt you got at the They Might Be Giants concert last summer. It's one of your favorites.

* * *

Please pass the milk, please.
Please pass the milk, please.
Please pass the milk, please.

Fingertips: Please Pass the Milk Please
An interactive snack by Adri
Release 3 / Serial number 140312 / Inform 7 build 6G60 (I6/v6.32 lib 6/12N) SD

Kitchen (on the chair)
On the table are a milk carton, a plate of brownies, your glass, and Sam's cup.

Your brother Sam is sitting across from you.

>run with scissors
The last thing you need right now is a trip to the hospital. Also, you don't have any scissors.

* * *

Please pass the milk, please.
Please pass the milk, please.
Please pass the milk, please.

Fingertips: Please Pass the Milk Please
An interactive snack by Adri
Release 3 / Serial number 140312 / Inform 7 build 6G60 (I6/v6.32 lib 6/12N) SD

Kitchen (on the chair)
On the table are a milk carton, a plate of brownies, your glass, and Sam's cup.

Your brother Sam is sitting across from you.

>don't pass milk
You pour the last of the milk into your glass. Sam looks like he's about to cry.

*** You did not pass the milk. ***

>p
Kitchen
Your brother Sam is sitting across from you.

On the table are a carton of milk, a plate of brownies, and two cups.

>pass the milk
(to Sam)
You pour the milk into Sam's cup. He picks up the cup and takes a big gulp. He grins at you.

    *** You passed the milk. ***

Would you like to RESTART, see some suggestions for AMUSING things to do, or QUIT?

>amusing
Have you tried...
passing the milk?
not passing the milk?
casting xyzzy?
looking at the milk carton more than once?
looking at pictures on the milk carton? Multiple times?
throwing various things at Sam? ****
Throwing yourself and Sam?
counting yourself and Sam?
eating various things?
running with scissors?
finding all ten endings?

Would you like to RESTART, see some suggestions for AMUSING things to do, or QUIT?

* * *

Please pass the milk, please.
Please pass the milk, please.
Please pass the milk, please.

Fingertips: Please Pass the Milk Please
An interactive snack by Adri
Release 3 / Serial number 140312 / Inform 7 build 6G60 (I6/v6.32 lib 6/12N) SD

Kitchen (on the chair)
On the table are a milk carton, a plate of brownies, your glass, and Sam's cup.

Your brother Sam is sitting across from you.

>pass milk
(to Sam)
You pour the milk into Sam's cup. He picks up the cup and takes a big gulp. He grins at you.

    *** You passed the milk. ***

Would you like to RESTART, see some suggestions for AMUSING things to do, view available ENDINGS, or QUIT?

>amusing
Have you tried... 
- looking more closely at the milk carton?
--- looking at it twice?
--- reading it?
--- looking under it?
--- looking at the pictures?
- examining your surroundings?
- interacting with Sam?
- throwing, eating and counting various things?
- running with scissors?
- finding all twelve endings?

Would you like to RESTART, see some suggestions for AMUSING things to do, view available ENDINGS, or QUIT?

* * *

>pass milk
(to Sam)
You pour the milk into Sam's cup. He picks up the cup and takes a big gulp. He grins at you.

    *** You passed the milk. ***

Would you like to RESTART, see some suggestions for AMUSING things to do, view available ENDINGS, or QUIT?

>please pass milk
You must supply a second noun.

>give milk
(to Sam)
You pour the milk into Sam's cup. He picks up the cup and takes a big gulp. He grins at you.

    *** You passed the milk. ***

Would you like to RESTART, see some suggestions for AMUSING things to do, or QUIT?

* * *

>pass milk
(to Sam)
You pour the milk into Sam's cup. He picks up the cup and takes a big gulp. He grins at you.

    *** You passed the milk. ***

Would you like to RESTART, see some suggestions for AMUSING things to do, view available ENDINGS, or QUIT?

>please pass the milk please
You must supply a second noun.

>pass brownie
You must supply a second noun.

* * *

>pass milk
(to Sam)
You pour the milk into Sam's cup. He picks up the cup and takes a big gulp. He grins at you.

    *** You passed the milk. ***

Would you like to RESTART, see some suggestions for AMUSING things to do, view available ENDINGS, or QUIT?

>restart
Please pass the milk, please.
Please pass the milk, please.
Please pass the milk, please.

Fingertips: Please Pass the Milk Please
An interactive snack by Adri
Release 1 / Serial number 120220 / Inform 7 build 6G60 (I6/v6.32 lib 6/12N) SD

Kitchen
Your brother Sam is sitting across from you.

On the table are a carton of milk, a plate of brownies, and two cups.

>pass
What do you want to give?

>please pass
(Sam to Sam)
That's an odd thing to do.

>please pass the milk
(to Sam)
You pour the milk into Sam's cup. He picks up the cup and takes a big gulp. He grins at you.

    *** You passed the milk. ***

Would you like to RESTART, see some suggestions for AMUSING things to do, or QUIT?

>restart
Please pass the milk, please.
Please pass the milk, please.
Please pass the milk, please.

Fingertips: Please Pass the Milk Please
An interactive snack by Adri
Release 1 / Serial number 120219 / Inform 7 build 6G60 (I6/v6.32 lib 6/12N) SD

Kitchen
Your brother Sam is sitting across from you.

On the table are a carton of milk, a plate of brownies, and two cups.

>please pass the milk please
I didn't understand that sentence.

>please pass the milk
(to Sam)
You pour the milk into Sam's cup. He picks up the cup and takes a big gulp. He grins at you.

    *** You passed the milk. ***

Would you like to RESTART, see some suggestions for AMUSING things to do, or QUIT?

* * *

>restart
Please pass the milk, please.
Please pass the milk, please.
Please pass the milk, please.

Fingertips: Please Pass the Milk Please
An interactive snack by Adri
Release 1 / Serial number 120219 / Inform 7 build 6G60 (I6/v6.32 lib 6/12N) SD

Kitchen
Your brother Sam is sitting across from you.

On the table are a carton of milk, a plate of brownies, and two cups.

>please pass the milk
(to Sam)
You pour the milk into Sam's cup. He picks up the cup and takes a big gulp. He grins at you.

    *** You passed the milk. ***

Would you like to RESTART, see some suggestions for AMUSING things to do, or QUIT?

* * *

Please pass the milk, please.
Please pass the milk, please.
Please pass the milk, please.

Fingertips: Please Pass the Milk Please
An interactive snack by Adri
Release 3 / Serial number 140312 / Inform 7 build 6G60 (I6/v6.32 lib 6/12N) SD

Kitchen (on the chair)
On the table are a milk carton, a plate of brownies, your glass, and Sam's cup.

Your brother Sam is sitting across from you.

>give brownie to sam
He doesn't need the brownie.

* * *

Please pass the milk, please.
Please pass the milk, please.
Please pass the milk, please.

Fingertips: Please Pass the Milk Please
An interactive snack by Adri
Release 3 / Serial number 140312 / Inform 7 build 6G60 (I6/v6.32 lib 6/12N) SD

Kitchen (on the chair)
On the table are a milk carton, a plate of brownies, your glass, and Sam's cup.

Your brother Sam is sitting across from you.

>give me to sam
That's an odd thing to do.

>give sam to sam
That's an odd thing to do.

>give milk to sam
(first taking the carton of milk)
You pour the last of the milk into your glass. Sam looks like he's about to cry.

*** You did not pass the milk. ***

Kitchen
Your brother Sam is sitting across from you.

On the table are a carton of milk, a plate of brownies, and two cups.

>give brownie to sam
(first taking the brownie)
You reach across the table to grab a brownie. Whoops. You bump the carton of milk and it spills all over the table.

*** You did not pass the milk. ***

* * *

>give sam to sam
That's an odd thing to do.

>give plate to sam
He doesn't need another brownie. He needs a glass of milk.

>give brownie to sam
He doesn't need another brownie. He needs a glass of milk.

>give brownies to sam
He doesn't need another brownie. He needs a glass of milk.

>give table to sam
He doesn't need the table.

>give glass to sam
He already has a cup. He would probably break it anyway.

>give cup to sam
He already has that.

>give milk to sam
You pour the milk into Sam's cup. He picks up the cup and takes a big gulp. He grins at you.

    *** You passed the milk. ***

Would you like to RESTART, see some suggestions for AMUSING things to do, or QUIT?

>restart
Please pass the milk, please.
Please pass the milk, please.
Please pass the milk, please.

Fingertips: Please Pass the Milk Please
An interactive snack by Adri
Release 1 / Serial number 120219 / Inform 7 build 6G60 (I6/v6.32 lib 6/12N) SD

Kitchen
Your brother Sam is sitting across from you.

On the table are a carton of milk, a plate of brownies, and two cups.

* * *

Please pass the milk, please.
Please pass the milk, please.
Please pass the milk, please.

Fingertips: Please Pass the Milk Please
An interactive snack by Adri
Release 3 / Serial number 140312 / Inform 7 build 6G60 (I6/v6.32 lib 6/12N) SD

Kitchen (on the chair)
On the table are a milk carton, a plate of brownies, your glass, and Sam's cup.

Your brother Sam is sitting across from you.

>say foo
You must supply a second noun.

>say foo to sam
You must supply a second noun.

* * *

Please pass the milk, please.
Please pass the milk, please.
Please pass the milk, please.

Fingertips: Please Pass the Milk Please
An interactive snack by Adri
Release 3 / Serial number 140312 / Inform 7 build 6G60 (I6/v6.32 lib 6/12N) SD

Kitchen (on the chair)
On the table are a milk carton, a plate of brownies, your glass, and Sam's cup.

Your brother Sam is sitting across from you.

>say
Sam just frowns at you impatiently.

>say hello
Sam just frowns at you impatiently.

>talk to sam
Sam just frowns at you impatiently.

>talk to sam about life
Sam just frowns at you impatiently.

>talk about life
Sam just frowns at you impatiently.

>talk about life to sam
Sam just frowns at you impatiently.

>hello, sam
You seem to want to talk to someone, but I can't see whom.

* * *

Please pass the milk, please.
Please pass the milk, please.
Please pass the milk, please.

Fingertips: Please Pass the Milk Please
An interactive snack by Adri
Release 3 / Serial number 140312 / Inform 7 build 6G60 (I6/v6.32 lib 6/12N) SD

Kitchen (on the chair)
On the table are a milk carton, a plate of brownies, your glass, and Sam's cup.

Your brother Sam is sitting across from you.

>hello, sam
You seem to want to talk to someone, but I can't see whom.

* * *

Please pass the milk, please.
Please pass the milk, please.
Please pass the milk, please.

Fingertips: Please Pass the Milk Please
An interactive snack by Adri
Release 3 / Serial number 140312 / Inform 7 build 6G60 (I6/v6.32 lib 6/12N) SD

Kitchen (on the chair)
On the table are a milk carton, a plate of brownies, your glass, and Sam's cup.

Your brother Sam is sitting across from you.

>talk to sam
You say hello to Sam.

>ask sam about foo
NO.

>ask sam
I only understood you as far as wanting to ask.

* * *

>ask sam about foo
NO.

>ask sam about milk
NO.

>tell sam about milk
NO.

>ask sam for milk
NO.

>ask
(about the shirt)
NO.

>tell
(Sam about the shirt)
NO.

* * *

>talk to sam
You say hello to Sam.

>ask sam for life
Sam does not respond.

>ask sam
(for the shirt)
Sam does not respond.

>tell sam about
(the shirt)
bar

>tell sam about life
bar

>ask sam about life
foo

>ask sam for milk
Sam does not respond.

>hint
What's the name of the game?

* * *

>talk to sam
You say hello to Sam.

>ask sam
(for the shirt)
foo

>ask sam about life
Sam just frowns at you impatiently.

>say hello
You are already talking to Sam.

>mention foo
That's not a verb I recognize.

>foo, sam
You seem to want to talk to someone, but I can't see whom.

* * *

>ask sam
(for the shirt)
foo

>ask sam for something
foo

>talk about life
That noun did not make sense in this context.

>talk to sam about life
I only understood you as far as wanting to talk to Sam.

>talk
Sam just frowns at you impatiently.

* * *

>talk to sam
You say hello to Sam.

>talk
Sam just frowns at you impatiently.

>talk to me
Sam just frowns at you impatiently.

>talk to milk
You can't talk to the carton of milk.

>talk about life
That noun did not make sense in this context.

* * *

Please pass the milk, please.
Please pass the milk, please.
Please pass the milk, please.

Fingertips: Please Pass the Milk Please
An interactive snack by Adri
Release 3 / Serial number 140312 / Inform 7 build 6G60 (I6/v6.32 lib 6/12N) SD

Kitchen (on the chair)
On the table are a milk carton, a plate of brownies, your glass, and Sam's cup.

Your brother Sam is sitting across from you.

>talk
Sam just shakes his head and frowns impatiently.

>say
(hello to the shirt)
The shirt does not respond.

>ask
(about the shirt)
(addressing Sam)
Sam does not respond.

* * *

>talk
Sam just shakes his head and frowns impatiently.

>talk to me
You say hello to yourself.

>talk to sam
You say hello to Sam.

* * *

>talk
Sam just shakes his head and frowns impatiently.

>talk to sam
Sam just frowns at you impatiently.

>talk to me
Sam just frowns at you impatiently.

* * *

>talk to milk
You can't talk to the carton of milk.

>ask
(about the shirt)
(addressing Sam)
Sam does not respond.

>ask sam
(for the shirt)
Sam does not respond.

>ask sam about life
Sam just frowns at you impatiently.

>ask sam for milk
Sam does not respond.

* * *

>talk to sam
Sam just frowns at you impatiently.

>hello, sam
You seem to want to talk to someone, but I can't see whom.

>ask sam about life
Sam just frowns at you impatiently.

>ask sam
(for the shirt)
Sam hasn't got the shirt.

* * *

>talk to sam
Sam just frowns at you impatiently.

>talk to shirt
The shirt does not respond.

>talk to table
The table does not respond.

>talk to me
You say hello to yourself.

* * *

>talk to sam
Sam just frowns at you impatiently.

>ask sam
(for the shirt)

>tell sam about life
This provokes no reaction.

>ask sam about life
There is no reply.

>tell sam about table
There is no reply.

* * *

>talk to sam
Sam just frowns at you impatiently.

>talk about life
Sam just frowns at you impatiently.

* * *

>talk
Sam just shakes his head and frowns impatiently.

>take
You reach across the table to grab a brownie. Whoops. You bump the carton of milk and it spills all over the table.

*** You did not pass the milk. ***

Kitchen
Your brother Sam is sitting across from you.

On the table are a carton of milk, a plate of brownies, and two cups.

* * *

>talk
Sam just shakes his head and frowns impatiently.

>point at milk
You point at the carton of milk. Sam gets really excited. He picks up his cup and bangs it on the table.

* * *

Please pass the milk, please.
Please pass the milk, please.
Please pass the milk, please.

Fingertips: Please Pass the Milk Please
An interactive snack by Adri
Release 3 / Serial number 140312 / Inform 7 build 6G60 (I6/v6.32 lib 6/12N) SD

Kitchen (on the chair)
On the table are a milk carton, a plate of brownies, your glass, and Sam's cup.

Your brother Sam is sitting across from you.

>tell
Sam just frowns at you impatiently.

>show
(the shirt)
You point at the shirt. Sam doesn't seem to care.

* * *

Please pass the milk, please.
Please pass the milk, please.
Please pass the milk, please.

Fingertips: Please Pass the Milk Please
An interactive snack by Adri
Release 3 / Serial number 140312 / Inform 7 build 6G60 (I6/v6.32 lib 6/12N) SD

Kitchen (on the chair)
On the table are a milk carton, a plate of brownies, your glass, and Sam's cup.

Your brother Sam is sitting across from you.

>tell sam
(about the shirt)
Sam just frowns at you impatiently.

>tell sam about shirt
Sam just frowns at you impatiently.

>tell about shirt
You can't see any such thing.

>speak
(hello to the shirt)
The shirt does not respond.

>hello, sam
You are already talking to Sam.

That's not a verb I recognize.

>milk, sam
You can't talk to the carton of milk.

>foo
That's not a verb I recognize.

>dance
You do a little dance in your seat. Sam giggles.

>ask sam for milk
Sam just frowns at you impatiently.

* * *

Please pass the milk, please.
Please pass the milk, please.
Please pass the milk, please.

Fingertips: Please Pass the Milk Please
An interactive snack by Adri
Release 3 / Serial number 140312 / Inform 7 build 6G60 (I6/v6.32 lib 6/12N) SD

Kitchen (on the chair)
On the table are a milk carton, a plate of brownies, your glass, and Sam's cup.

Your brother Sam is sitting across from you.

>ask sam for milk
Sam just frowns at you impatiently.

>ask sam about milk
Sam does not respond.

* * *

>ask sam for milk
Sam just frowns at you impatiently.

>ask sam for something
Sam just frowns at you impatiently.

>ask sam for table
Sam just frowns at you impatiently.

* * *

>ask sam for milk
Sam just frowns at you impatiently.

>yes
That was a rhetorical question.

>no
That was a rhetorical question.

>sorry
Oh, don't apologize.

>show apple to sam
You can't see any such thing.

>show milk to sam
(first taking the carton of milk)
You pour the last of the milk into your glass. Sam looks like he's about to cry.

*** You did not pass the milk. ***

Kitchen
Your brother Sam is sitting across from you.

On the table are a carton of milk, a plate of brownies, and two cups.

* * *

Please pass the milk, please.
Please pass the milk, please.
Please pass the milk, please.

Fingertips: Please Pass the Milk Please
An interactive snack by Adri
Release 3 / Serial number 140312 / Inform 7 build 6G60 (I6/v6.32 lib 6/12N) SD

Kitchen (on the chair)
On the table are a milk carton, a plate of brownies, your glass, and Sam's cup.

Your brother Sam is sitting across from you.

>show milk to sam
He doesn't seem interested in that.

Kitchen
Your brother Sam is sitting across from you.

On the table are a carton of milk, a plate of brownies, and two cups.

* * *

Please pass the milk, please.
Please pass the milk, please.
Please pass the milk, please.

Fingertips: Please Pass the Milk Please
An interactive snack by Adri
Release 3 / Serial number 140312 / Inform 7 build 6G60 (I6/v6.32 lib 6/12N) SD

Kitchen (on the chair)
On the table are a milk carton, a plate of brownies, your glass, and Sam's cup.

Your brother Sam is sitting across from you.

>tell sam about life
This provokes no reaction.

>ask about life
There is no reply.

>ask sam about life
There is no reply.

* * *

Please pass the milk, please.
Please pass the milk, please.
Please pass the milk, please.

Fingertips: Please Pass the Milk Please
An interactive snack by Adri
Release 3 / Serial number 140312 / Inform 7 build 6G60 (I6/v6.32 lib 6/12N) SD

Kitchen (on the chair)
On the table are a milk carton, a plate of brownies, your glass, and Sam's cup.

Your brother Sam is sitting across from you.

>ask about life
(addressing Sam)
no.

>ask sam about life
no.

>ask sam about milk
There is no reply.

* * *

Please pass the milk, please.
Please pass the milk, please.
Please pass the milk, please.

Fingertips: Please Pass the Milk Please
An interactive snack by Adri
Release 3 / Serial number 140312 / Inform 7 build 6G60 (I6/v6.32 lib 6/12N) SD

Kitchen (on the chair)
On the table are a milk carton, a plate of brownies, your glass, and Sam's cup.

Your brother Sam is sitting across from you.

>ask sam about life
Sam just frowns at you impatiently.

>tell sam about life
Sam just frowns at you impatiently.

>ask sam about milk
Sam just frowns at you impatiently.

>tell sam about milk
Sam just frowns at you impatiently.

>answer sam about milk
(to Sam)
Sam just frowns at you impatiently.

>answer sam that milk
(to Sam)
Sam just frowns at you impatiently.

>ask sam for milk
Sam just frowns at you impatiently.

* * *

Please pass the milk, please.
Please pass the milk, please.
Please pass the milk, please.

Fingertips: Please Pass the Milk Please
An interactive snack by Adri
Release 3 / Serial number 140312 / Inform 7 build 6G60 (I6/v6.32 lib 6/12N) SD

Kitchen (on the chair)
On the table are a milk carton, a plate of brownies, your glass, and Sam's cup.

Your brother Sam is sitting across from you.

>hello
(addressing Sam)
You say hello to Sam.

>hello
You are already talking to Sam.

>hello
You are already talking to Sam.

* * *

Please pass the milk, please.
Please pass the milk, please.
Please pass the milk, please.

Fingertips: Please Pass the Milk Please
An interactive snack by Adri
Release 3 / Serial number 140312 / Inform 7 build 6G60 (I6/v6.32 lib 6/12N) SD

Kitchen (on the chair)
On the table are a milk carton, a plate of brownies, your glass, and Sam's cup.

Your brother Sam is sitting across from you.

>say hello
Sam just frowns at you impatiently.

>say hello to sam
Sam just frowns at you impatiently.

* * *

Please pass the milk, please.
Please pass the milk, please.
Please pass the milk, please.

Fingertips: Please Pass the Milk Please
An interactive snack by Adri
Release 3 / Serial number 140312 / Inform 7 build 6G60 (I6/v6.32 lib 6/12N) SD

Kitchen (on the chair)
On the table are a milk carton, a plate of brownies, your glass, and Sam's cup.

Your brother Sam is sitting across from you.

>put milk on plate
(first taking the carton of milk)

You pour the last of the milk into your glass. Sam looks like he's about to cry.

*** You did not pass the milk. ***You need to be holding the carton of milk before you can put it on top of something else.

* * *

Please pass the milk, please.
Please pass the milk, please.
Please pass the milk, please.

Fingertips: Please Pass the Milk Please
An interactive snack by Adri
Release 3 / Serial number 140312 / Inform 7 build 6G60 (I6/v6.32 lib 6/12N) SD

Kitchen (on the chair)
On the table are a milk carton, a plate of brownies, your glass, and Sam's cup.

Your brother Sam is sitting across from you.

>point at brownie
You must supply a second noun.

>point at brownies
You must supply a second noun.

>point
(at the shirt)
You must supply a second noun.

* * *

Please pass the milk, please.
Please pass the milk, please.
Please pass the milk, please.

Fingertips: Please Pass the Milk Please
An interactive snack by Adri
Release 3 / Serial number 140312 / Inform 7 build 6G60 (I6/v6.32 lib 6/12N) SD

Kitchen (on the chair)
On the table are a milk carton, a plate of brownies, your glass, and Sam's cup.

Your brother Sam is sitting across from you.

>point at brownies
You must supply a second noun.

>show brownie to sam
You point at brownie. Sam points at the milk.

(first taking the brownie)
You reach across the table to grab a brownie. Whoops. You bump the carton of milk and it spills all over the table.

*** You did not pass the milk. ***

* * *

Please pass the milk, please.
Please pass the milk, please.
Please pass the milk, please.

Fingertips: Please Pass the Milk Please
An interactive snack by Adri
Release 3 / Serial number 140312 / Inform 7 build 6G60 (I6/v6.32 lib 6/12N) SD

Kitchen (on the chair)
On the table are a milk carton, a plate of brownies, your glass, and Sam's cup.

Your brother Sam is sitting across from you.

>show brownie to sam
You point at brownie. Sam points at the milk.

>show milk to sam
You point at carton of milk. Sam gets really excited. He picks up his cup and bangs it on the table.

>point at milk
You must supply a second noun.

* * *

Please pass the milk, please.
Please pass the milk, please.
Please pass the milk, please.

Fingertips: Please Pass the Milk Please
An interactive snack by Adri
Release 3 / Serial number 140312 / Inform 7 build 6G60 (I6/v6.32 lib 6/12N) SD

Kitchen (on the chair)
On the table are a milk carton, a plate of brownies, your glass, and Sam's cup.

Your brother Sam is sitting across from you.

>point at milk
You point at carton of milk. Sam gets really excited. He picks up his cup and bangs it on the table.

* * *

Please pass the milk, please.
Please pass the milk, please.
Please pass the milk, please.

Fingertips: Please Pass the Milk Please
An interactive snack by Adri
Release 3 / Serial number 140312 / Inform 7 build 6G60 (I6/v6.32 lib 6/12N) SD

Kitchen (on the chair)
On the table are a milk carton, a plate of brownies, your glass, and Sam's cup.

Your brother Sam is sitting across from you.

>point at tabe
You can't see any such thing.

>point at table
Sam doesn't seem interested in that.

>show table to sam
Sam doesn't seem interested in that.

>show sam to sam
Sam doesn't seem interested in that.

* * *

Please pass the milk, please.
Please pass the milk, please.
Please pass the milk, please.

Fingertips: Please Pass the Milk Please
An interactive snack by Adri
Release 3 / Serial number 140312 / Inform 7 build 6G60 (I6/v6.32 lib 6/12N) SD

Kitchen (on the chair)
On the table are a milk carton, a plate of brownies, your glass, and Sam's cup.

Your brother Sam is sitting across from you.

>point at sam
You point at Sam. He seems confused.

>point at me
You point at yourself. Sam doesn't seem to care.

>take
You reach across the table to grab a brownie. Whoops. You bump the carton of milk and it spills all over the table.

*** You did not pass the milk. ***

* * *

Kitchen
Your brother Sam is sitting across from you.

On the table are a carton of milk, a plate of brownies, and two cups.

>show milk
(to Sam)
You point at the carton of milk. Sam gets really excited. He picks up his cup and bangs it on the table.

* * *

Please pass the milk, please.
Please pass the milk, please.
Please pass the milk, please.

Fingertips: Please Pass the Milk Please
An interactive snack by Adri
Release 3 / Serial number 140312 / Inform 7 build 6G60 (I6/v6.32 lib 6/12N) SD

Kitchen (on the chair)
On the table are a milk carton, a plate of brownies, your glass, and Sam's cup.

Your brother Sam is sitting across from you.

>show milk
You point at the carton of milk. Sam gets really excited. He picks up his cup and bangs it on the table.

>drop brownie
You haven't got that.

>drop brownies
You haven't got those.

>spill brownie
You haven't got that.

>spill milk
You knock over the milk. Sam bursts into tears.

*** You did not pass the milk. ***

Kitchen
Your brother Sam is sitting across from you.

On the table are a carton of milk, a plate of brownies, and two cups.

>drop milk
You knock over the milk. Sam bursts into tears.

*** You did not pass the milk. ***

Kitchen
Your brother Sam is sitting across from you.

On the table are a carton of milk, a plate of brownies, and two cups.

>pour milk
You pour the last of the milk into your glass. Sam looks like he's about to cry.

*** You did not pass the milk. ***

Kitchen
Your brother Sam is sitting across from you.

On the table are a carton of milk, a plate of brownies, and two cups.

>pour milk on brownies
You pick up the carton of milk and dump it all over the brownies. Sam shrieks angrily.

*** You did not pass the milk. ***

Kitchen
Your brother Sam is sitting across from you.

On the table are a carton of milk, a plate of brownies, and two cups.

>pour milk on sam
You pick up the carton of milk and dump it all over Sam. Sam shrieks angrily.

*** You did not pass the milk. ***

Kitchen
Your brother Sam is sitting across from you.

On the table are a carton of milk, a plate of brownies, and two cups.

>pour brownies
You can't pour the brownies.

>say foo
Sam just frowns at you impatiently.

* * *

Please pass the milk, please.
Please pass the milk, please.
Please pass the milk, please.

Fingertips: Please Pass the Milk Please
An interactive snack by Adri
Release 3 / Serial number 140312 / Inform 7 build 6G60 (I6/v6.32 lib 6/12N) SD

Kitchen (on the chair)
On the table are a milk carton, a plate of brownies, your glass, and Sam's cup.

Your brother Sam is sitting across from you.

>say bar
Sam just frowns at you impatiently.

>say "bar"
Sam just frowns at you impatiently.

>say xyzzy
A hollow voice says, "Milk: it does a body good."

>tell sam about life
Sam just frowns at you impatiently.

>tell sam about milk
Sam just frowns at you impatiently.

>clean
(the shirt)
You can't clean the shirt.

>clean sam
You can't clean Sam.

* * *

Please pass the milk, please.
Please pass the milk, please.
Please pass the milk, please.

Fingertips: Please Pass the Milk Please
An interactive snack by Adri
Release 3 / Serial number 140312 / Inform 7 build 6G60 (I6/v6.32 lib 6/12N) SD

Kitchen (on the chair)
On the table are a milk carton, a plate of brownies, your glass, and Sam's cup.

Your brother Sam is sitting across from you.

>x sam
There are traces of chocolate on his cheeks. He seems to be waiting for something.

>clean sam
You try to clean Sam's face, but he pushes you away.

>run
You're not allowed to run in the house!

>run in house
I only understood you as far as wanting to run.

* * *

Please pass the milk, please.
Please pass the milk, please.
Please pass the milk, please.

Fingertips: Please Pass the Milk Please
An interactive snack by Adri
Release 3 / Serial number 140312 / Inform 7 build 6G60 (I6/v6.32 lib 6/12N) SD

Kitchen (on the chair)
On the table are a milk carton, a plate of brownies, your glass, and Sam's cup.

Your brother Sam is sitting across from you.

>give cup to sam
He already has that.

* * *

Please pass the milk, please.
Please pass the milk, please.
Please pass the milk, please.

Fingertips: Please Pass the Milk Please
An interactive snack by Adri
Release 3 / Serial number 140312 / Inform 7 build 6G60 (I6/v6.32 lib 6/12N) SD

Kitchen (on the chair)
On the table are a milk carton, a plate of brownies, your glass, and Sam's cup.

Your brother Sam is sitting across from you.

>undress
You should probably keep your clothes on.

>take off
(the shirt)
You should probably keep your clothes on.

>remove
(the shirt)
You should probably keep your clothes on.

* * *

>undress
You should probably keep your clothes on.

>remove shirt
You should probably keep your clothes on.

>take off shirt
You should probably keep your shirt on.

* * *

>remove shirt
You should probably keep your clothes on.

>remove
(the shirt)
You should probably keep your clothes on.

>remove table
You're not wearing that.

* * *

>undress
You should probably keep your clothes on.

>remove
(the shirt)
You should probably keep your shirt on.

* * *

Please pass the milk, please.
Please pass the milk, please.
Please pass the milk, please.

Fingertips: Please Pass the Milk Please
An interactive snack by Adri
Release 3 / Serial number 140312 / Inform 7 build 6G60 (I6/v6.32 lib 6/12N) SD

Kitchen (on the chair)
On the table are a milk carton, a plate of brownies, your glass, and Sam's cup.

Your brother Sam is sitting across from you.

>undress
(first taking the brownie)
You reach across the table to grab a brownie. Whoops. You bump the carton of milk and it spills all over the table.

*** You did not pass the milk. ***

Kitchen
Your brother Sam is sitting across from you.

On the table are a carton of milk, a plate of brownies, and two cups.

>take off brownie
(first taking the brownie)
You reach across the table to grab a brownie. Whoops. You bump the carton of milk and it spills all over the table.

*** You did not pass the milk. ***

Kitchen
Your brother Sam is sitting across from you.

On the table are a carton of milk, a plate of brownies, and two cups.

>remove
(the shirt)
You should probably keep your shirt on.

* * *

Please pass the milk, please.
Please pass the milk, please.
Please pass the milk, please.

Fingertips: Please Pass the Milk Please
An interactive snack by Adri
Release 3 / Serial number 140312 / Inform 7 build 6G60 (I6/v6.32 lib 6/12N) SD

Kitchen (on the chair)
On the table are a milk carton, a plate of brownies, your glass, and Sam's cup.

Your brother Sam is sitting across from you.

>take sam
You try to pick up Sam. He squirms away.

>get sam
You try to pick up Sam. He squirms away.

>touch sam
You try to hug Sam, but he pulls away.

>poke sam
That's not a verb I recognize.

* * *

Please pass the milk, please.
Please pass the milk, please.
Please pass the milk, please.

Fingertips: Please Pass the Milk Please
An interactive snack by Adri
Release 3 / Serial number 140312 / Inform 7 build 6G60 (I6/v6.32 lib 6/12N) SD

Kitchen (on the chair)
On the table are a milk carton, a plate of brownies, your glass, and Sam's cup.

Your brother Sam is sitting across from you.

>poke sam
You give Sam a sharp poke. He screeches at you and slaps your hand away.

* * *

Please pass the milk, please.
Please pass the milk, please.
Please pass the milk, please.

Fingertips: Please Pass the Milk Please
An interactive snack by Adri
Release 3 / Serial number 140312 / Inform 7 build 6G60 (I6/v6.32 lib 6/12N) SD

Kitchen (on the chair)
On the table are a milk carton, a plate of brownies, your glass, and Sam's cup.

Your brother Sam is sitting across from you.

>x table
The blue and white checkered table cloth brightens up the room.

>x tablecloth
The blue and white checkered table cloth brightens up the room.

>wear sam
(first taking Sam)
You try to pick up Sam. He squirms away.

>wear tablecloth
(first taking the tablecloth)
That's hardly portable.

>wear shirt
You're already wearing that!

* * *

Please pass the milk, please.
Please pass the milk, please.
Please pass the milk, please.

Fingertips: Please Pass the Milk Please
An interactive snack by Adri
Release 3 / Serial number 140312 / Inform 7 build 6G60 (I6/v6.32 lib 6/12N) SD

Kitchen (on the chair)
On the table are a milk carton, a plate of brownies, your glass, and Sam's cup.

Your brother Sam is sitting across from you.

>wear tablecloth
You pull the tablecloth off the table, spilling milk and brownies all over Sam. He's too shocked to say anything for a moment, and then he starts bawling.

*** You did not pass the milk. ***

Kitchen
Your brother Sam is sitting across from you.

On the table are a carton of milk, a plate of brownies, and two cups.

>wear shirt
You're already wearing that!
You can't wear that.

* * *

Please pass the milk, please.
Please pass the milk, please.
Please pass the milk, please.

Fingertips: Please Pass the Milk Please
An interactive snack by Adri
Release 3 / Serial number 140312 / Inform 7 build 6G60 (I6/v6.32 lib 6/12N) SD

Kitchen (on the chair)
On the table are a milk carton, a plate of brownies, your glass, and Sam's cup.

Your brother Sam is sitting across from you.

>wear sam
You can't wear that.

>wear shirt
You're already wearing that!

* * *

Please pass the milk, please.
Please pass the milk, please.
Please pass the milk, please.

Fingertips: Please Pass the Milk Please
An interactive snack by Adri
Release 3 / Serial number 140312 / Inform 7 build 6G60 (I6/v6.32 lib 6/12N) SD

Kitchen (on the chair)
On the table are a milk carton, a plate of brownies, your glass, and Sam's cup.

Your brother Sam is sitting across from you.

>wear table
You can't wear that.

>remove tablecloth
(first taking the tablecloth)
You pull the tablecloth off the table, spilling milk and brownies all over Sam. He's too shocked to say anything for a moment, and then he starts bawling.

*** You did not pass the milk. ***

Kitchen
Your brother Sam is sitting across from you.

On the table are a carton of milk, a plate of brownies, and two cups.

>remove milk
(first taking the carton of milk)
You pour the last of the milk into your glass. Sam looks like he's about to cry.

*** You did not pass the milk. ***

Kitchen
Your brother Sam is sitting across from you.

On the table are a carton of milk, a plate of brownies, and two cups.

* * *

>wear table
You can't wear that.

>wear me
You can't wear that.

>wear shirt
You're already wearing that!

>remove shirt
You should probably keep your shirt on.

>take off milk
(first taking the carton of milk)
You pour the last of the milk into your glass. Sam looks like he's about to cry.

*** You did not pass the milk. ***

Kitchen
Your brother Sam is sitting across from you.

On the table are a carton of milk, a plate of brownies, and two cups.

* * *

Please pass the milk, please.
Please pass the milk, please.
Please pass the milk, please.

Fingertips: Please Pass the Milk Please
An interactive snack by Adri
Release 3 / Serial number 140312 / Inform 7 build 6G60 (I6/v6.32 lib 6/12N) SD

Kitchen (on the chair)
On the table are a milk carton, a plate of brownies, your glass, and Sam's cup.

Your brother Sam is sitting across from you.

>drop shirt
You should probably keep your shirt on.

>drop me
You lack the dexterity.

>drop sam
Sam is already here.

>drop table
The table is already here.

>drop milk
You knock over the milk. Sam bursts into tears.

*** You did not pass the milk. ***

* * *

Kitchen
Your brother Sam is sitting across from you.

On the table are a carton of milk, a plate of brownies, and two cups.

>take tablecloth
You pull the tablecloth off the table, spilling milk and brownies all over Sam. He's too shocked to say anything for a moment, and then he starts bawling.

*** You did not pass the milk. ***

Kitchen
Your brother Sam is sitting across from you.

On the table are a carton of milk, a plate of brownies, and two cups.

>take table
That's hardly portable.

>throw tablecloth
You pick up the tablecloth and throw it at Sam. He catches it and tosses it back at you. It bounces off your shoulder.

* * *

Please pass the milk, please.
Please pass the milk, please.
Please pass the milk, please.

Fingertips: Please Pass the Milk Please
An interactive snack by Adri
Release 3 / Serial number 140312 / Inform 7 build 6G60 (I6/v6.32 lib 6/12N) SD

Kitchen (on the chair)
On the table are a milk carton, a plate of brownies, your glass, and Sam's cup.

Your brother Sam is sitting across from you.

>throw tablecloth
You pull the tablecloth off the table, spilling milk and brownies all over Sam. He's too shocked to say anything for a moment, and then he starts bawling.

*** You did not pass the milk. ***

Kitchen
Your brother Sam is sitting across from you.

On the table are a carton of milk, a plate of brownies, and two cups.

>eat tablecloth
You pick up the tablecloth and gnaw on it. Sam giggles.

* * *

Please pass the milk, please.
Please pass the milk, please.
Please pass the milk, please.

Fingertips: Please Pass the Milk Please
An interactive snack by Adri
Release 3 / Serial number 140312 / Inform 7 build 6G60 (I6/v6.32 lib 6/12N) SD

Kitchen (on the chair)
On the table are a milk carton, a plate of brownies, your glass, and Sam's cup.

Your brother Sam is sitting across from you.

>eat table
You gnaw on the edge of the table. You must really be hungry.

>eat tablecloth
You pick up the end of the tablecloth and gnaw on it. Sam giggles.

>eat milk
You pick up the carton of milk and gnaw on it. Sam giggles.

>eat brownie
You reach across the table to grab a brownie. Whoops. You bump the carton of milk and it spills all over the table.

*** You did not pass the milk. ***

Kitchen
Your brother Sam is sitting across from you.

On the table are a carton of milk, a plate of brownies, and two cups.

>eat n
You must name something more substantial.

>eat c
You can't see any such thing.

>l
Kitchen
Your brother Sam is sitting across from you.

On the table are a carton of milk, a plate of brownies, and two cups.

* * *

Please pass the milk, please.
Please pass the milk, please.
Please pass the milk, please.

Fingertips: Please Pass the Milk Please
An interactive snack by Adri
Release 3 / Serial number 140312 / Inform 7 build 6G60 (I6/v6.32 lib 6/12N) SD

Kitchen (on the chair)
On the table are a milk carton, a plate of brownies, your glass, and Sam's cup.

Your brother Sam is sitting across from you.

>eat tablecloth
You pick up the end of the tablecloth and gnaw on it. Sam giggles.

>shout
Sam cringes.

>curse
Sam's eyes go wide.

>scream
Sam cringes.

>cry
Sam blinks at you in surprise.

* * *

Please pass the milk, please.
Please pass the milk, please.
Please pass the milk, please.

Fingertips: Please Pass the Milk Please
An interactive snack by Adri
Release 3 / Serial number 140312 / Inform 7 build 6G60 (I6/v6.32 lib 6/12N) SD

Kitchen (on the chair)
On the table are a milk carton, a plate of brownies, your glass, and Sam's cup.

Your brother Sam is sitting across from you.

>drop tablecloth
You haven't got that.

>drop milk
You knock over the milk. Sam bursts into tears.

*** You did not pass the milk. ***

* * *

Kitchen
Your brother Sam is sitting across from you.

On the table are a carton of milk, a plate of brownies, and two cups.

>drop chair
The chair is already here.

>drop milk
You knock over the milk. Sam bursts into tears.

*** You did not pass the milk. ***

* * *

Kitchen
Your brother Sam is sitting across from you.

On the table are a carton of milk, a plate of brownies, and two cups.

>drop brownie
You haven't got that.

* * *

Please pass the milk, please.
Please pass the milk, please.
Please pass the milk, please.

Fingertips: Please Pass the Milk Please
An interactive snack by Adri
Release 3 / Serial number 140312 / Inform 7 build 6G60 (I6/v6.32 lib 6/12N) SD

Kitchen (on the chair)
On the table are a milk carton, a plate of brownies, your glass, and Sam's cup.

Your brother Sam is sitting across from you.

>drop milk
You knock over the milk. Sam bursts into tears.

*** You did not pass the milk. ***

* * *

Kitchen
Your brother Sam is sitting across from you.

On the table are a carton of milk, a plate of brownies, and two cups.

>drop sam
Sam is already here.

>put milk on plate
You pick up the carton of milk and dump it all over the plate of brownies. Sam shrieks angrily.

*** You did not pass the milk. ***

Kitchen
Your brother Sam is sitting across from you.

On the table are a carton of milk, a plate of brownies, and two cups.

* * *

Please pass the milk, please.
Please pass the milk, please.
Please pass the milk, please.

Fingertips: Please Pass the Milk Please
An interactive snack by Adri
Release 3 / Serial number 140312 / Inform 7 build 6G60 (I6/v6.32 lib 6/12N) SD

Kitchen (on the chair)
On the table are a milk carton, a plate of brownies, your glass, and Sam's cup.

Your brother Sam is sitting across from you.

>wear shirt
You're already wearing that!

* * *

>remove shirt
You should probably keep your shirt on.

>wear tablecloth
You pull the tablecloth off the table, spilling milk and brownies all over Sam. He's too shocked to say anything for a moment, and then he starts bawling.

*** You did not pass the milk. ***

* * *

Please pass the milk, please.
Please pass the milk, please.
Please pass the milk, please.

Fingertips: Please Pass the Milk Please
An interactive snack by Adri
Release 3 / Serial number 140312 / Inform 7 build 6G60 (I6/v6.32 lib 6/12N) SD

Kitchen (on the chair)
On the table are a milk carton, a plate of brownies, your glass, and Sam's cup.

Your brother Sam is sitting across from you.

>cry
Sam blinks at you in surprise.

* * *

Please pass the milk, please.
Please pass the milk, please.
Please pass the milk, please.

Fingertips: Please Pass the Milk Please
An interactive snack by Adri
Release 3 / Serial number 140312 / Inform 7 build 6G60 (I6/v6.32 lib 6/12N) SD

Kitchen (on the chair)
On the table are a milk carton, a plate of brownies, your glass, and Sam's cup.

Your brother Sam is sitting across from you.

I beg your pardon?

* * *

Please pass the milk, please.
Please pass the milk, please.
Please pass the milk, please.

Fingertips: Please Pass the Milk Please
An interactive snack by Adri
Release 3 / Serial number 140312 / Inform 7 build 6G60 (I6/v6.32 lib 6/12N) SD

Kitchen (on the chair)
On the table are a milk carton, a plate of brownies, your glass, and Sam's cup.

Your brother Sam is sitting across from you.

>remove
(the shirt)
You should probably keep your clothes on.

>take off
(the shirt)
You should probably keep your clothes on.

* * *

>remove
(the shirt)
You should probably keep your clothes on.

>give
What do you want to give?

>give milk
(to Sam)
You pour the milk into Sam's cup. He picks up the cup and takes a big gulp. He grins at you.

    *** You passed the milk. ***

Would you like to RESTART, see some suggestions for AMUSING things to do, or QUIT?

>pass
Please give one of the answers above.

Would you like to RESTART, see some suggestions for AMUSING things to do, or QUIT?

>restart
Please pass the milk, please.
Please pass the milk, please.
Please pass the milk, please.

Fingertips: Please Pass the Milk Please
An interactive snack by Adri
Release 1 / Serial number 120219 / Inform 7 build 6G60 (I6/v6.32 lib 6/12N) SD

Kitchen
Your brother Sam is sitting across from you.

On the table are a carton of milk, a plate of brownies, and two cups.

>pass
You must supply a second noun.

* * *

>give
What do you want to give?

>drink
(the carton of milk)
You pour the last of the milk into your glass. Sam looks like he's about to cry.

*** You did not pass the milk. ***

Kitchen
Your brother Sam is sitting across from you.

On the table are a carton of milk, a plate of brownies, and two cups.

>eat
(the brownie)
You don't have a brownie yet.

>show
(Sam)
You point at Sam. He seems confused.

>drop
(the shirt)
You should probably keep your clothes on.

>pass
(Sam please)
You must supply a second noun.

>give
What do you want to give?

* * *

Please pass the milk, please.
Please pass the milk, please.
Please pass the milk, please.

Fingertips: Please Pass the Milk Please
An interactive snack by Adri
Release 3 / Serial number 140312 / Inform 7 build 6G60 (I6/v6.32 lib 6/12N) SD

Kitchen (on the chair)
On the table are a milk carton, a plate of brownies, your glass, and Sam's cup.

Your brother Sam is sitting across from you.

>take
(the brownie)
You reach across the table to grab a brownie. Whoops. You bump the carton of milk and it spills all over the table.

*** You did not pass the milk. ***

Kitchen
Your brother Sam is sitting across from you.

On the table are a carton of milk, a plate of brownies, and two cups.

* * *

Please pass the milk, please.
Please pass the milk, please.
Please pass the milk, please.

Fingertips: Please Pass the Milk Please
An interactive snack by Adri
Release 3 / Serial number 140312 / Inform 7 build 6G60 (I6/v6.32 lib 6/12N) SD

Kitchen (on the chair)
On the table are a milk carton, a plate of brownies, your glass, and Sam's cup.

Your brother Sam is sitting across from you.

>pass
What do you want to give?

>hand
(the shirt to Sam)
You should probably keep your clothes on.

>pass the milk
(to Sam)
You pour the milk into Sam's cup. He picks up the cup and takes a big gulp. He grins at you.

    *** You passed the milk. ***

Would you like to RESTART, see some suggestions for AMUSING things to do, or QUIT?

>restart
Please pass the milk, please.
Please pass the milk, please.
Please pass the milk, please.

Fingertips: Please Pass the Milk Please
An interactive snack by Adri
Release 1 / Serial number 120219 / Inform 7 build 6G60 (I6/v6.32 lib 6/12N) SD

Kitchen
Your brother Sam is sitting across from you.

On the table are a carton of milk, a plate of brownies, and two cups.

* * *

>pass
What do you want to give?

>give
What do you want to give?

>hand
What do you want to give?

* * *

>pass
What do you want to give?

>stand on
(Sam)
You try to stand on Sam. He pushes you away.

>sit on
I only understood you as far as wanting to sit.

>count
(Sam)
There's only one of him, thankfully.

* * *

>pass
What do you want to give?

>pass milk
You must supply a second noun.

>give milk
(to Sam)
You pour the milk into Sam's cup. He picks up the cup and takes a big gulp. He grins at you.

    *** You passed the milk. ***

Would you like to RESTART, see some suggestions for AMUSING things to do, or QUIT?

* * *

Please pass the milk, please.
Please pass the milk, please.
Please pass the milk, please.

Fingertips: Please Pass the Milk Please
An interactive snack by Adri
Release 3 / Serial number 140312 / Inform 7 build 6G60 (I6/v6.32 lib 6/12N) SD

Kitchen (on the chair)
On the table are a milk carton, a plate of brownies, your glass, and Sam's cup.

Your brother Sam is sitting across from you.

>give
(the brownie to Sam)
He doesn't need another brownie. He needs a glass of milk.

>give brownie
(to Sam)
He doesn't need another brownie. He needs a glass of milk.

* * *

>give
(the brownie to Sam)
He doesn't need another brownie. He needs a glass of milk.

>give shirt
(to Sam)
You should probably keep your clothes on.

* * *

>give
(the brownie to Sam)
He doesn't need another brownie. He needs a glass of milk.

>pass the milk
(to Sam)
You pour the milk into Sam's cup. He picks up the cup and takes a big gulp. He grins at you.

    *** You passed the milk. ***

Would you like to RESTART, see some suggestions for AMUSING things to do, or QUIT?

* * *

>restart
Please pass the milk, please.
Please pass the milk, please.
Please pass the milk, please.

Fingertips: Please Pass the Milk Please
An interactive snack by Adri
Release 1 / Serial number 120219 / Inform 7 build 6G60 (I6/v6.32 lib 6/12N) SD

Kitchen
Your brother Sam is sitting across from you.

On the table are a carton of milk, a plate of brownies, and two cups.

>give brownie
(to Sam)
He doesn't need another brownie. He needs a glass of milk.

>give table
(to Sam)
He doesn't need the table.

>give
You can only do that to something animate.

* * *

>give
(the brownie to Sam)
He doesn't need another brownie. He needs a glass of milk.

>give table
(to Sam)
He doesn't need the table.

* * *

>give
(the brownie to Sam)
He doesn't need another brownie. He needs a glass of milk.

>pass
(the brownie please)
He doesn't need another brownie. He needs a glass of milk.

>talk
Sam just frowns at you impatiently.

* * *

Please pass the milk, please.
Please pass the milk, please.
Please pass the milk, please.

Fingertips: Please Pass the Milk Please
An interactive snack by Adri
Release 3 / Serial number 140312 / Inform 7 build 6G60 (I6/v6.32 lib 6/12N) SD

Kitchen (on the chair)
On the table are a milk carton, a plate of brownies, your glass, and Sam's cup.

Your brother Sam is sitting across from you.

>hug
(Sam)
You try to hug Sam, but he pulls away.

* * *

Please pass the milk, please.
Please pass the milk, please.
Please pass the milk, please.

Fingertips: Please Pass the Milk Please
An interactive snack by Adri
Release 3 / Serial number 140312 / Inform 7 build 6G60 (I6/v6.32 lib 6/12N) SD

Kitchen (on the chair)
On the table are a milk carton, a plate of brownies, your glass, and Sam's cup.

Your brother Sam is sitting across from you.

>drink
(the carton of milk)
You pour the last of the milk into your glass. Sam looks like he's about to cry.

*** You did not pass the milk. ***

* * *

Kitchen
Your brother Sam is sitting across from you.

On the table are a carton of milk, a plate of brownies, and two cups.

>eat
You reach across the table to grab a brownie. Whoops. You bump the carton of milk and it spills all over the table.

*** You did not pass the milk. ***

Kitchen
Your brother Sam is sitting across from you.

On the table are a carton of milk, a plate of brownies, and two cups.

>give
(the shirt to Sam)
You should probably keep your clothes on.

* * *

Please pass the milk, please.
Please pass the milk, please.
Please pass the milk, please.

Fingertips: Please Pass the Milk Please
An interactive snack by Adri
Release 3 / Serial number 140312 / Inform 7 build 6G60 (I6/v6.32 lib 6/12N) SD

Kitchen (on the chair)
On the table are a milk carton, a plate of brownies, your glass, and Sam's cup.

Your brother Sam is sitting across from you.

>drink milk
You pour the last of the milk into your glass. Sam looks like he's about to cry.

*** You did not pass the milk. ***

>r
Kitchen
Your brother Sam is sitting across from you.

On the table are a carton of milk, a plate of brownies, and two cups.

>pour
(the carton of milk)
You pour the last of the milk into your glass. Sam looks like he's about to cry.

*** You did not pass the milk. ***

Kitchen
Your brother Sam is sitting across from you.

On the table are a carton of milk, a plate of brownies, and two cups.

>drink
(the carton of milk)
You pour the last of the milk into your glass. Sam looks like he's about to cry.

*** You did not pass the milk. ***

* * *

Kitchen
Your brother Sam is sitting across from you.

On the table are a carton of milk, a plate of brownies, and two cups.

>take
(the brownie)
You reach across the table to grab a brownie. Whoops. You bump the carton of milk and it spills all over the table.

*** You did not pass the milk. ***

* * *

Please pass the milk, please.
Please pass the milk, please.
Please pass the milk, please.

Fingertips: Please Pass the Milk Please
An interactive snack by Adri
Release 3 / Serial number 140312 / Inform 7 build 6G60 (I6/v6.32 lib 6/12N) SD

Kitchen (on the chair)
On the table are a milk carton, a plate of brownies, your glass, and Sam's cup.

Your brother Sam is sitting across from you.

>eat
(the brownie)
You don't have a brownie yet.

>r
Kitchen
Your brother Sam is sitting across from you.

On the table are a carton of milk, a plate of brownies, and two cups.

>give
(the shirt to Sam)
You should probably keep your clothes on.

* * *

>eat
(the brownie)
You don't have a brownie yet.

>hug
(Sam)
You try to hug Sam, but he pulls away.

>kiss
(Sam)
You smooch Sam on the cheek. He glares at you and wipes at his cheek.

>attack
(Sam)
You pick up the brownie and throw it at Sam. He catches it and tosses it back at you. It bounces off your shoulder.

>punch
(Sam)
You pick up the brownie and throw it at Sam. He catches it and tosses it back at you. It bounces off your shoulder.

>throw
You pick up the brownie and throw it at Sam. He catches it and tosses it back at you. It bounces off your shoulder.

* * *

Please pass the milk, please.
Please pass the milk, please.
Please pass the milk, please.

Fingertips: Please Pass the Milk Please
An interactive snack by Adri
Release 3 / Serial number 140312 / Inform 7 build 6G60 (I6/v6.32 lib 6/12N) SD

Kitchen (on the chair)
On the table are a milk carton, a plate of brownies, your glass, and Sam's cup.

Your brother Sam is sitting across from you.

>give cup
(to Sam)
He already has that.

>take
(the brownie)
You reach across the table to grab a brownie. Whoops. You bump the carton of milk and it spills all over the table.

*** You did not pass the milk. ***

* * *

Kitchen
Your brother Sam is sitting across from you.

On the table are a carton of milk, a plate of brownies, and two cups.

>walk
You stand up and walk away. Sam throws his cup at you.

*** You did not pass the milk. ***

* * *

Please pass the milk, please.
Please pass the milk, please.
Please pass the milk, please.

Fingertips: Please Pass the Milk Please
An interactive snack by Adri
Release 3 / Serial number 140312 / Inform 7 build 6G60 (I6/v6.32 lib 6/12N) SD

Kitchen (on the chair)
On the table are a milk carton, a plate of brownies, your glass, and Sam's cup.

Your brother Sam is sitting across from you.

>gnaw
(the brownie)
You reach across the table to grab a brownie. Whoops. You bump the carton of milk and it spills all over the table.

*** You did not pass the milk. ***

Kitchen
Your brother Sam is sitting across from you.

On the table are a carton of milk, a plate of brownies, and two cups.

>eat brownie
You reach across the table to grab a brownie. Whoops. You bump the carton of milk and it spills all over the table.

*** You did not pass the milk. ***

* * *

Please pass the milk, please.
Please pass the milk, please.
Please pass the milk, please.

Fingertips: Please Pass the Milk Please
An interactive snack by Adri
Release 3 / Serial number 140312 / Inform 7 build 6G60 (I6/v6.32 lib 6/12N) SD

Kitchen (on the chair)
On the table are a milk carton, a plate of brownies, your glass, and Sam's cup.

Your brother Sam is sitting across from you.

>eat brownie
You don't have a brownie yet.

>give brownie
(to Sam)
He doesn't need another brownie. He needs a glass of milk.

* * *

Please pass the milk, please.
Please pass the milk, please.
Please pass the milk, please.

Fingertips: Please Pass the Milk Please
An interactive snack by Adri
Release 3 / Serial number 140312 / Inform 7 build 6G60 (I6/v6.32 lib 6/12N) SD

Kitchen (on the chair)
On the table are a milk carton, a plate of brownies, your glass, and Sam's cup.

Your brother Sam is sitting across from you.

>point
(at the shirt)
You point at the shirt. Sam doesn't seem to care.

>show
(the shirt)
You point at the shirt. Sam doesn't seem to care.

* * *

Please pass the milk, please.
Please pass the milk, please.
Please pass the milk, please.

Fingertips: Please Pass the Milk Please
An interactive snack by Adri
Release 3 / Serial number 140312 / Inform 7 build 6G60 (I6/v6.32 lib 6/12N) SD

Kitchen (on the chair)
On the table are a milk carton, a plate of brownies, your glass, and Sam's cup.

Your brother Sam is sitting across from you.

>count
You forget all about the brownies and break into an impromptu of hide-and-seek.

*** You did not pass the milk. ***

>c
Kitchen
Your brother Sam is sitting across from you.

On the table are a carton of milk, a plate of brownies, and two cups.

>count brownies
There are 69,105 brownies here.

* * *

Please pass the milk, please.
Please pass the milk, please.
Please pass the milk, please.

Fingertips: Please Pass the Milk Please
An interactive snack by Adri
Release 3 / Serial number 140312 / Inform 7 build 6G60 (I6/v6.32 lib 6/12N) SD

Kitchen (on the chair)
On the table are a milk carton, a plate of brownies, your glass, and Sam's cup.

Your brother Sam is sitting across from you.

>please pass the milk
(to Sam)
You pour the milk into Sam's cup. He picks up the cup and takes a big gulp. He grins at you.

    *** You passed the milk. ***

Would you like to RESTART, see some suggestions for AMUSING things to do, or QUIT?

* * *

>restart
Please pass the milk, please.
Please pass the milk, please.
Please pass the milk, please.

Fingertips: Please Pass the Milk Please
An interactive snack by Adri
Release 1 / Serial number 120219 / Inform 7 build 6G60 (I6/v6.32 lib 6/12N) SD

Kitchen
Your brother Sam is sitting across from you.

On the table are a carton of milk, a plate of brownies, and two cups.

>please pass the milk please
You pour the milk into Sam's cup. He picks up the cup and takes a big gulp. He grins at you.

    *** You passed the milk. ***

Would you like to RESTART, see some suggestions for AMUSING things to do, or QUIT?

* * *

Please pass the milk, please.
Please pass the milk, please.
Please pass the milk, please.

Fingertips: Please Pass the Milk Please
An interactive snack by Adri
Release 3 / Serial number 140312 / Inform 7 build 6G60 (I6/v6.32 lib 6/12N) SD

Kitchen (on the chair)
On the table are a milk carton, a plate of brownies, your glass, and Sam's cup.

Your brother Sam is sitting across from you.

>please pass the milk, please
You pour the milk into Sam's cup. He picks up the cup and takes a big gulp. He grins at you.

    *** You passed the milk. ***

Would you like to RESTART, see some suggestions for AMUSING things to do, or QUIT?

>restart
Please pass the milk, please.
Please pass the milk, please.
Please pass the milk, please.

Fingertips: Please Pass the Milk Please
An interactive snack by Adri
Release 1 / Serial number 120219 / Inform 7 build 6G60 (I6/v6.32 lib 6/12N) SD

Kitchen
Your brother Sam is sitting across from you.

On the table are a carton of milk, a plate of brownies, and two cups.

>pass
What do you want to give?

>please pass
(Sam please)
That's an odd thing to do.

>please pass the milk please
You pour the milk into Sam's cup. He picks up the cup and takes a big gulp. He grins at you.

    *** You passed the milk. ***

Would you like to RESTART, see some suggestions for AMUSING things to do, or QUIT?

* * *

>please pass the milk, please
You pour the milk into Sam's cup. He picks up the cup and takes a big gulp. He grins at you.

    *** You passed the milk. ***

Would you like to RESTART, see some suggestions for AMUSING things to do, or QUIT?

>amusing
Have you tried...
- passing the milk?
- not passing the milk?
- casting xyzzy?
- looking at the milk carton more than once?
- looking at pictures on the milk carton? Multiple times?
- throwing various things at Sam?
- throwing yourself and Sam?
- counting yourself and Sam?
- Counting the brownies?
- Counting (without a noun)
- eating various things?
- running with scissors?
- finding all eleven endings?

Would you like to RESTART, see some suggestions for AMUSING things to do, or QUIT?

* * *

Please pass the milk, please.
Please pass the milk, please.
Please pass the milk, please.

Fingertips: Please Pass the Milk Please
An interactive snack by Adri
Release 3 / Serial number 140312 / Inform 7 build 6G60 (I6/v6.32 lib 6/12N) SD

Kitchen (on the chair)
On the table are a milk carton, a plate of brownies, your glass, and Sam's cup.

Your brother Sam is sitting across from you.

>pass the brownie please
He doesn't need another brownie. He needs a glass of milk.

>pass the brownie to sam please
He doesn't need another brownie. He needs a glass of milk.

>please pass the brownie to sam pleas
I only understood you as far as wanting to please pass the brownie to Sam.

>pass the brownie to sam pleasee
I only understood you as far as wanting to pass the brownie to Sam.

>pass the brownie to sam please
He doesn't need another brownie. He needs a glass of milk.

* * *

Please pass the milk, please.
Please pass the milk, please.
Please pass the milk, please.

Fingertips: Please Pass the Milk Please
An interactive snack by Adri
Release 3 / Serial number 140312 / Inform 7 build 6G60 (I6/v6.32 lib 6/12N) SD

Kitchen (on the chair)
On the table are a milk carton, a plate of brownies, your glass, and Sam's cup.

Your brother Sam is sitting across from you.

>throw
(the brownie)
You pick up the brownie and throw it at Sam. He catches it and tosses it back at you. It bounces off your shoulder.

>remove
(the shirt)
You should probably keep your clothes on.

>kiss
(Sam)
You smooch Sam on the cheek. He glares at you and wipes at his cheek.

>give
What do you want to give?

>pass
What do you want to give?

* * *

Please pass the milk, please.
Please pass the milk, please.
Please pass the milk, please.

Fingertips: Please Pass the Milk Please
An interactive snack by Adri
Release 3 / Serial number 140312 / Inform 7 build 6G60 (I6/v6.32 lib 6/12N) SD

Kitchen (on the chair)
On the table are a milk carton, a plate of brownies, your glass, and Sam's cup.

Your brother Sam is sitting across from you.

>sit
(on the chair)
You are already sitting.

>sit down
You are already sitting.

>sitting
That's not a verb I recognize.

>sit on chair
You are already sitting.

* * *

Please pass the milk, please.
Please pass the milk, please.
Please pass the milk, please.

Fingertips: Please Pass the Milk Please
An interactive snack by Adri
Release 3 / Serial number 140312 / Inform 7 build 6G60 (I6/v6.32 lib 6/12N) SD

Kitchen (on the chair)
On the table are a milk carton, a plate of brownies, your glass, and Sam's cup.

Your brother Sam is sitting across from you.

>sit on me
No matter how you twist and turn, you can't seem to manage that.

>sit
(on the chair)
You are already sitting.

* * *

Please pass the milk, please.
Please pass the milk, please.
Please pass the milk, please.

Fingertips: Please Pass the Milk Please
An interactive snack by Adri
Release 3 / Serial number 140312 / Inform 7 build 6G60 (I6/v6.32 lib 6/12N) SD

Kitchen (on the chair)
On the table are a milk carton, a plate of brownies, your glass, and Sam's cup.

Your brother Sam is sitting across from you.

>undo
[You can't "undo" what hasn't been done!]

>l
Kitchen
Your brother Sam is sitting across from you.

On the table are a carton of milk, a plate of brownies, and two cups.

>undo
There is no need to do that.

* * *

Please pass the milk, please.
Please pass the milk, please.
Please pass the milk, please.

Fingertips: Please Pass the Milk Please
An interactive snack by Adri
Release 3 / Serial number 140312 / Inform 7 build 6G60 (I6/v6.32 lib 6/12N) SD

Kitchen (on the chair)
On the table are a milk carton, a plate of brownies, your glass, and Sam's cup.

Your brother Sam is sitting across from you.

>talk to sam about life
Sam just frowns at you impatiently.

>stand
You stand up and walk away. Sam throws his cup at you.

*** You did not pass the milk. ***

Kitchen
Your brother Sam is sitting across from you.

On the table are a carton of milk, a plate of brownies, and two cups.

>stand on table
Don't do that. You might fall.

>point at milk
You point at the carton of milk. Sam gets really excited. He picks up his cup and bangs it on the table.

* * *

Please pass the milk, please.
Please pass the milk, please.
Please pass the milk, please.

Fingertips: Please Pass the Milk Please
An interactive snack by Adri
Release 3 / Serial number 140312 / Inform 7 build 6G60 (I6/v6.32 lib 6/12N) SD

Kitchen (on the chair)
On the table are a milk carton, a plate of brownies, your glass, and Sam's cup.

Your brother Sam is sitting across from you.

>z
Sam turns his cup over, giving it a little shake to remind you that it's empty.

>z
Sam reaches towards the milk, waving his arm wildly to make his point.

>z
Sam picks up his cup and peers into it. He pouts and sets it back down.

>z
Sam picks up his cup and peers into it. He pouts and sets it back down.

>z
Sam reaches towards the milk, waving his arm wildly to make his point.

>z
Sam turns his cup over, giving it a little shake to remind you that it's empty.

* * *

>z
Sam reaches towards the milk, waving his arm wildly to make his point.

>talk
Sam just frowns at you impatiently.

* * *

Please pass the milk, please.
Please pass the milk, please.
Please pass the milk, please.

Fingertips: Please Pass the Milk Please
An interactive snack by Adri
Release 3 / Serial number 140312 / Inform 7 build 6G60 (I6/v6.32 lib 6/12N) SD

Kitchen (on the chair)
On the table are a milk carton, a plate of brownies, your glass, and Sam's cup.

Your brother Sam is sitting across from you.

>put milk in cup
You pour the milk into Sam's cup. He picks up the cup and takes a big gulp. He grins at you.

    *** You passed the milk. ***

Would you like to RESTART, see some suggestions for AMUSING things to do, or QUIT?

Kitchen
Your brother Sam is sitting across from you.

On the table are a carton of milk, a plate of brownies, and two cups.

>put brownies on table
(first taking the brownies)

Don't be greedy! Save some for your brother.
You need to be holding the brownies before you can put them on top of something else.

* * *

>put milk in cup
You pour the milk into Sam's cup. He picks up the cup and takes a big gulp. He grins at you.

    *** You passed the milk. ***

Would you like to RESTART, see some suggestions for AMUSING things to do, or QUIT?

>restart
Please pass the milk, please.
Please pass the milk, please.
Please pass the milk, please.

Fingertips: Please Pass the Milk Please
An interactive snack by Adri
Release 1 / Serial number 120225 / Inform 7 build 6G60 (I6/v6.32 lib 6/12N) SD

Kitchen
Your brother Sam is sitting across from you.

On the table are a carton of milk, a plate of brownies, and two cups.

>sam, take the milk
That's not a verb I recognize.

>sam, hello
That's not a verb I recognize.

* * *

Please pass the milk, please.
Please pass the milk, please.
Please pass the milk, please.

Fingertips: Please Pass the Milk Please
An interactive snack by Adri
Release 3 / Serial number 140312 / Inform 7 build 6G60 (I6/v6.32 lib 6/12N) SD

Kitchen (on the chair)
On the table are a milk carton, a plate of brownies, your glass, and Sam's cup.

Your brother Sam is sitting across from you.

>put milk on cup
(first taking the carton of milk)

You pour the last of the milk into your glass. Sam looks like he's about to cry.

*** You did not pass the milk. ***You need to be holding the carton of milk before you can put it on top of something else.

>restart
Please pass the milk, please.
Please pass the milk, please.
Please pass the milk, please.

Fingertips: Please Pass the Milk Please
An interactive snack by Adri
Release 1 / Serial number 120225 / Inform 7 build 6G60 (I6/v6.32 lib 6/12N) SD

Kitchen
Your brother Sam is sitting across from you.

On the table are a carton of milk, a plate of brownies, and two cups.

>put milk in cup
(first taking the carton of milk)

You pour the last of the milk into your glass. Sam looks like he's about to cry.

*** You did not pass the milk. ***

Kitchen
Your brother Sam is sitting across from you.

On the table are a carton of milk, a plate of brownies, and two cups.

* * *

>put milk on cup
(first taking the carton of milk)

You pour the last of the milk into your glass. Sam looks like he's about to cry.

*** You did not pass the milk. ***You need to be holding the carton of milk before you can put it on top of something else.

Kitchen
Your brother Sam is sitting across from you.

On the table are a carton of milk, a plate of brownies, and two cups.

* * *

Please pass the milk, please.
Please pass the milk, please.
Please pass the milk, please.

Fingertips: Please Pass the Milk Please
An interactive snack by Adri
Release 3 / Serial number 140312 / Inform 7 build 6G60 (I6/v6.32 lib 6/12N) SD

Kitchen (on the chair)
On the table are a milk carton, a plate of brownies, your glass, and Sam's cup.

Your brother Sam is sitting across from you.

>pet sam
You try to hug Sam, but he pulls away.

>count milk
You see 69,105 of those.

There's just the one.

* * *

Please pass the milk, please.
Please pass the milk, please.
Please pass the milk, please.

Fingertips: Please Pass the Milk Please
An interactive snack by Adri
Release 3 / Serial number 140312 / Inform 7 build 6G60 (I6/v6.32 lib 6/12N) SD

Kitchen (on the chair)
On the table are a milk carton, a plate of brownies, your glass, and Sam's cup.

Your brother Sam is sitting across from you.

>count milk
There's just the one.

>count me
You are a unique and special snowflake.

>dance
You do a little dance in your seat. Sam giggles.

>pet sam
You try to hug Sam, but he pulls away.

>pet milk
Keep your hands to yourself.

>touch milk
You feel nothing unexpected.

* * *

Please pass the milk, please.
Please pass the milk, please.
Please pass the milk, please.

Fingertips: Please Pass the Milk Please
An interactive snack by Adri
Release 3 / Serial number 140312 / Inform 7 build 6G60 (I6/v6.32 lib 6/12N) SD

Kitchen (on the chair)
On the table are a milk carton, a plate of brownies, your glass, and Sam's cup.

Your brother Sam is sitting across from you.

>pet milk
You feel nothing unexpected.

>pet sam
You try to hug Sam, but he pulls away.

>hug milk
You can only do that to something animate.

* * *

Please pass the milk, please.
Please pass the milk, please.
Please pass the milk, please.

Fingertips: Please Pass the Milk Please
An interactive snack by Adri
Release 3 / Serial number 140312 / Inform 7 build 6G60 (I6/v6.32 lib 6/12N) SD

Kitchen (on the chair)
On the table are a milk carton, a plate of brownies, your glass, and Sam's cup.

Your brother Sam is sitting across from you.

>about
"Please Pass the Milk Please" was written for the Apollo 18+20 tribute album. Thanks so much to Kevin Jackson-Mead for organizing the compilation and inspiring me to finally write my first (and second!) game. Thank you to everyone in PR-IF and on ifMUD for just generally being encouraging and helpful. Thank you to everyone who provided feedback on the game, especially cyberskunk, Lorenzo Batallones, Felix Plesoianu and jpt. And last, but not least, thanks to They Might Be Giants for making awesome music.

>credits
"Please Pass the Milk Please" was written for the Apollo 18+20 tribute album. Thanks so much to Kevin Jackson-Mead for organizing the compilation and inspiring me to finally write my first (and second!) game. Thank you to everyone in PR-IF and on ifMUD for just generally being encouraging and helpful. Thank you to everyone who provided feedback on the game, especially cyberskunk, Lorenzo Batallones, Felix Plesoianu and jpt. And last, but not least, thanks to They Might Be Giants for making awesome music.

>help
What's the name of the game?

>hint
What's the name of the game?

* * *

Please pass the milk, please.
Please pass the milk, please.
Please pass the milk, please.

Fingertips: Please Pass the Milk Please
An interactive snack by Adri
Release 3 / Serial number 140312 / Inform 7 build 6G60 (I6/v6.32 lib 6/12N) SD

Kitchen (on the chair)
On the table are a milk carton, a plate of brownies, your glass, and Sam's cup.

Your brother Sam is sitting across from you.

>hit me
Violence isn't the answer to this one.

* * *

Please pass the milk, please.
Please pass the milk, please.
Please pass the milk, please.

Fingertips: Please Pass the Milk Please
An interactive snack by Adri
Release 3 / Serial number 140312 / Inform 7 build 6G60 (I6/v6.32 lib 6/12N) SD

Kitchen (on the chair)
On the table are a milk carton, a plate of brownies, your glass, and Sam's cup.

Your brother Sam is sitting across from you.

>amusing
That's not a verb I recognize.

>pass milk
(to Sam)
You pour the milk into Sam's cup. He picks up the cup and takes a big gulp. He grins at you.

    *** You passed the milk. ***

Would you like to RESTART, see some suggestions for AMUSING things to do, view available ENDINGS, or QUIT?

>amusing
Have you tried...
- passing the milk?
- not passing the milk?
- casting xyzzy?
- looking at the milk carton more than once?
- looking at pictures on the milk carton? Multiple times?
- throwing various things at Sam?
- throwing yourself and Sam?
- counting yourself and Sam?
- counting the brownies?
- counting (without a noun)
- eating various things?
- running with scissors?
- finding all twelve endings?

Would you like to RESTART, see some suggestions for AMUSING things to do, or QUIT?

>restart
Please pass the milk, please.
Please pass the milk, please.
Please pass the milk, please.

Fingertips: Please Pass the Milk Please
An interactive snack by Adri
Release 1 / Serial number 120514 / Inform 7 build 6G60 (I6/v6.32 lib 6/12N) SD

Kitchen
Your brother Sam is sitting across from you.

On the table are a carton of milk, a plate of brownies, and two cups.

>take tablecloth
You pull the tablecloth off the table, spilling milk and brownies all over Sam. He's too shocked to say anything for a moment, and then he starts bawling.

*** You did not pass the milk. ***

* * *

Kitchen
Your brother Sam is sitting across from you.

On the table are a carton of milk, a plate of brownies, and two cups.

>up
You stand up and walk away. Sam throws his cup at you.

*** You did not pass the milk. ***

Kitchen
Your brother Sam is sitting across from you.

On the table are a carton of milk, a plate of brownies, and two cups.

>run
You're not allowed to run in the house!

>count
You forget all about the brownies and break into an impromptu game of hide-and-seek.

*** You did not pass the milk. ***

Kitchen
Your brother Sam is sitting across from you.

On the table are a carton of milk, a plate of brownies, and two cups.

>throw milk
You pick up the carton of milk and throw it at Sam. Milk flies everywhere. Sam is too startled to cry.

*** You did not pass the milk. ***

Kitchen
Your brother Sam is sitting across from you.

On the table are a carton of milk, a plate of brownies, and two cups.

>throw plate at sam
You throw the plate of brownies at Sam. Brownies fly everywhere and the plate shatters against the wall. You'd better clean up that mess before someone gets hurt.

*** You did not pass the milk. ***

Kitchen
Your brother Sam is sitting across from you.

On the table are a carton of milk, a plate of brownies, and two cups.

>throw glass at sam
You throw your glass at Sam. He ducks and it shatters against the wall. You'd better clean up that mess before someone gets hurt.

*** You did not pass the milk. ***

Kitchen
Your brother Sam is sitting across from you.

On the table are a carton of milk, a plate of brownies, and two cups.

>throw table at sam
You lift up your side of the table, spilling milk and brownies all over Sam. He's too shocked to say anything for a moment, and then he starts bawling.

*** You did not pass the milk. ***

Kitchen
Your brother Sam is sitting across from you.

On the table are a carton of milk, a plate of brownies, and two cups.

>pick up table
That's hardly portable.

>take table
That's hardly portable.

>take plate
Don't be greedy! Save some for your brother.

>take all
There are none at all available!

* * *

Please pass the milk, please.
Please pass the milk, please.
Please pass the milk, please.

Fingertips: Please Pass the Milk Please
An interactive snack by Adri
Release 3 / Serial number 140312 / Inform 7 build 6G60 (I6/v6.32 lib 6/12N) SD

Kitchen (on the chair)
On the table are a milk carton, a plate of brownies, your glass, and Sam's cup.

Your brother Sam is sitting across from you.

>take table
You lift up your side of the table, spilling milk and brownies all over Sam. He's too shocked to say anything for a moment, and then he starts bawling.

*** You did not pass the milk. ***

Kitchen
Your brother Sam is sitting across from you.

On the table are a carton of milk, a plate of brownies, and two cups.

>take brownie
You reach across the table to grab a brownie. Whoops. You bump the carton of milk and it spills all over the table.

*** You did not pass the milk. ***

Kitchen
Your brother Sam is sitting across from you.

On the table are a carton of milk, a plate of brownies, and two cups.

>take milk
You pour the last of the milk into your glass. Sam looks like he's about to cry.

*** You did not pass the milk. ***

Kitchen
Your brother Sam is sitting across from you.

On the table are a carton of milk, a plate of brownies, and two cups.

>pour milk on table
You pick up the carton of milk and dump it all over the table. Sam shrieks angrily.

*** You did not pass the milk. ***

Kitchen
Your brother Sam is sitting across from you.

On the table are a carton of milk, a plate of brownies, and two cups.

>don't pass milk
You pour the last of the milk into your glass. Sam looks like he's about to cry.

*** You did not pass the milk. ***

Kitchen
Your brother Sam is sitting across from you.

On the table are a carton of milk, a plate of brownies, and two cups.

>spill milk
You knock over the milk. Sam bursts into tears.

*** You did not pass the milk. ***

* * *

Kitchen
Your brother Sam is sitting across from you.

On the table are a carton of milk, a plate of brownies, and two cups.

>x milk
The carton reads "Cowtown Dairy." There's a drawing on the front of a cow grazing happily on some seaweed.

>x milk
On the back is a photo of a sad-looking cat and the words "Have you seen my C? Reward!!!"

>x cat
It looks very sad.

>x cat
Why would you want to see a picture of a sad cat?

>x c
It's missing.

>x c
It's missing.

>x cow
         (__)
         (oo)
   /------\/
  / |    ||
 *  /\---/\
    ~~   ~~

>x cow
         (__)
         (oo)
   /------\/
  / |    ||
 *  /\---/\
    ~~   ~~

>read milk
You glance at the nutritional facts. You're not really sure what all those numbers mean.

>read milk
You glance at the nutritional facts. You're not really sure what all those numbers mean.

>read facts
You can't see any such thing.

I beg your pardon?

>look under milk carton
You pick up the milk and peek at the expiration date on the bottom. March 24. That's fine. 1992. Oh. You quickly put the milk back down.

* * *

Please pass the milk, please.
Please pass the milk, please.
Please pass the milk, please.

Fingertips: Please Pass the Milk Please
An interactive snack by Adri
Release 3 / Serial number 140312 / Inform 7 build 6G60 (I6/v6.32 lib 6/12N) SD

Kitchen (on the chair)
On the table are a milk carton, a plate of brownies, your glass, and Sam's cup.

Your brother Sam is sitting across from you.

>dance
You do a little dance in your seat. Sam giggles.

>pass milk
(to Sam)
You pour the milk into Sam's cup. He picks up the cup and takes a big gulp. He grins at you.

    *** You passed the milk. ***

Would you like to RESTART, see some suggestions for AMUSING things to do, view available ENDINGS, or QUIT?

>amusing
Have you tried... 
- looking more closely at the milk carton?
--- looking at it twice?
--- reading it?
--- looking under it?
--- looking at the pictures?
- examining your surroundings?
- interacting with Sam?
- vocalizing?
- throwing, eating and counting various things?
- running with scissors?
- finding all twelve endings?

Would you like to RESTART, see some suggestions for AMUSING things to do, view available ENDINGS, or QUIT?

>endings
- Passing the milk
- Not passing the milk
- Leaving the room
- Counting nothing
- Taking a brownie
- Pouring the milk on something
- Spilling the milk
- Taking the tablecloth
- Taking the table
- Throwing the milk at Sam
- Throwing the plate at Sam
- Throwing the glass at Sam

Would you like to RESTART, see some suggestions for AMUSING things to do, view available ENDINGS, or QUIT?

* * *

Please pass the milk, please.
Please pass the milk, please.
Please pass the milk, please.

Fingertips: Please Pass the Milk Please
An interactive snack by Adri
Release 3 / Serial number 140312 / Inform 7 build 6G60 (I6/v6.32 lib 6/12N) SD

Kitchen (on the chair)
On the table are a milk carton, a plate of brownies, your glass, and Sam's cup.

Your brother Sam is sitting across from you.

>count plate
The plate contins 69,105 brownies.

>count brownies
The plate contins 69,105 brownies.

>count brownie
The plate contins 69,105 brownies.

* * *

Please pass the milk, please.
Please pass the milk, please.
Please pass the milk, please.

Fingertips: Please Pass the Milk Please
An interactive snack by Adri
Release 3 / Serial number 140312 / Inform 7 build 6G60 (I6/v6.32 lib 6/12N) SD

Kitchen (on the chair)
On the table are a milk carton, a plate of brownies, your glass, and Sam's cup.

Your brother Sam is sitting across from you.

>don't pass the milk
You pour the last of the milk into your glass. Sam looks like he's about to cry.

*** You did not pass the milk. ***

please press any key please

Kitchen (on the chair)
On the table are a milk carton, a plate of brownies, your glass, and Sam's cup.

Your brother Sam is sitting across from you.

* * *

Please pass the milk, please.
Please pass the milk, please.
Please pass the milk, please.

Fingertips: Please Pass the Milk Please
An interactive snack by Adri
Release 3 / Serial number 140312 / Inform 7 build 6G60 (I6/v6.32 lib 6/12N) SD

Kitchen (on the chair)
On the table are a milk carton, a plate of brownies, your glass, and Sam's cup.

Your brother Sam is sitting across from you.

>pass the milk
(to Sam)
You pour the milk into Sam's cup. He picks up the cup and takes a big gulp. He grins at you.

    *** You passed the milk. ***

Would you like to RESTART, see some suggestions for AMUSING things to do, UNDO the last command, view available ENDINGS, or QUIT?

>undo
Kitchen
[Previous turn undone.]

>don't pass the milk
You pour the last of the milk into your glass. Sam looks like he's about to cry.

*** You did not pass the milk. ***

Please press SPACE to continue.

Kitchen (on the chair)
On the table are a milk carton, a plate of brownies, your glass, and Sam's cup.

Your brother Sam is sitting across from you.

>up
You stand up and walk away. Sam throws his cup at you.

*** You did not pass the milk. ***

Please press SPACE to continue.