This is the day you've always dreamed of. You are finally marrying the love of your life, Prince Roland.

Castle Garden
You are standing in the garden behind your family's castle. On this lovely fall evening, it is doing double duty as a wedding chapel.

Your betrothed, Roland, stands before you.

You can also see Father Alfred here.

>take rose
Taken.

The Paper Bag Princess
An interactive something or other by Adri
Release 1 / Serial number 130818 / Inform 7 build 6G60 (I6/v6.32 lib 6/12N) SD

Castle Ruins
You can see a paper bag here.

>kill rose
Violence isn't the answer to this one.

* * *

>take rose
Taken.

The Paper Bag Princess
An interactive something or other by Adri
Release 1 / Serial number 130818 / Inform 7 build 6G60 (I6/v6.32 lib 6/12N) SD

Castle Ruins
You can see a paper bag here.

>remove gown
You take off the handful of rags.

* * *

This is the day you've always dreamed of. You are finally marrying the love of your life, Prince Roland.

Castle Garden
You are standing in the garden behind your family's castle. On this lovely fall evening, it is doing double duty as a wedding chapel.

Your betrothed, Roland, stands before you.

You can also see Father Alfred here.

>x castle
castle.

Father Alfred begins the ceremony, "We are gathered here today to witness the joining of two hearts." Roland smiles shyly at you.

>x garden
rose bushes.

"If anyone has a reason why these two should not be wed, speak now or forever hold your peace." You hold your breath for a second, wondering whether anyone will speak up. Fortunately, nobody does and you relax.

* * *

This is the day you've always dreamed of. You are finally marrying the love of your life, Prince Roland.

Castle Garden
You are standing in the garden behind your family's castle. On this lovely fall evening, it is doing double duty as a wedding chapel.

Your betrothed, Roland, stands before you.

You can also see Father Alfred here.

>x me
You are the loveliest princess in the land.

You are wearing a wedding gown and a sparkly gold crown.

---

>i
You are carrying a bouquet.

>take rose
Taken.

The Paper Bag Princess
An interactive something or other by Adri
Release 1 / Serial number 130818 / Inform 7 build 6G60 (I6/v6.32 lib 6/12N) SD

Castle Ruins
You can see a paper bag here.

>i
You are wearing a handful of rags and a tarnished gold crown.

You are carrying a rose.

>x me
You are still the loveliest princess in the land.

You are wearing a tarnished gold crown and the tattered remains of your wedding gown. It doesn't leave very much to the imagination.

>i
You are wearing a handful of rags and a tarnished gold crown.

You are carrying a rose.

>x rags
The tattered remains of your wedding gown.

* * *

>i
You are carrying a bouquet.

>x crown
Your gold crown.

>x gown
A long, white wedding gown.

* * *

>i
You are carrying a bouquet.

>drop bouquet.search rubble.x bag
Dropped.

The Paper Bag Princess
An interactive fairy tale by Adri
Release 1 / Serial number 130818 / Inform 7 build 6G60 (I6/v6.32 lib 6/12N) SD

Castle Ruins
No more castle. pile of rubble

You find a paper bag.

It's a gift bag fashioned out of paper. It looks like it used to have polka dots on it, but now it's just scorched.

* * *

>x me
You are the loveliest princess in the land.

You are wearing a wedding gown and a sparkly gold crown.

---

>take rose
Taken.

The Paper Bag Princess
An interactive something or other by Adri
Release 1 / Serial number 130818 / Inform 7 build 6G60 (I6/v6.32 lib 6/12N) SD

Castle Ruins
You can see a paper bag here.

>x me
You are still the loveliest princess in the land.

You are wearing a tarnished gold crown and the tattered remains of your wedding gown. It doesn't leave very much to the imagination.

* * *

>x me
You are the the loveliest princess in the land.

You are stark naked, save for your crown.

* * *

>x me
You are still the loveliest princess in the land.

You are wearing a tarnished gold crown and the tattered remains of your wedding gown. It doesn't leave very much to the imagination.

>i
You are wearing a tattered wedding gown and a tarnished gold crown.

You are carrying a rose.

* * *

>x me
You are the loveliest princess in the land.

You are wearing a wedding gown and a sparkly gold crown.

---

>remove crown
You take off the gold crown.

>x me
You are the the loveliest princess in the land.

You are wearing a wedding gown.

>take rose
Taken.

The Paper Bag Princess
An interactive something or other by Adri
Release 1 / Serial number 130818 / Inform 7 build 6G60 (I6/v6.32 lib 6/12N) SD

Castle Ruins
You can see a paper bag here.

>x me
You are the the loveliest princess in the land.

You are wearing the tattered remains of your wedding gown. It doesn't leave very much to the imagination.

>wear crown
You put on the tarnished gold crown.

>x me
You are the the loveliest princess in the land.

You are wearing a tarnished gold crown and the tattered remains of your wedding gown. It doesn't leave very much to the imagination.

* * *

>x me
You are the the loveliest princess in the land.

You are stark naked, save for a tarnished gold crown.

>remove crown
You take off the tarnished gold crown.

>x me
You are the the loveliest princess in the land.

You are elegantly clad in only your birthday suit.

* * *

>x me
You are the loveliest princess in the land.

You are wearing a wedding gown and a sparkly gold crown.

---

>x gown
A long, white wedding gown.

...

>xyzzy
POOF! Your fairy godmother appears. She smiles at you and places a necklace around your neck.

,,,,

DRAGON!

Please press SPACE to continue.

* * *

The Paper Bag Princess
An interactive fairy tale by Adri
Release 1 / Serial number 130921 / Inform 7 build 6G60 (I6/v6.32 lib 6/12N) SD

Castle Ruins
No more castle. pile of rubble

>restart
Are you sure you want to restart?

>y
Something something something

Throne Room
This is it. You're finally getting married!

Your betrothed, Roland, stands before you.

>xyzzy
POOF! Your fairy godmother appears. She smiles at you and places a necklace around your neck.

---

>x me
You are the loveliest princess in the land.

You are wearing a necklace and a sparkly gold crown and a long, white wedding gown.

...

>z.z
You beam happily at Roland.

,,,,

DRAGON!

Please press SPACE to continue.

The Paper Bag Princess
An interactive fairy tale by Adri
Release 1 / Serial number 130921 / Inform 7 build 6G60 (I6/v6.32 lib 6/12N) SD

Castle Ruins
No more castle. pile of rubble

Time passes.

>x me
You are still the loveliest princess in the land.

You are wearing a necklace and a tarnished gold crown and the tattered remains of your wedding gown. It doesn't leave very much to the imagination.
a gift bag that has been fashioned into a rather respectable dress.

>remove dress
You strip off the remains of your wedding gown.

>x me
You are still the loveliest princess in the land.

You are wearing a necklace and a tarnished gold crown and a gift bag that has been fashioned into a rather respectable dress.

>remove necklace
You take off the necklace.

>x me
You are still the loveliest princess in the land.

You are wearing a necklace and a tarnished gold crown and a gift bag that has been fashioned into a rather respectable dress.

>i
You are carrying a necklace, a bouquet, and a handful of rags.

>remove crown
You take off the tarnished gold crown.

>x me
You are still the loveliest princess in the land.

You are wearing a necklace and a bouquet and a gift bag that has been fashioned into a rather respectable dress.

>remove bag
You remove the gift bag, folding it carefully.

>x me
You are still the loveliest princess in the land.

You are elegantly clad in only your birthday suit.

>i
You are carrying a paper bag, a necklace, a bouquet, a handful of rags, and a tarnished gold crown.

* * *

>x me
You are the loveliest princess in the land.

You are wearing a wedding gown and a sparkly gold crown.

---

>xyzzy
POOF! Your fairy godmother appears. She smiles at you and places a necklace around your neck.

...

>x me
You are the loveliest princess in the land.

You are wearing a necklace, a wedding gown, and a sparkly gold crown.

,,,,

DRAGON!

Please press SPACE to continue.

The Paper Bag Princess
An interactive fairy tale by Adri
Release 1 / Serial number 130921 / Inform 7 build 6G60 (I6/v6.32 lib 6/12N) SD

Castle Ruins
No more castle. pile of rubble

>x me
You are still the loveliest princess in the land.

You are wearing a gift bag that has been fashioned into a rather respectable dress, a necklace, a tattered remains of your wedding gown, and a tarnished gold crown.

* * *

>x me
You are the loveliest princess in the land.

You are wearing a wedding gown and a sparkly gold crown.

---

>remove gown
no.

...

>undo
Throne Room
[Previous turn undone.]

>xyzzy
POOF! Your fairy godmother appears. She smiles at you and places a necklace around your neck.

...

* * *

The Paper Bag Princess
An interactive fairy tale by Adri
Release 1 / Serial number 130921 / Inform 7 build 6G60 (I6/v6.32 lib 6/12N) SD

Castle Ruins
No more castle. pile of rubble

>x me
You are still the loveliest princess in the land.

You are wearing a gift bag that has been fashioned into a rather respectable dress, some handful of rags, a necklace, and a tarnished gold crown.

* * *

This is the day you've always dreamed of. You are finally marrying the love of your life, Prince Roland.

Castle Garden
You are standing in the garden behind your family's castle. On this lovely fall evening, it is doing double duty as a wedding chapel.

Your betrothed, Roland, stands before you.

You can also see Father Alfred here.

>x roland
Roland is the most attractive man you have ever laid eyes on.

Father Alfred begins the ceremony, "We are gathered here today to witness the joining of two hearts." Roland smiles shyly at you.

>talk to roland
That's not a verb I recognize.

>talk to dragon
That's not a verb I recognize.

>hello, dragon
You seem to want to talk to someone, but I can't see whom.

>hello, roland
You seem to want to talk to someone, but I can't see whom.

>roland, hello
There is no reply.

>dragon, hello
There is no reply.

>foo, hello
You seem to want to talk to someone, but I can't see whom.

* * *

>x roland
Roland is the most attractive man you have ever laid eyes on.

Father Alfred begins the ceremony, "We are gathered here today to witness the joining of two hearts." Roland smiles shyly at you.

>heteronormativity off
Ok!

>x roland
Rolande is the most attractive person you have ever laid eyes on. Too bad she's also the biggest jerk you've ever met!

...

>undo
Throne Room
[Previous turn undone.]

>x rolande
Rolande is the most attractive person you have ever laid eyes on. Too bad she's also the biggest jerk you've ever met!

...

* * *

>heteronormativity off
Ok!

>x him
Rolande is the most attractive woman you have ever laid eyes on.

"If anyone has a reason why these two should not be wed, speak now or forever hold your peace." You hold your breath for a second, wondering whether anyone will speak up. Fortunately, nobody does and you relax.

>x her
I'm not sure what "her" refers to.

* * *

This is the day you've always dreamed of. You are finally marrying the love of your life, Prince Roland.

Castle Garden
You are standing in the garden behind your family's castle. On this lovely fall evening, it is doing double duty as a wedding chapel.

Your betrothed, Roland, stands before you.

You can also see Father Alfred here.

>n
(first opening the Cave Door)
It seems to be locked.

>open door
It seems to be locked.

>knock on door
That's not a verb I recognize.

>open door
It seems to be locked.

>in
You can't go that way.

>out
But you aren't in anything at the moment.

* * *

This is the day you've always dreamed of. You are finally marrying the love of your life, Prince Roland.

Castle Garden
You are standing in the garden behind your family's castle. On this lovely fall evening, it is doing double duty as a wedding chapel.

Your betrothed, Roland, stands before you.

You can also see Father Alfred here.

>e
It seems to be locked.

>e
You can't go that way.

>w
You can't go that way.

>open door
It seems to be locked.

>e
You can't go that way.

* * *

>e
It seems to be locked.

>w
You can't go that way.

>e
It seems to be locked.

>x door
You see nothing special about the Cave Door.

>open door
It seems to be locked.

>enter door
You can't go that way.

>e
You can't go that way.

* * *

This is the day you've always dreamed of. You are finally marrying the love of your life, Prince Roland.

Castle Garden
You are standing in the garden behind your family's castle. On this lovely fall evening, it is doing double duty as a wedding chapel.

Your betrothed, Roland, stands before you.

You can also see Father Alfred here.

>open door
It seems to be locked.

>unlock door
(with the crown)
That doesn't seem to fit the lock.

* * *

This is the day you've always dreamed of. You are finally marrying the love of your life, Prince Roland.

Castle Garden
You are standing in the garden behind your family's castle. On this lovely fall evening, it is doing double duty as a wedding chapel.

Your betrothed, Roland, stands before you.

You can also see Father Alfred here.

>knock
(the Cave Door)
You knock on the Cave Door.

>knock on door
Knocking on that would be silly.

You knock on the door.

>knock on crown
Knocking on that would be silly.

>knock on me
Violence isn't the answer to this one.

* * *

>knock
(the Cave Door)
You knock on the Cave Door.

>knock crown
You give the crown a gentle rap.

* * *

This is the day you've always dreamed of. You are finally marrying the love of your life, Prince Roland.

Castle Garden
You are standing in the garden behind your family's castle. On this lovely fall evening, it is doing double duty as a wedding chapel.

Your betrothed, Roland, stands before you.

You can also see Father Alfred here.

>knock on door
You knock on the door.

>knock on crown
Knocking on that would be silly.

>knock on wall
You can't see any such thing.

* * *

This is the day you've always dreamed of. You are finally marrying the love of your life, Prince Roland.

Castle Garden
You are standing in the garden behind your family's castle. On this lovely fall evening, it is doing double duty as a wedding chapel.

Your betrothed, Roland, stands before you.

You can also see Father Alfred here.

>i
You are carrying a bouquet.

---

>x gown
A long, white wedding gown.

>x crown
A tall gold

* * *

>x gown
A long, white wedding gown.

>take rose
Taken.

The Paper Bag Princess
An interactive something or other by Adri
Release 1 / Serial number 130818 / Inform 7 build 6G60 (I6/v6.32 lib 6/12N) SD

Castle Ruins

>x gown
The tattered remains of your wedding gown.

>i
You are carrying:
  a rose
  a tattered wedding gown (being worn)
  a crown (being worn)

>drop rose
Dropped.

>l
Castle Ruins
You can see a rose here.

>i
You are carrying:
  a tattered wedding gown (being worn)
  a crown (being worn)

* * *

>i
You are carrying a bouquet.

---

>x crown
Your gold crown.

* * *

>take rose
Taken.

The Paper Bag Princess
An interactive something or other by Adri
Release 1 / Serial number 130818 / Inform 7 build 6G60 (I6/v6.32 lib 6/12N) SD

Castle Ruins

>i
You are carrying:
  a rose
  a tattered wedding gown (being worn)
  a tarnished gold crown (being worn)

>x gown
The tattered remains of your wedding gown.

>x crown
Your gold crown. It's looking a little worse for the wear.

* * *

>i
You are carrying a bouquet.

---

>take rose
Taken.

The Paper Bag Princess
An interactive something or other by Adri
Release 1 / Serial number 130818 / Inform 7 build 6G60 (I6/v6.32 lib 6/12N) SD

Castle Ruins

>i
You are wearing a tattered wedding gown and a tarnished gold crown.

You are carrying a rose.

* * *

>i
You are carrying a bouquet.

---

>x me
You are the the loveliest princess in the land.

You are wearing sparkly gold crown and a wedding gown.

* * *

>i
You are carrying a bouquet.

---

>drop bouquet
Dropped.

The Paper Bag Princess
An interactive fairy tale by Adri
Release 1 / Serial number 130818 / Inform 7 build 6G60 (I6/v6.32 lib 6/12N) SD

Castle Ruins
You can see a paper bag here.

* * *

>i
You are carrying a bouquet.

---

>x dress
A long, white wedding gown.

...

>x me
You are the loveliest princess in the land.

You are wearing a sparkly gold crown and a long, white wedding gown.

,,,,

DRAGON!

Please press SPACE to continue.

The Paper Bag Princess
An interactive fairy tale by Adri
Release 1 / Serial number 130916 / Inform 7 build 6G60 (I6/v6.32 lib 6/12N) SD

Castle Ruins
No more castle. pile of rubble

>x crown
Your gold crown. It's looking a little worse for the wear.

>x me
You are still the loveliest princess in the land.

You are wearing a tarnished gold crown and the tattered remains of your wedding gown. It doesn't leave very much to the imagination.
a gift bag that has been fashioned into a rather respectable dress.

* * *

This is the day you've always dreamed of. You are finally marrying the love of your life, Prince Roland.

Castle Garden
You are standing in the garden behind your family's castle. On this lovely fall evening, it is doing double duty as a wedding chapel.

Your betrothed, Roland, stands before you.

You can also see Father Alfred here.

>x gold
You can't see any such thing.

>x wedding
A long, white wedding gown.

>x dress
A long, white wedding gown.

>i
You are carrying:
  a wedding gown (being worn)
  a gold crown (being worn)

* * *

This is the day you've always dreamed of. You are finally marrying the love of your life, Prince Roland.

Castle Garden
You are standing in the garden behind your family's castle. On this lovely fall evening, it is doing double duty as a wedding chapel.

Your betrothed, Roland, stands before you.

You can also see Father Alfred here.

>remove gown
no.

>take rose
Taken.

The Paper Bag Princess
An interactive something or other by Adri
Release 1 / Serial number 130818 / Inform 7 build 6G60 (I6/v6.32 lib 6/12N) SD

Castle Ruins
You can see a paper bag here.

>remove gown
You strip off the remains of your wedding gown and discard them in a pile of rubble.

You take off the handful of rags.

>i
You are wearing a tarnished gold crown.

You are carrying a handful of rags and a rose.

>wear gown
You put on the tattered wedding gown.

* * *

>i
You are wearing a tarnished gold crown.

You are carrying a handful of rags and a rose.

>l
Castle Ruins
You can see a paper bag here.

* * *

>remove gown
no.

>wear gown
You're already wearing that!

>take rose
Taken.

The Paper Bag Princess
An interactive something or other by Adri
Release 1 / Serial number 130818 / Inform 7 build 6G60 (I6/v6.32 lib 6/12N) SD

Castle Ruins

>remove gown
You take off the tattered wedding gown.

>wear gown
You put on the tattered wedding gown.

>i
You are wearing a tattered wedding gown and a tarnished gold crown.

You are carrying a rose.

* * *

>remove gown
no.

>i
You are wearing a wedding gown and a sparkly gold crown.

You are carrying nothing.

>take rose
Taken.

The Paper Bag Princess
An interactive something or other by Adri
Release 1 / Serial number 130818 / Inform 7 build 6G60 (I6/v6.32 lib 6/12N) SD

Castle Ruins
You can see a paper bag here.

>remove gown
You strip off the remains of your wedding gown and discard them in a pile of rubble.

>i
You are wearing a tarnished gold crown.

You are carrying a rose.

>l
Castle Ruins
You can see a paper bag here.

>x gown
You can't see any such thing.

>x rags
You can't see any such thing.

>x me
You are still the loveliest princess in the land.

You are stark naked, save for a tarnished gold crown.

>take bag
Taken.

>wear bag
You put on the paper bag.

>i
You are wearing a paper bag and a tarnished gold crown.

You are carrying a rose.

>x bag
You see nothing special about the paper bag.

>x me
You are still the loveliest princess in the land.

You are wearing a tarnished gold crown and a gift bag that has been fashioned into a rather respectable dress.

>remove crown
You take off the tarnished gold crown.

>i
You are wearing a paper bag.

You are carrying a rose and a tarnished gold crown.

* * *

This is the day you've always dreamed of. You are finally marrying the love of your life, Prince Roland.

Castle Garden
You are standing in the garden behind your family's castle. On this lovely fall evening, it is doing double duty as a wedding chapel.

Your betrothed, Roland, stands before you.

You can also see Father Alfred here.

>wear gown
You're already wearing that!

>remove gown
no.

>g
no.

>g
no.

>wear gown
You're already wearing that!

* * *

>take rose
Taken.

The Paper Bag Princess
An interactive something or other by Adri
Release 1 / Serial number 130818 / Inform 7 build 6G60 (I6/v6.32 lib 6/12N) SD

Castle Ruins

>wear gown
You're already wearing that!

* * *

>wear gown
You can't wear that!

* * *

This is the day you've always dreamed of. You are finally marrying the love of your life, Prince Roland.

Castle Garden
You are standing in the garden behind your family's castle. On this lovely fall evening, it is doing double duty as a wedding chapel.

Your betrothed, Roland, stands before you.

You can also see Father Alfred here.

>drop crown
no.

>remove crown
You take off the sparkly gold crown.

* * *

>drop crown
no.

>remove dress
no.

* * *

This is the day you've always dreamed of. You are finally marrying the love of your life, Prince Roland.

Castle Garden
You are standing in the garden behind your family's castle. On this lovely fall evening, it is doing double duty as a wedding chapel.

Your betrothed, Roland, stands before you.

You can also see Father Alfred here.

>take throngs
That's hardly portable.

* * *

This is the day you've always dreamed of. You are finally marrying the love of your life, Prince Roland.

Castle Garden
You are standing in the garden behind your family's castle. On this lovely fall evening, it is doing double duty as a wedding chapel.

Your betrothed, Roland, stands before you.

You can also see Father Alfred here.

>take guests
They're hardly portable.

>take priest
That's hardly portable.

* * *

This is the day you've always dreamed of. You are finally marrying the love of your life, Prince Roland.

Castle Garden
You are standing in the garden behind your family's castle. On this lovely fall evening, it is doing double duty as a wedding chapel.

Your betrothed, Roland, stands before you.

You can also see Father Alfred here.

>z
You beam happily at Roland.

"We are gathered here today to witness the joining of two hearts."

>z
You beam happily at Roland.

"Speak now or forever hold your peace."

You hold your breath for a second, wondering whether anyone will speak up. Nobody does. You visibly relax.

>n
You can't go that way.

>drop bouquet.search rubble
Dropped.

The Paper Bag Princess
An interactive fairy tale by Adri
Release 1 / Serial number 130818 / Inform 7 build 6G60 (I6/v6.32 lib 6/12N) SD

Castle Ruins
No more castle. pile of rubble

You find a paper bag.

>n
You can't go that way.

>s
You can't go that way.

>z
Wear something.

* * *

>z
You beam happily at Roland.

"Speak now or forever hold your peace."

You hold your breath for a second, wondering whether anyone will speak up. Nobody does. You visibly relax.

>z
You beam happily at Roland.

"Who gives this woman--"

You glare icily at the minister. "Ahem. Moving on.." Roland furrows his brow, but says nothing.

>z
You beam happily at Roland.

And so on. You're not really paying attention to the whole thing.

"Elizabeth, do you take Roland to be your husband blah blah blah."

The Paper Bag Princess
An interactive fairy tale by Adri
Release 1 / Serial number 130819 / Inform 7 build 6G60 (I6/v6.32 lib 6/12N) SD

Castle Ruins
No more castle. pile of rubble

>restart
Are you sure you want to restart?

>y
The Paper Bag Princess
An interactive fairy tale by Adri
Release 1 / Serial number 130819 / Inform 7 build 6G60 (I6/v6.32 lib 6/12N) SD

Throne Room
This is it. You're finally getting married!

Your betrothed, Roland, stands before you.

>z
You beam happily at Roland.

---

>z
You beam happily at Roland.

...

>z
You beam happily at Roland.

,,,,

DRAGON!

Please press SPACE to continue.

The Paper Bag Princess
An interactive fairy tale by Adri
Release 1 / Serial number 130819 / Inform 7 build 6G60 (I6/v6.32 lib 6/12N) SD

Castle Ruins
No more castle. pile of rubble

>search rubble.wear bag.n.ne
You find a paper bag.

(first taking the paper bag)
You quickly fashion a dress out of the gift bag. It's not as fancy as you're used to, but it'll get the job done.

You strip off the remains of your wedding gown and discard them in a pile of rubble.

First Forest
There's a trail of burned trees and horses' teeth leading to the northeast.

Cave Exterior

>knock
(the Cave Door)
You knock on the Cave Door.

The dragon opens the door and tells you to beat it.

>ask dragon about flying
The Dragon something or other.

>ask dragon about flying
The Dragon something or other.

>ask dragon about fly
The Dragon something or other.

>ask dragon about fire
The Dragon something or other.

* * *

The Paper Bag Princess
An interactive fairy tale by Adri
Release 1 / Serial number 130819 / Inform 7 build 6G60 (I6/v6.32 lib 6/12N) SD

Castle Ruins
No more castle. pile of rubble

>z
Time passes.

>search rubble.wear bag.n.ne
You find a paper bag.

(first taking the paper bag)
You quickly fashion a dress out of the gift bag. It's not as fancy as you're used to, but it'll get the job done.

You strip off the remains of your wedding gown and discard them in a pile of rubble.

First Forest
There's a trail of burned trees and horses' teeth leading to the northeast.

Cave Exterior

* * *

>knock
(the Cave Door)
You knock on the Cave Door.

The dragon opens the door and tells you to beat it.

>ask dragon about fly
The dragon does not respond.

>ask dragon about flying
The dragon does not respond.

>ask dragon about fire
The dragon does not respond.

* * *

>search rubble.wear bag.n.ne
You find a paper bag.

(first taking the paper bag)
You quickly fashion a dress out of the gift bag. It's not as fancy as you're used to, but it'll get the job done.

You strip off the remains of your wedding gown and discard them in a pile of rubble.

First Forest
There's a trail of burned trees and horses' teeth leading to the northeast.

Cave Exterior

>e
You can't go that way.

>knock
(the Cave Door)
You knock on the Cave Door.

The dragon opens the door and tells you to beat it.

>e
You can't go that way.

>ask about flying
(addressing the dragon)
---

>g
---

>g
---

I beg your pardon?

>ask about flying
The Dragon something or other.

>ask about fire
---

>g
---

>g
---

The dragon falls asleep.

>e
You can't go that way.

* * *

>z
Time passes.

>search rubble.wear bag.n.ne.knock
You find a paper bag.

(first taking the paper bag)
You quickly fashion a dress out of the gift bag. It's not as fancy as you're used to, but it'll get the job done.

You strip off the remains of your wedding gown and discard them in a pile of rubble.

First Forest
There's a trail of burned trees and horses' teeth leading to the northeast.

Cave Exterior
(the Cave Door)
You knock on the Cave Door.

The dragon opens the door and tells you to beat it.

>ask dragon about me
The Dragon something or other.

>ask dragon about fly
---

>ask dragon about fire
---

>g
---

* * *

I beg your pardon?

>ask dragon about fly
---

>g
---

>g
The Dragon something or other.

>ask dragon about fire
---

>ask dragon about fly
The Dragon something or other.

* * *

>ask dragon about fire
The Dragon something or other.

>g
The Dragon something or other.

>ask dragon about fly
The Dragon something or other.

* * *

>ask dragon about fire
The Dragon something or other.

>l
Cave Exterior
You can see a dragon here.

>x dragon
Rawr. Dragon.

>e
You open the Cave Door.

>e
That's already open.

>l
Cave Exterior
You can see a dragon here.

>e
That's already open.

>enter door
You can't go that way.

>in
You can't go that way.

>ask dragon about roland
Blah.

>x dragon
Rawr. Dragon.

* * *

>search rubble.wear bag.n.ne.knock
You find a paper bag.

(first taking the paper bag)
You quickly fashion a dress out of the gift bag. It's not as fancy as you're used to, but it'll get the job done.

You strip off the remains of your wedding gown and discard them in a pile of rubble.

First Forest
There's a trail of burned trees and horses' teeth leading to the northeast.

Cave Exterior
(the Cave Door)
You knock on the Cave Door.

The dragon opens the door and tells you to beat it.

>x dragon
Rawr. Dragon.

>talk to dragon
I am awesome.

>ask dragon about roland
Blah.

>ask dragon about me
The Dragon something or other.

>ask dragon about flying
---

>g
---

* * *

>g
---

The dragon falls asleep.

>g
The dragon is fast asleep. You shouldn't wake it up.

>e
You open the Cave Door.

>l
Cave Exterior
You can see a dragon here.

* * *

The Paper Bag Princess
An interactive fairy tale by Adri
Release 1 / Serial number 130819 / Inform 7 build 6G60 (I6/v6.32 lib 6/12N) SD

Castle Ruins
No more castle. pile of rubble

>x rubble
rubble

>search rubble
You find a paper bag.

>wear bag
(first taking the paper bag)
You quickly fashion a dress out of the gift bag. It's not as fancy as you're used to, but it'll get the job done.

You strip off the remains of your wedding gown and discard them in a pile of rubble.

>n
First Forest
There's a trail of burned trees and horses' teeth leading to the northeast.

>ne
Cave Exterior

>x dragon
Rawr. Dragon.

>l
Cave Exterior
You can see a dragon here.

>knock
(the Cave Door)
You knock on the Cave Door.

The dragon opens the door and tells you to beat it.

>ask about flight
(addressing the dragon)
The Dragon something or other.

>g
The Dragon something or other.

>ask about flying
---

>g
---

* * *

>g
The Dragon something or other.

>ask about fire
---

* * *

>g
The dragon is fast asleep. You shouldn't wake it up.

>e
You open the Cave Door.

You can't go that way.

>e
You can't go that way.

>e
You can't go that way.

>x door
You see nothing special about the Cave Door.

>e
You can't go that way.

* * *

>z
You beam happily at Roland.

And so on. You're not really paying attention to the whole thing.

"Elizabeth, do you take Roland to be your husband blah blah blah."

>z
You beam happily at Roland.

"Elizabeth, do you take Roland to be your husband blah blah blah."

DRAGON!

Please press SPACE to continue.

* * *

>z
You beam happily at Roland.

"Who gives this woman--"

You glare icily at the minister. "Ahem. Moving on.." Roland furrows his brow, but says nothing.

The Paper Bag Princess
An interactive fairy tale by Adri
Release 1 / Serial number 130916 / Inform 7 build 6G60 (I6/v6.32 lib 6/12N) SD

Castle Ruins
No more castle. pile of rubble

I beg your pardon?

>n
Burnt Forest
There's a trail of burned trees and horses' teeth leading to the northeast.

>ne
Burnt Forest.
Something something something.

>n
Burnt Forest.
Something something something.

I beg your pardon?

I beg your pardon?

>e
Burnt Forest.
Something something something.

>e
Burnt Forest.
Something something something.

I beg your pardon?

>e
Cave Exterior

>e
(first opening the Cave Door)
The door is locked. Perhaps you should try knocking.

>knock
(the Cave Door)
You grab the knocker and bang on the door.

The dragon sticks his nose out the door and says, "Well, a princess! I love to eat princesses, but I have already eaten a whole castle today. I am a very busy dragon. Come back tomorrow."

Then he slams the door.

>knock
(the Cave Door)
You grab the knocker and bang on the door again.

The dragon sticks his nose out the door and says, "Well, a princess! I love to eat princesses, but I have already eaten a whole castle today. I am a very busy dragon. Come back tomorrow."

This time he pauses a moment before slamming the door.

>shout at dragon
You shout at the dragon.

lalalalalala

>n
You can't go that way.

* * *

The Paper Bag Princess
An interactive fairy tale by Adri
Release 1 / Serial number 130916 / Inform 7 build 6G60 (I6/v6.32 lib 6/12N) SD

Castle Ruins
No more castle. pile of rubble

>n
Burnt Forest
There's a trail of burned trees and horses' teeth leading to the northeast.

* * *

>ne
Burnt Forest.
Something something something.

>n.n.n.n.n
Burnt Forest.
Something something something.

Burnt Forest.
Something something something.

Burnt Forest.
Something something something.

Burnt Forest.
Something something something.

Burnt Forest.
Something something something.

>n
Burnt Forest.
Something something something.

>n.n
Burnt Forest.
Something something something.

Burnt Forest.
Something something something.

>n
Burnt Forest.
Something something something.

>n
Burnt Forest.
Something something something.

>n
Cave Exterior

>e
(first opening the Cave Door)
The door is locked. Perhaps you should try knocking.

* * *

>knock
(the Cave Door)
You grab the knocker and bang on the door again.

The dragon sticks his nose out the door and says, "Well, a princess! I love to eat princesses, but I have already eaten a whole castle today. I am a very busy dragon. Come back tomorrow."

This time he pauses a moment before slamming the door.

>undo
Cave Exterior
[Previous turn undone.]

>knock again
You can't see any such thing.

>knock
(the Cave Door)
You grab the knocker and bang on the door again.

The dragon sticks his nose out the door and says, "Well, a princess! I love to eat princesses, but I have already eaten a whole castle today. I am a very busy dragon. Come back tomorrow."

This time he pauses a moment before slamming the door.

>shout
lalalalalala
You shout at the dragon.

* * *

This is the day you've always dreamed of. You are finally marrying the love of your life, Prince Roland.

Castle Garden
You are standing in the garden behind your family's castle. On this lovely fall evening, it is doing double duty as a wedding chapel.

Your betrothed, Roland, stands before you.

You can also see Father Alfred here.

>take roland
I don't suppose Roland would care for that.

>e
You can't go that way.

* * *

This is the day you've always dreamed of. You are finally marrying the love of your life, Prince Roland.

Castle Garden
You are standing in the garden behind your family's castle. On this lovely fall evening, it is doing double duty as a wedding chapel.

Your betrothed, Roland, stands before you.

You can also see Father Alfred here.

>drop bouquet
Dropped.

Please press SPACE to continue.

>search rubble
You find a paper bag.

>l
Castle Ruins
No more castle.

You can see a paper bag here.

>search rubble
Nothing else.

* * *

>wear bag
(first taking the paper bag)
You quickly fashion a dress out of the gift bag. It's not as fancy as you're used to, but it'll get the job done.

You strip off the remains of your wedding gown and discard them in a pile of rubble.

>n
First Forest

* * *

>wear bag
(first taking the paper bag)
You quickly fashion a dress out of the gift bag. It's not as fancy as you're used to, but it'll get the job done.

You strip off the remains of your wedding gown and discard them in a pile of rubble.

>remove bag
You remove the gift bag, folding it carefully.

>i
You are carrying a paper bag.

>x me
You are still the loveliest princess in the land.

You are stark naked, save for a tarnished gold crown.

>wear bag
You slip the makeshift dress over your head and pull it down past your hips.

>remove bag
You remove the gift bag, folding it carefully.

>n
You can't go anywhere dressed like that!

* * *

>drop bouquet
Dropped.

Please press SPACE to continue.

>s
You can't go that way.

>n
NOPE.

>up
You can't go that way.

>down
You can't go that way.

* * *

>n
NOPE.

>e
You can't go that way.

* * *

>w
You can't go that way.

>e
You can't go that way.

>n
NOPE.

>search rubble.wear bag
You find a paper bag.

You quickly fashion a dress out of the gift bag. It's not as fancy as you're used to, but it'll get the job done.

You strip off the remains of your wedding gown and discard them in a pile of rubble.

You put on the paper bag.

>e
You can't go that way.

* * *

>w
You can't go that way.

>n
First Forest

>n
You can't go that way.

>e
You can't go that way.

* * *

>w
You can't go that way.

>s
You don't know which way to go!

>s
You don't know which way to go!

>e
You can't go that way.

* * *

>drop bouquet
Dropped.

Please press SPACE to continue.

The Paper Bag Princess
An interactive fairy tale by Adri
Release 1 / Serial number 130819 / Inform 7 build 6G60 (I6/v6.32 lib 6/12N) SD

Castle Ruins
No more castle. pile of rubble

The Paper Bag Princess
An interactive fairy tale by Adri
Release 1 / Serial number 130819 / Inform 7 build 6G60 (I6/v6.32 lib 6/12N) SD

Castle Ruins
No more castle. pile of rubble

>drop bouquet
You can't see any such thing.

>restart
Are you sure you want to restart?

* * *

>y
The Paper Bag Princess
An interactive fairy tale by Adri
Release 1 / Serial number 130819 / Inform 7 build 6G60 (I6/v6.32 lib 6/12N) SD

Throne Room
This is it. You're finally getting married!

Your betrothed, Roland, stands before you.

>drop bouquet
Dropped.

Please press SPACE to continue.

* * *

The Paper Bag Princess
An interactive fairy tale by Adri
Release 1 / Serial number 130819 / Inform 7 build 6G60 (I6/v6.32 lib 6/12N) SD

Castle Ruins
No more castle. pile of rubble

>search rubble.wear bag
You find a paper bag.

(first taking the paper bag)
You quickly fashion a dress out of the gift bag. It's not as fancy as you're used to, but it'll get the job done.

You strip off the remains of your wedding gown and discard them in a pile of rubble.

>e
You can't go that way.

>n
First Forest
There's a trail of burned trees and horses' teeth leading to the northeast.

* * *

>ne
Cave Exterior

>knock
(the Cave Door)
You knock on the Cave Door.

>knock on me
You give yourself a gentle rap.

Violence isn't the answer to this one.

>knock on crown
You give the tarnished gold crown a gentle rap.

* * *

>search rubble.wear bag.n.ne
You find a paper bag.

(first taking the paper bag)
You quickly fashion a dress out of the gift bag. It's not as fancy as you're used to, but it'll get the job done.

You strip off the remains of your wedding gown and discard them in a pile of rubble.

First Forest
There's a trail of burned trees and horses' teeth leading to the northeast.

Cave Exterior

>knock on me
Violence isn't the answer to this one.

* * *

>search rubble.wear bag.n.ne
You find a paper bag.

(first taking the paper bag)
You quickly fashion a dress out of the gift bag. It's not as fancy as you're used to, but it'll get the job done.

You strip off the remains of your wedding gown and discard them in a pile of rubble.

First Forest
There's a trail of burned trees and horses' teeth leading to the northeast.

Cave Exterior

>l
Cave Exterior
You can see a dragon here.

>x dragon
You can't see any such thing.

>knock on door
You knock on the Cave Door.

The dragon opens the door and tells you to beat it.

>l
Cave Exterior

>x dragon
You can't see any such thing.

* * *

>l
Cave Exterior
You can see a dragon here.

>talk to dragon
That's not a verb I recognize.

>ask dragon about fire
---

>tell dragon about fire
This provokes no reaction.

* * *

This is the day you've always dreamed of. You are finally marrying the love of your life, Prince Roland.

Castle Garden
You are standing in the garden behind your family's castle. On this lovely fall evening, it is doing double duty as a wedding chapel.

Your betrothed, Roland, stands before you.

You can also see Father Alfred here.

>drop bouquet.search rubble
Dropped.

The Paper Bag Princess
An interactive fairy tale by Adri
Release 1 / Serial number 130818 / Inform 7 build 6G60 (I6/v6.32 lib 6/12N) SD

Castle Ruins
No more castle. pile of rubble

You find a paper bag.

>wear bag
(first taking the paper bag)
You already have that.
You quickly fashion a dress out of the gift bag. It's not as fancy as you're used to, but it'll get the job done.

You strip off the remains of your wedding gown and discard them in a pile of rubble.

>i
You are carrying nothing.

>x me
You are still the loveliest princess in the land.

You are wearing a tarnished gold crown and the tattered remains of your wedding gown. It doesn't leave very much to the imagination.
a gift bag that has been fashioned into a rather respectable dress.

* * *

This is the day you've always dreamed of. You are finally marrying the love of your life, Prince Roland.

Castle Garden
You are standing in the garden behind your family's castle. On this lovely fall evening, it is doing double duty as a wedding chapel.

Your betrothed, Roland, stands before you.

You can also see Father Alfred here.

>drop bouquet.search rubble.wear bag
Dropped.

The Paper Bag Princess
An interactive fairy tale by Adri
Release 1 / Serial number 130818 / Inform 7 build 6G60 (I6/v6.32 lib 6/12N) SD

Castle Ruins
No more castle. pile of rubble

You find a paper bag.

You quickly fashion a dress out of the gift bag. It's not as fancy as you're used to, but it'll get the job done.

You strip off the remains of your wedding gown and discard them in a pile of rubble.

You slip the makeshift dress over your head and pull it down past your hips.

You slip the makeshift dress over your head and pull it down past your hips.

>restart
Are you sure you want to restart?

>y
The Paper Bag Princess
An interactive fairy tale by Adri
Release 1 / Serial number 130818 / Inform 7 build 6G60 (I6/v6.32 lib 6/12N) SD

Throne Room
This is it. You're finally getting married!

Your betrothed, Roland, stands before you.

>drop bouquet.search rubble.remove dress.wear bag.
Dropped.

The Paper Bag Princess
An interactive fairy tale by Adri
Release 1 / Serial number 130818 / Inform 7 build 6G60 (I6/v6.32 lib 6/12N) SD

Castle Ruins
No more castle. pile of rubble

You find a gift bag.

You strip off the remains of your wedding gown and discard them in a pile of rubble.

You quickly fashion a dress out of the gift bag. It's not as fancy as you're used to, but it'll get the job done.

You put on the gift bag.

* * *

>remove bag
You take off the gift bag.

>wear bag
You put on the gift bag.

* * *

This is the day you've always dreamed of. You are finally marrying the love of your life, Prince Roland.

Castle Garden
You are standing in the garden behind your family's castle. On this lovely fall evening, it is doing double duty as a wedding chapel.

Your betrothed, Roland, stands before you.

You can also see Father Alfred here.

>drop bouquet.take bag
Dropped.

The Paper Bag Princess
An interactive fairy tale by Adri
Release 1 / Serial number 130818 / Inform 7 build 6G60 (I6/v6.32 lib 6/12N) SD

Castle Ruins
No more castle. pile of rubble

You can't see any such thing.

>search rubble.take bag
You find a gift bag.

Taken.

>wear bag
You already have that.
You quickly fashion a dress out of the gift bag. It's not as fancy as you're used to, but it'll get the job done.(first taking the handful of rags off)
You strip off the remains of your wedding gown and discard them in a pile of rubble.

Dropped.

You put on the gift bag.

* * *

This is the day you've always dreamed of. You are finally marrying the love of your life, Prince Roland.

Castle Garden
You are standing in the garden behind your family's castle. On this lovely fall evening, it is doing double duty as a wedding chapel.

Your betrothed, Roland, stands before you.

You can also see Father Alfred here.

>drop bouquet.search rubble.wear bag.
Dropped.

The Paper Bag Princess
An interactive fairy tale by Adri
Release 1 / Serial number 130818 / Inform 7 build 6G60 (I6/v6.32 lib 6/12N) SD

Castle Ruins
No more castle. pile of rubble

You find a gift bag.

You quickly fashion a dress out of the gift bag. It's not as fancy as you're used to, but it'll get the job done.

You strip off the remains of your wedding gown and discard them in a pile of rubble.

You put on the gift bag.

>x bag
You see nothing special about the gift bag.

>x me
You are still the loveliest princess in the land.

You are wearing a tarnished gold crown and a gift bag that has been fashioned into a rather respectable dress.

* * *

This is the day you've always dreamed of. You are finally marrying the love of your life, Prince Roland.

Castle Garden
You are standing in the garden behind your family's castle. On this lovely fall evening, it is doing double duty as a wedding chapel.

Your betrothed, Roland, stands before you.

You can also see Father Alfred here.

>drop bouquet.search rubble.x bag
Dropped.

The Paper Bag Princess
An interactive fairy tale by Adri
Release 1 / Serial number 130818 / Inform 7 build 6G60 (I6/v6.32 lib 6/12N) SD

Castle Ruins
No more castle. pile of rubble

You find a paper bag.

It's a gift bag made out of paper. It looks like it used to have polka dots on it, but now it's just scorched.

>wear bag
You quickly fashion a dress out of the gift bag. It's not as fancy as you're used to, but it'll get the job done.

You strip off the remains of your wedding gown and discard them in a pile of rubble.

You put on the paper bag.

>x bag
It's a gift bag made out of paper. It looks like it used to have polka dots on it, but now it's just scorched. It has been fashioned into a crude dress.

>remove bag
You take off the paper bag.

>x bag
It's a gift bag made out of paper. It looks like it used to have polka dots on it, but now it's just scorched. It has been fashioned into a crude dress.

>x me
You are still the loveliest princess in the land.

You are stark naked, save for a tarnished gold crown.

* * *

This is the day you've always dreamed of. You are finally marrying the love of your life, Prince Roland.

Castle Garden
You are standing in the garden behind your family's castle. On this lovely fall evening, it is doing double duty as a wedding chapel.

Your betrothed, Roland, stands before you.

You can also see Father Alfred here.

>drop bouqet
You can't see any such thing.

>drop bouquet
Dropped.

The Paper Bag Princess
An interactive fairy tale by Adri
Release 1 / Serial number 130818 / Inform 7 build 6G60 (I6/v6.32 lib 6/12N) SD

Castle Ruins
No more castle. pile of rubble

>e
You don't know which way to go!

>n
NOPE.

* * *

This is the day you've always dreamed of. You are finally marrying the love of your life, Prince Roland.

Castle Garden
You are standing in the garden behind your family's castle. On this lovely fall evening, it is doing double duty as a wedding chapel.

Your betrothed, Roland, stands before you.

You can also see Father Alfred here.

>drop bouquet.search rubble.wear dress.n
Dropped.

The Paper Bag Princess
An interactive fairy tale by Adri
Release 1 / Serial number 130818 / Inform 7 build 6G60 (I6/v6.32 lib 6/12N) SD

Castle Ruins
No more castle. pile of rubble

You find a paper bag.

You're already wearing that!

You can't go anywhere dressed like that!

>wear bag
You quickly fashion a dress out of the gift bag. It's not as fancy as you're used to, but it'll get the job done.

You strip off the remains of your wedding gown and discard them in a pile of rubble.

You put on the paper bag.

>n
First Forest

>e
You don't know which way to go!

>w
You don't know which way to go!

>s
You don't know which way to go!

>n
You don't know which way to go!

* * *

>drop bouquet.search rubble.wear dress.n
Dropped.

The Paper Bag Princess
An interactive fairy tale by Adri
Release 1 / Serial number 130818 / Inform 7 build 6G60 (I6/v6.32 lib 6/12N) SD

Castle Ruins
No more castle. pile of rubble

You find a paper bag.

You're already wearing that!

You can't go anywhere dressed like that!

>wear bag.n
You quickly fashion a dress out of the gift bag. It's not as fancy as you're used to, but it'll get the job done.

You strip off the remains of your wedding gown and discard them in a pile of rubble.

You put on the paper bag.

First Forest

>n
You'll have to say which compass direction to go in.

>s
You don't know which way to go!

>e
You'll have to say which compass direction to go in.

>n
You'll have to say which compass direction to go in.

* * *

This is the day you've always dreamed of. You are finally marrying the love of your life, Prince Roland.

Castle Garden
You are standing in the garden behind your family's castle. On this lovely fall evening, it is doing double duty as a wedding chapel.

Your betrothed, Roland, stands before you.

You can also see Father Alfred here.

>drop bouquet.search rubble.wear bag.n
Dropped.

The Paper Bag Princess
An interactive fairy tale by Adri
Release 1 / Serial number 130818 / Inform 7 build 6G60 (I6/v6.32 lib 6/12N) SD

Castle Ruins
No more castle. pile of rubble

You find a paper bag.

You quickly fashion a dress out of the gift bag. It's not as fancy as you're used to, but it'll get the job done.

You strip off the remains of your wedding gown and discard them in a pile of rubble.

You put on the paper bag.

First Forest

* * *

This is the day you've always dreamed of. You are finally marrying the love of your life, Prince Roland.

Castle Garden
You are standing in the garden behind your family's castle. On this lovely fall evening, it is doing double duty as a wedding chapel.

Your betrothed, Roland, stands before you.

You can also see Father Alfred here.

>drop bouquet.search rubble.take bag
Dropped.

The Paper Bag Princess
An interactive fairy tale by Adri
Release 1 / Serial number 130818 / Inform 7 build 6G60 (I6/v6.32 lib 6/12N) SD

Castle Ruins
No more castle. pile of rubble

You find a paper bag.

Taken.

>wear bag
You already have that.
You quickly fashion a dress out of the gift bag. It's not as fancy as you're used to, but it'll get the job done.

You strip off the remains of your wedding gown and discard them in a pile of rubble.

You slip the makeshift dress over your head and pull it down past your hips.

You put on the paper bag.

>remove bag
You remove the gift bag, folding it carefully.

You take off the paper bag.

>wear bag
You slip the makeshift dress over your head and pull it down past your hips.

You put on the paper bag.

* * *

This is the day you've always dreamed of. You are finally marrying the love of your life, Prince Roland.

Castle Garden
You are standing in the garden behind your family's castle. On this lovely fall evening, it is doing double duty as a wedding chapel.

Your betrothed, Roland, stands before you.

You can also see Father Alfred here.

>drop bouquet.search rubble.wear bag.e
Dropped.

Please press SPACE to continue.

The Paper Bag Princess
An interactive fairy tale by Adri
Release 1 / Serial number 130819 / Inform 7 build 6G60 (I6/v6.32 lib 6/12N) SD

Castle Ruins
No more castle. pile of rubble

You find a paper bag.

(first taking the paper bag)
You quickly fashion a dress out of the gift bag. It's not as fancy as you're used to, but it'll get the job done.

You strip off the remains of your wedding gown and discard them in a pile of rubble.

You can't go that way.

>n
First Forest
There's a trail of burned trees and horses" teeth leading to the northeast.

* * *

This is the day you've always dreamed of. You are finally marrying the love of your life, Prince Roland.

Castle Garden
You are standing in the garden behind your family's castle. On this lovely fall evening, it is doing double duty as a wedding chapel.

Your betrothed, Roland, stands before you.

You can also see Father Alfred here.

I beg your pardon?

>z
You beam happily at Roland.

---

* * *

This is the day you've always dreamed of. You are finally marrying the love of your life, Prince Roland.

Castle Garden
You are standing in the garden behind your family's castle. On this lovely fall evening, it is doing double duty as a wedding chapel.

Your betrothed, Roland, stands before you.

You can also see Father Alfred here.

>help
 > About "The Paper Bag Princess"
   How to Play
   Credits

Princess Elizabeth is slated to marry Prince Ronald when a dragon attacks the castle and kidnaps Ronald.

The author can be contacted at <genericgeekgirl@gmail.com>.

Please press SPACE to continue.

 > About "The Paper Bag Princess"
   How to Play
   Credits
 > About "The Paper Bag Princess"
   How to Play
   Credits

   About "The Paper Bag Princess"
 > How to Play
   Credits
   About "The Paper Bag Princess"
 > How to Play
   Credits

 > About Interactive Fiction
   What to do with >
   Getting Started
   Rooms and Travel
   Objects
   Controlling the Game
   How the World is Assembled
   If You Get Stuck

>q
   About "The Paper Bag Princess"
 > How to Play
   Credits

   About "The Paper Bag Princess"
   How to Play
 > Credits
   About "The Paper Bag Princess"
   How to Play
 > Credits

CREDITS

Please press SPACE to continue.

* * *

   About "The Paper Bag Princess"
   How to Play
 > Credits
   About "The Paper Bag Princess"
   How to Play
 > Credits

>q
Throne Room
This is it. You're finally getting married!

Your betrothed, Roland, stands before you.

* * *

This is the day you've always dreamed of. You are finally marrying the love of your life, Prince Roland.

Castle Garden
You are standing in the garden behind your family's castle. On this lovely fall evening, it is doing double duty as a wedding chapel.

Your betrothed, Roland, stands before you.

You can also see Father Alfred here.

>wefwf...
That's not a verb I recognize.

>talk to roland
Roland shakes his head and puts a finger up to his lips.

---

>talk to me
...

...

>talk to priest
The priest does not respond.

,,,,

DRAGON!

Please press SPACE to continue.

The Paper Bag Princess
An interactive fairy tale by Adri
Release 1 / Serial number 130819 / Inform 7 build 6G60 (I6/v6.32 lib 6/12N) SD

Castle Ruins
No more castle. pile of rubble

* * *

This is the day you've always dreamed of. You are finally marrying the love of your life, Prince Roland.

Castle Garden
You are standing in the garden behind your family's castle. On this lovely fall evening, it is doing double duty as a wedding chapel.

Your betrothed, Roland, stands before you.

You can also see Father Alfred here.

>hello, roland
(roland, hello)
Roland shakes his head and puts a finger up to his lips.

---

>roland, hello
Roland shakes his head and puts a finger up to his lips.

...

>roland, foo
Roland shakes his head and puts a finger up to his lips.

,,,,

DRAGON!

Please press SPACE to continue.

* * *

This is the day you've always dreamed of. You are finally marrying the love of your life, Prince Roland.

Castle Garden
You are standing in the garden behind your family's castle. On this lovely fall evening, it is doing double duty as a wedding chapel.

Your betrothed, Roland, stands before you.

You can also see Father Alfred here.

>z.z.z.z
You beam happily at Roland.

Father Alfred begins the ceremony, "We are gathered here today to witness the joining of two hearts." Roland smiles shyly at you.

You beam happily at Roland.

"If anyone has a reason why these two should not be wed, speak now or forever hold your peace." You hold your breath for a second, wondering whether anyone will speak up. Fortunately, nobody does and you relax.

You beam happily at Roland.

"Who gives this woman--" You glare icily at the minister. You are nobody's property. "Ahem. Moving on," says the minister, visibly flustered. Roland looks at you questioningly, but says nothing.

You beam happily at Roland.

"Love is a wonderful thing." And so on. You're too excited to pay attention to every word.

The Paper Bag Princess
An interactive fairy tale by Adri
Release 1 / Serial number 130916 / Inform 7 build 6G60 (I6/v6.32 lib 6/12N) SD

Castle Ruins
No more castle. pile of rubble

Time passes.

>search rubble.wear bag.n.ne
You find a paper bag.

(first taking the paper bag)
You quickly fashion a dress out of the gift bag. It's not as fancy as you're used to, but it'll get the job done.

You strip off the remains of your wedding gown and discard them in a pile of rubble.

First Forest
There's a trail of burned trees and horses' teeth leading to the northeast.

Cave Exterior

>x dragon
You can't see any such thing.

>e
(first opening the Cave Door)
It seems to be locked.

>e
(first opening the Cave Door)
It seems to be locked.

>l
Cave Exterior

>knock
(the Cave Door)
You knock on the Cave Door.

The dragon opens the door and tells you to beat it.

>e
(first opening the Cave Door)
It seems to be locked.

>knock
(the Cave Door)
You knock on the Cave Door.

>ask about flight.g.g.g.g
(addressing the dragon)
The Dragon something or other.

>ask about flight
---

>g
---

* * *

>g
The dragon is fast asleep. You shouldn't wake it up.

>e
(first opening the Cave Door)
The dragon is fast asleep. You shouldn't wake it up.

Cave Interior
Your betrothed, Roland, stands before you.

>talk to roland
Roland shakes his head and puts a finger up to his lips.

* * *

The Paper Bag Princess
An interactive fairy tale by Adri
Release 1 / Serial number 130916 / Inform 7 build 6G60 (I6/v6.32 lib 6/12N) SD

Castle Ruins
No more castle. pile of rubble

Time passes.

>search rubble.wear bag.n.ne.knock
You find a paper bag.

(first taking the paper bag)
You quickly fashion a dress out of the gift bag. It's not as fancy as you're used to, but it'll get the job done.

You strip off the remains of your wedding gown and discard them in a pile of rubble.

First Forest
There's a trail of burned trees and horses' teeth leading to the northeast.

Cave Exterior
You can see now the dragon here.

(the Cave Door)
You grab the knocker and bang on the door.

"Well, a princess! I love to eat princesses, but I have already eaten a whole castle today. I am a very busy dragon. Come back tomorrow."
 Then he slams the door.

>ask about fire
(addressing the dragon)
---

>g
---

>g
...

>ask about flying
---

* * *

>g
...

>g
...

>ask about fire
...

* * *

>ask about flight
(addressing the dragon)
first

>g
second

>g
third

>g
done

>g
done

* * *

The Paper Bag Princess
An interactive fairy tale by Adri
Release 1 / Serial number 130916 / Inform 7 build 6G60 (I6/v6.32 lib 6/12N) SD

Castle Ruins
No more castle. pile of rubble

Time passes.

>n.ne
Burnt Forest
There's a trail of burned trees and horses' teeth leading to the northeast.

Burnt Forest
Something something something.

>n.n.n.n.n.n
Burnt Forest
Something something something.

Burnt Forest
Something something something.

Burnt Forest
Something something something.

Burnt Forest
Something something something.

Burnt Forest
Something something something.

Burnt Forest
Something something something.

>n
Burnt Forest
Something something something.

>n
Burnt Forest
Something something something.

>n
Cave Exterior

>knock
(the Cave Door)
You grab the knocker and bang on the door.

The dragon sticks his nose out the door and says, "Well, a princess! I love to eat princesses, but I have already eaten a whole castle today. I am a very busy dragon. Come back tomorrow."

Then he slams the door.

>knock again
You must supply a noun.

* * *

The Paper Bag Princess
An interactive fairy tale by Adri
Release 1 / Serial number 130916 / Inform 7 build 6G60 (I6/v6.32 lib 6/12N) SD

Castle Ruins
No more castle. pile of rubble

Time passes.

>n.ne.n.n.n.n.n.n.n.n
Burnt Forest
There's a trail of burned trees and horses' teeth leading to the northeast.

Burnt Forest
Something something something.

Burnt Forest
Something something something.

Burnt Forest
Something something something.

Burnt Forest
Something something something.

Burnt Forest
Something something something.

Burnt Forest
Something something something.

Burnt Forest
Something something something.

Burnt Forest
Something something something.

Cave Exterior

>knock
(the Cave Door)
You grab the knocker and bang on the door.

The dragon sticks his nose out the door and says, "Well, a princess! I love to eat princesses, but I have already eaten a whole castle today. I am a very busy dragon. Come back tomorrow."

Then he slams the door.

>knock again
You grab the knocker and bang on the door again.

The dragon sticks his nose out the door and says, "Well, a princess! I love to eat princesses, but I have already eaten a whole castle today. I am a very busy dragon. Come back tomorrow."

This time he pauses a moment before slamming the door.

>shout
You shout at the dragon.

lalalalalala

>talk to dragon
You say, "Is it true that you are the smartest and fiercest dragon in the whole world?"

"Yes", says the dragon. Boastful fellow, isn't he?

I beg your pardon?

* * *

The Paper Bag Princess
An interactive fairy tale by Adri
Release 1 / Serial number 130916 / Inform 7 build 6G60 (I6/v6.32 lib 6/12N) SD

Castle Ruins
No more castle. pile of rubble

Time passes.

>n.ne.n.n.n.n.n.n.n.n.n
Burnt Forest
There's a trail of burned trees and horses' teeth leading to the northeast.

Burnt Forest
Something something something.

Burnt Forest
Something something something.

Burnt Forest
Something something something.

Burnt Forest
Something something something.

Burnt Forest
Something something something.

Burnt Forest
Something something something.

Cave Exterior
You can't go that way.

You can't go that way.

You can't go that way.

>knock
(the Cave Door)
You grab the knocker and bang on the door.

The dragon sticks his nose out the door and says, "Well, a princess! I love to eat princesses, but I have already eaten a whole castle today. I am a very busy dragon. Come back tomorrow."
Then he slams the door.

>knock
(the Cave Door)
You grab the knocker and bang on the door again.

The dragon sticks his nose out the door and says, "Well, a princess! I love to eat princesses, but I have already eaten a whole castle today. I am a very busy dragon. Come back tomorrow."
This time he pauses a moment before slamming the door.

>shout
The dragon slams the door in your face.

>undo
Cave Exterior
[Previous turn undone.]

* * *

>y
Of course you do! But just as you're about to say so, you're interrupted by a cry of "Dragon!!!!".

DRAGON!

Please press SPACE to continue.

I beg your pardon?

* * *

>y
Of course you do! But just as you're about to say so, you're interrupted by a cry of "Dragon!!!!".

DRAGON!

Please press SPACE to continue.

The Paper Bag Princess
An interactive fairy tale by Adri
Release 1 / Serial number 130926 / Inform 7 build 6G60 (I6/v6.32 lib 6/12N) SD

Castle Ruins
No more castle. pile of rubble the embers

* * *

>n
You shake your head. "No. I don't."

Oh. There's a pause, and then the guests begin to murmur. Roland just stares at you in shock. The minister frowns. "Elizabeth, are you sure?" he asks.

>y
You whisper, "I'm so sorry," and run off.

    *** Rocks fall. Everyone dies. ***

Would you like to RESTART, RESTORE a saved game, QUIT, or UNDO the last command?

>undo
Throne Room
[Previous turn undone.]

>y
(addressing Roland)
Roland shakes his head and puts a finger up to his lips.

"We are gathered here today to witness the joining of two hearts."

>z.z.z.z
You beam happily at Roland.

"Speak now or forever hold your peace."

You hold your breath for a second, wondering whether anyone will speak up. Nobody does. You visibly relax.

You beam happily at Roland.

"Who gives this woman--"

You glare icily at the minister. "Ahem. Moving on.." Roland furrows his brow, but says nothing.

You beam happily at Roland.

And so on. You're not really paying attention to the whole thing.

"Elizabeth, do you take Roland to be your husband blah blah blah."

>n
You shake your head. "No. I don't."

Oh. There's a pause, and then the guests begin to murmur. Roland just stares at you in shock. The minister frowns. "Elizabeth, are you sure?" he asks.

>n
You shake your head and smile. "I'm sorry", you say. "I panicked for a moment. Of course I--."

DRAGON!

Please press SPACE to continue.

* * *

>z
You beam happily at Roland.

"Elizabeth, do you take Roland to be your husband?"

>yes
Of course you do!

The minister smiles at you and turns to Roland. "And, Roland, do you take Elizabeth to be your wife?"

Roland grins at you and exclaims, "I do!".

"I now pronounce you man and... dragon?!?" The minister's eyes go wide, seconds before he is incinerated by a burst of flame.

A large dragon flies overhead. The wedding guests scatter in every direction. You cower against Roland, but he pushes you towards the dragon and runs towards the road.

The dragon eats all the guests it can catch, and when it has had its fill, it smashes your castle to smithereens with its heavy tail and sets the remains on fire. You are nearly caught in a blaze of flame as you duck behind what used to be the stone wall of the garden. You are unhurt, but your fine gown snags on a rose bush and tears.

As the dragon finally turns to go, it catches sight of Roland, running down the road towards the river. It swoops down and smashes the bridge just as Roland is about to cross it and catches him up in its claws. The dragon flies away with your beloved prince.

Please press SPACE to continue.

The Paper Bag Princess
An interactive fairy tale by Adri
Release 1 / Serial number 130928 / Inform 7 build 6G60 (I6/v6.32 lib 6/12N) SD

Castle Ruins
This used to be your home. Now it is nothing more than a smoking pile of rubble. The smoke obscures your view of the stars, and the primary source of light is the burning remains of your furniture.

The only road away from the castle now ends abruptly at the river bank. The forest surrounds you thickly on all sides, except for an area to the north where the trees have been broken and scorched.

>xyzzy.x vial.open vial.x vial
POOF! Your fairy godmother appears. "Tsk," she says. "Poor girl. I'm not sure I can help you with this one." She pauses and rummages around in her pockets, pulling out a vial. She hands it to you. "This is the best I can do. Use it wisely." Then she vanishes, as quickly as she appeared.

It's a vial, containing a dark liquid.

You open the vial, revealing an oily black liquid.

In the vial is an oily black liquid.

>x liquid
A thick, black liquid that appears to be oil.

>remove rags.pour oil on vial
You strip off the remains of your wedding gown.

There isn't very much in the bottle. You shouldn't waste it.

>pour oil on rags
You pour the oily black liquid onto the handful of rags and discard the empty vial

>x vial
You can't see any such thing.

>l
Castle Ruins
This used to be your home. Now it is nothing more than a smoking pile of rubble. The smoke obscures your view of the stars, and the primary source of light is the burning remains of your furniture.

The only road away from the castle now ends abruptly at the river bank. The forest surrounds you thickly on all sides, except for an area to the north where the trees have been broken and scorched.

>x rubble
These piles of brick and wood used to be your home.

* * *

The Paper Bag Princess
An interactive fairy tale by Adri
Release 1 / Serial number 130928 / Inform 7 build 6G60 (I6/v6.32 lib 6/12N) SD

Castle Ruins
This used to be your home. Now it is nothing more than a smoking pile of rubble. The smoke obscures your view of the stars, and the primary source of light is the burning remains of your furniture.

The only road away from the castle now ends abruptly at the river bank. The forest surrounds you thickly on all sides, except for an area to the north where the trees have been broken and scorched.

>x rubble
These piles of brick and wood used to be your home. You catch a glimpse of something colorful hidden in one of the piles.

>take glimpse
You dig through the piles of rubble until you find a paper bag.

>dig
That's not a verb I recognize.

* * *

The Paper Bag Princess
An interactive fairy tale by Adri
Release 1 / Serial number 130928 / Inform 7 build 6G60 (I6/v6.32 lib 6/12N) SD

Castle Ruins
This used to be your home. Now it is nothing more than a smoking pile of rubble. The smoke obscures your view of the stars, and the primary source of light is the burning remains of your furniture.

The only road away from the castle now ends abruptly at the river bank. The forest surrounds you thickly on all sides, except for an area to the north where the trees have been broken and scorched.

>restart
Are you sure you want to restart?

* * *

The Paper Bag Princess
An interactive fairy tale by Adri
Release 1 / Serial number 130928 / Inform 7 build 6G60 (I6/v6.32 lib 6/12N) SD

Castle Ruins
This used to be your home. Now it is nothing more than a smoking pile of rubble. The smoke obscures your view of the stars, and the primary source of light is the burning remains of your furniture.

The only road away from the castle now ends abruptly at the river bank. The forest surrounds you thickly on all sides, except for an area to the north where the trees have been broken and scorched.

>xyzzy.x vial.open vial.x vial
POOF! Your fairy godmother appears. "Tsk," she says. "Poor girl. I'm not sure I can help you with this one." She pauses and rummages around in her pockets, pulling out a vial. She hands it to you. "This is the best I can do. Use it wisely." Then she vanishes, as quickly as she appeared.

It's a vial, containing a dark liquid.

You open the vial, revealing an oily black liquid.

It's an open vial.

In the vial is an oily black liquid.

>i
You are carrying a vial.

* * *

>yes
You need to specify who you want to speak to.

* * *

>z.z.z
You beam happily at Roland.

"Elizabeth, do you take Roland to be your husband?"

The minister is waiting for your answer. Please say "yes" or "no".

The minister is waiting for your answer. Please say "yes" or "no".

>yes
Of course you do!

The minister smiles at you and turns to Roland. "And, Roland, do you take Elizabeth to be your wife?"

Roland grins at you and exclaims, "I do!".

"I now pronounce you man and... dragon?!?" The minister's eyes go wide, seconds before he is incinerated by a burst of flame.

A large dragon flies overhead. The wedding guests scatter in every direction. You cower against Roland, but he pushes you towards the dragon and runs towards the road.

The dragon eats all the guests it can catch, and when it has had its fill, it smashes your castle to smithereens with its heavy tail and sets the remains on fire. You are nearly caught in a blaze of flame as you duck behind what used to be the stone wall of the garden. You are unhurt, but your fine gown snags on a rose bush and tears.

As the dragon finally turns to go, it catches sight of Roland, running down the road towards the river. It swoops down and smashes the bridge just as Roland is about to cross it and catches him up in its claws. The dragon flies away with your beloved prince.

Please press SPACE to continue.

* * *

The Paper Bag Princess
An interactive fairy tale by Adri
Release 1 / Serial number 130928 / Inform 7 build 6G60 (I6/v6.32 lib 6/12N) SD

Castle Ruins
This used to be your home. Now it is nothing more than a smoking pile of rubble. The smoke obscures your view of the stars, and the primary source of light is the burning remains of your furniture.

The only road away from the castle now ends abruptly at the river bank. The forest surrounds you thickly on all sides, except for an area to the north where the trees have been broken and scorched.

>xyzzy.put vial on rags
POOF! Your fairy godmother appears. "Tsk," she says. "Poor girl. I'm not sure I can help you with this one." She pauses and rummages around in her pockets, pulling out a vial. She hands it to you. "This is the best I can do. Use it wisely." Then she vanishes, as quickly as she appeared.

The vial isn't open.

* * *

This is the day you've always dreamed of. You are finally marrying the love of your life, Prince Roland.

Castle Garden
You are standing in the garden behind your family's castle. On this lovely fall evening, it is doing double duty as a wedding chapel.

Your betrothed, Roland, stands before you.

You can also see Father Alfred here.

>z.z.z
You beam happily at Roland.

"We are gathered here today to witness the joining of two hearts."

You beam happily at Roland.

"Speak now or forever hold your peace."

You hold your breath for a second, wondering whether anyone will speak up. Nobody does. You visibly relax.

You beam happily at Roland.

"Who gives this woman--"

You glare icily at the minister. You are nobody's property. "Ahem. Moving on.." Roland furrows his brow, but says nothing.

The Paper Bag Princess
An interactive fairy tale by Adri
Release 1 / Serial number 130921 / Inform 7 build 6G60 (I6/v6.32 lib 6/12N) SD

Castle Ruins
No more castle. pile of rubble flame

>search rubble.wear bag.n.ne.knock
You find a paper bag.

(first taking the paper bag)
You quickly fashion a dress out of the gift bag. It's not as fancy as you're used to, but it'll get the job done.

You strip off the remains of your wedding gown and discard them in a pile of rubble.

First Forest
There's a trail of burned trees and horses' teeth leading to the northeast.

Cave Exterior
(the Cave Door)
You grab the knocker and bang on the door.

The dragon sticks his nose out the door and says, "Well, a princess! I love to eat princesses, but I have already eaten a whole castle today. I am a very busy dragon. Come back tomorrow."

Then he slams the door.

>ask about flight
(addressing the dragon)
first

* * *

>g
done

>ask about fire
first

The dragon falls asleep.

>g
The dragon is fast asleep. You shouldn't wake it up.

* * *

>ask about fire
(addressing the dragon)
first

>g
second

* * *

>g
done

>ask about flying
first

>g
second

>g
third

The dragon falls asleep.

* * *

>ask about roland
(addressing the dragon)
The Dragon says, "I don't know anything about that."

* * *

>ask dragon about fire
"Is it true," you say, "that you can burn up ten forests with your fiery breath?"

"Oh, yes", says the dragon, and he takes a huge, deep breath and breathes out so much fire that he burns up fifty forests.

Were you impressed by that display?

>n
Secretly, you were deeply impressed, but you just shrug. "Eh", you say.

"Fantastic," you say, and the dragon takes another huge breath and breathes out so much fire that he burns up one hundred forests.

Were you impressed by that display?

>y
"Fantastic," you say.

"Magnificent," you say, and the dragon takes another huge breath. But this time, nothing comes out.

* * *

>knock
(the Cave Door)
You grab the knocker and bang on the door again.

The dragon sticks his nose out the door and says, "Well, a princess! I love to eat princesses, but I have already eaten a whole castle today. I am a very busy dragon. Come back tomorrow."

This time he pauses a moment before slamming the door.

>ask dragon about dragon
The dragon says, "I don't know anything about that."

>ask dragon about himself
There is no reply.

>ask dragon about itself
The dragon says, "I don't know anything about that."

>hello, dragon
(dragon, hello)
There is no reply.

>dragon, hello
There is no reply.

>talk to dragon
There is no reply.

* * *

>knock
(the Cave Door)
You grab the knocker and bang on the door again.

The dragon sticks his nose out the door and says, "Well, a princess! I love to eat princesses, but I have already eaten a whole castle today. I am a very busy dragon. Come back tomorrow."

This time he pauses a moment before slamming the door.

>talk to dragon
There is no reply.

>ask dragon about fire
"Is it true," you say, "that you can burn up ten forests with your fiery breath?"

"Oh, yes", says the dragon, and he takes a huge, deep breath and breathes out so much fire that he burns up fifty forests.

Were you impressed by that display?

>n
You shake your head in disappointment.

The dragon takes another huge breath and breathes out so much fire that he burns up one hundred forests.

Wasn't that amazing?

* * *

The Paper Bag Princess
An interactive fairy tale by Adri
Release 1 / Serial number 130921 / Inform 7 build 6G60 (I6/v6.32 lib 6/12N) SD

Castle Ruins
No more castle. pile of rubble flame

>search rubble.take bag.n.ne.knock
You find a paper bag.

Taken.

You can't go anywhere dressed like that!

You can't go that way.

What do you want to knock?

>wear bag.n.ne.knock
You quickly fashion a dress out of the gift bag. It's not as fancy as you're used to, but it'll get the job done.

You strip off the remains of your wedding gown and discard them in a pile of rubble.

First Forest
There's a trail of burned trees and horses' teeth leading to the northeast.

Cave Exterior
(the Cave Door)
You knock on the Cave Door.

The dragon opens the door and tells you to beat it.

>ask about roland
(addressing the dragon)
Blah.

>ask about me
Princess.

>ask about dragon
The Dragon says, "I don't know anything about that."

>ask about foo
The Dragon says, "I don't know anything about that."

>ask about flight
"Is it true," you say, "that you can burn up ten forests with your fiery breath?"

"Oh, yes", says the dragon, and he takes a huge, deep breath and breathes out so much fire that he burns up fifty forests.

>g
"Fantastic," you say, and the dragon takes another huge breath and breathes out so much fire that he burns up one hundred forests.

>g
"Magnificent," you say, and the dragon takes another huge breath. But this time, nothing comes out.

>g
The dragon doesn't have enough fire left to cook a meatball!

* * *

The Paper Bag Princess
An interactive fairy tale by Adri
Release 1 / Serial number 130921 / Inform 7 build 6G60 (I6/v6.32 lib 6/12N) SD

Castle Ruins
No more castle. pile of rubble flame

>search rubble.wear bag.n.ne
You find a paper bag.

(first taking the paper bag)
You quickly fashion a dress out of the gift bag. It's not as fancy as you're used to, but it'll get the job done.

You strip off the remains of your wedding gown and discard them in a pile of rubble.

First Forest
There's a trail of burned trees and horses' teeth leading to the northeast.

Cave Exterior

>knock
(the Cave Door)
You grab the knocker and bang on the door.

The dragon sticks his nose out the door and says, "Well, a princess! I love to eat princesses, but I have already eaten a whole castle today. I am a very busy dragon. Come back tomorrow."

Then he slams the door.

>ask dragon about ire
The Dragon says, "I don't know anything about that."

>ask dragon about fire
"Is it true," you say, "that you can burn up ten forests with your fiery breath?"

"Oh, yes", says the dragon, and he takes a huge, deep breath and breathes out so much fire that he burns up fifty forests.

Wow! Wasn't that impressive?

* * *

>n
You can't go that way.

>yes
The dragon does not respond.

* * *

>knock
(the Cave Door)
You grab the knocker and bang on the door.

The dragon sticks his nose out the door and says, "Well, a princess! I love to eat princesses, but I have already eaten a whole castle today. I am a very busy dragon. Come back tomorrow."

Then he slams the door.

>ask dragon about fire
"Is it true," you say, "that you can burn up ten forests with your fiery breath?"

"Oh, yes", says the dragon, and he takes a huge, deep breath and breathes out so much fire that he burns up fifty forests.

Were you impressed by that display?

>n
You shake your head in disappointment.

The dragon takes another huge breath and breathes out so much fire that he burns up one hundred forests.

Were you impressed by that display?

>y
"Fantastic!" you exclaim. "Do it again!"

The dragon takes another huge breath. But this time, nothing comes out.

>ask about fire
The dragon doesn't have enough fire left to cook a meatball!

>g
The dragon doesn't have enough fire left to cook a meatball!

>ask about flying
You say, "Dragon, is it true that you can fly around the world in just ten seconds?"

"Why, yes," says the dragon, and he jumps up and flies around the world in just ten seconds. He seems very tired when he returns.

Were you impressed by that display?

>y
"Magnificent!" you exclaim. "Do it again!"

"Fantastic!" you shout. "Do it again!"

So the dragon jumps up and flies around the whole world in just twenty seconds. When he returns, he flops down on the ground.

>ask about flying
The dragon is too tired to stand up.

* * *

>knock
(the Cave Door)
You grab the knocker and bang on the door.

The dragon sticks his nose out the door and says, "Well, a princess! I love to eat princesses, but I have already eaten a whole castle today. I am a very busy dragon. Come back tomorrow."

Then he slams the door.

>undo
Cave Exterior
[Previous turn undone.]

>e
(first opening the Cave Door)
The door is locked. Perhaps you should try knocking.

>unlock door
What do you want to unlock the Cave Door with?

>l
Cave Exterior

>open door
The door is locked. Perhaps you should try knocking.

>knock on door
You grab the knocker and bang on the door.

The dragon sticks his nose out the door and says, "Well, a princess! I love to eat princesses, but I have already eaten a whole castle today. I am a very busy dragon. Come back tomorrow."

Then he slams the door.

>knock on door
You grab the knocker and bang on the door again.

The dragon sticks his nose out the door and says, "Well, a princess! I love to eat princesses, but I have already eaten a whole castle today. I am a very busy dragon. Come back tomorrow."

This time he pauses a moment before slamming the door.

>shout
What do you want to shout hello to?

>dragon
There is no reply.

>l
Cave Exterior
You can see a dragon here.

>dance
That's not a verb I recognize.

>xyzzy
POOF! Your fairy godmother appears. Something something something.

>l
Cave Exterior
You can see a dragon here.

* * *

>knock
(the Cave Door)
You grab the knocker and bang on the door again.

The dragon sticks his nose out the door and says, "Well, a princess! I love to eat princesses, but I have already eaten a whole castle today. I am a very busy dragon. Come back tomorrow."

This time he pauses a moment before slamming the door.

>xyzzy
POOF! Your fairy godmother appears. Something something something.

* * *

>l
Cave Exterior
You can see a dragon here.

>knock
(the Cave Door)
You already have the dragon's attention.

* * *

>knock
(the Cave Door)
You grab the knocker and bang on the door again.

The dragon sticks his nose out the door and says, "Well, a princess! I love to eat princesses, but I have already eaten a whole castle today. I am a very busy dragon. Come back tomorrow."

This time he pauses a moment before slamming the door.

>dance
That's not a verb I recognize.

* * *

>xyzzy
POOF! Your fairy godmother appears. Something something something.

>quiz
That's not a verb I recognize.

>ask dragona bout dragon
You can't see any such thing.

>ask dragon about dragon
The Dragon says, "I don't know anything about that."

>talk to dragon
There is no reply.

>hello, dragon
(dragon, hello)
There is no reply.

* * *

>ask dragon about dragon
The dragon says, "I don't know anything about that."

>talk to dragon
There is no reply.

>dragon, hello
There is no reply.

>ask dragon about roland
Blah.

>ask dragon about me
The dragon says, "I love to eat princesses, but I have already eaten a whole castle today. Come back tomorrow."

>ask dragon about castle
The dragon says, "That's very kind of you to offer, but I have already eaten a whole castle today."

>ask dragon about dragon
The Dragon says, "I don't know anything about that."

* * *

The Paper Bag Princess
An interactive fairy tale by Adri
Release 1 / Serial number 130921 / Inform 7 build 6G60 (I6/v6.32 lib 6/12N) SD

Castle Ruins
No more castle. pile of rubble flame

I beg your pardon?

>search rubble.wear bag.n.ne.knock
You find a paper bag.

(first taking the paper bag)
You quickly fashion a dress out of the gift bag. It's not as fancy as you're used to, but it'll get the job done.

You strip off the remains of your wedding gown and discard them in a pile of rubble.

First Forest
There's a trail of burned trees and horses' teeth leading to the northeast.

Cave Exterior
(the Cave Door)
You knock on the Cave Door.

The dragon opens the door and tells you to beat it.

>ask dragon about fire
"Is it true," you say, "that you can burn up ten forests with your fiery breath?"

"Oh, yes", says the dragon, and he takes a huge, deep breath and breathes out so much fire that he burns up fifty forests.

Wow! Wasn't that impressive?

* * *

>ask dragon about fire
"Fantastic," you say, and the dragon takes another huge breath and breathes out so much fire that he burns up one hundred forests.

Wow! Wasn't that impressive?

>y
"Magnificent," you say, and the dragon takes another huge breath. But this time, nothing comes out.

Wow! Wasn't that impressive?

* * *

I beg your pardon?

>n.ne
Burnt Forest
There's a trail of burned trees and horses' teeth leading to the northeast.

Burnt Forest
Something something something.

>n.n.n.n.n.n.n.n.n.n
Burnt Forest
Something something something.

Burnt Forest
Something something something.

Burnt Forest
Something something something.

Burnt Forest
Something something something.

Burnt Forest
Something something something.

Burnt Forest
Something something something.

Burnt Forest
Something something something.

Cave Exterior
You can't go that way.

You can't go that way.

>knock
(the Cave Door)
You grab the knocker and bang on the door.

The dragon sticks his nose out the door and says, "Well, a princess! I love to eat princesses, but I have already eaten a whole castle today. I am a very busy dragon. Come back tomorrow."

Then he slams the door.

* * *

The Paper Bag Princess
An interactive fairy tale by Adri
Release 1 / Serial number 130921 / Inform 7 build 6G60 (I6/v6.32 lib 6/12N) SD

Castle Ruins
No more castle. pile of rubble flame

>search rubble.wear bag.ne.n
You find a paper bag.

(first taking the paper bag)
You quickly fashion a dress out of the gift bag. It's not as fancy as you're used to, but it'll get the job done.

You strip off the remains of your wedding gown and discard them in a pile of rubble.

You can't go that way.

First Forest
There's a trail of burned trees and horses' teeth leading to the northeast.

>n
The trail seems to be leading northeast.

>ne
Cave Exterior

>knock
(the Cave Door)
You grab the knocker and bang on the door.

The dragon sticks his nose out the door and says, "Well, a princess! I love to eat princesses, but I have already eaten a whole castle today. I am a very busy dragon. Come back tomorrow."

Then he slams the door.

* * *

>hello, dragon
(dragon, hello)
There is no reply.

>talk toc rown
I didn't understand that sentence.

>talk to crown
The tarnished gold crown does not respond.

>ask dragon about dragon
The dragon says, "I don't know anything about that."

>show crown to dragon
The dragon does not respond.

* * *

The Paper Bag Princess
An interactive fairy tale by Adri
Release 1 / Serial number 130921 / Inform 7 build 6G60 (I6/v6.32 lib 6/12N) SD

Castle Ruins
No more castle. pile of rubble flame

>n.ne.ne.ne.n.n.n.n.n.n
Burnt Forest
There's a trail of burned trees and horses' teeth leading to the northeast.

Burnt Forest
Something something something.

Burnt Forest
Something something something.

Burnt Forest
Something something something.

Burnt Forest
Something something something.

Burnt Forest
Something something something.

Burnt Forest
Something something something.

Burnt Forest
Something something something.

Burnt Forest
Something something something.

Burnt Forest
Something something something.

>n
Cave Exterior

>knock
(the Cave Door)
You grab the knocker and bang on the door.

The dragon sticks his nose out the door and says, "Well, a princess! I love to eat princesses, but I have already eaten a whole castle today. I am a very busy dragon. Come back tomorrow."
Then he slams the door.

* * *

The Paper Bag Princess
An interactive fairy tale by Adri
Release 1 / Serial number 130921 / Inform 7 build 6G60 (I6/v6.32 lib 6/12N) SD

Castle Ruins
No more castle. pile of rubble flame

>n.ne
Burnt Forest
There's a trail of burned trees and horses' teeth leading to the northeast.

You can see a branch and a pine sap here.

Darkness
It is pitch dark, and you can't see a thing.

>n.n.n.n.n.n.n.n.n.n
Burnt Forest
Something something something.

Burnt Forest
Something something something.

Burnt Forest
Something something something.

Burnt Forest
Something something something.

Burnt Forest
Something something something.

Burnt Forest
Something something something.

Cave Exterior
You can't go that way.

You can't go that way.

You can't go that way.

>knock
(the Cave Door)
You grab the knocker and bang on the door.

The dragon sticks his nose out the door and says, "Well, a princess! I love to eat princesses, but I have already eaten a whole castle today. I am a very busy dragon. Come back tomorrow."

Then he slams the door.

* * *

>n.ne
Burnt Forest
There's a trail of burned trees and horses' teeth leading to the northeast.

You can see a branch and a pine sap here.

Darkness
It is pitch dark, and you can't see a thing.

>n.n.n.n.n.n.n.n.n
Burnt Forest
Something something something.

Burnt Forest
Something something something.

You can see a ring here.

Burnt Forest
Something something something.

Burnt Forest
Something something something.

Burnt Forest
Something something something.

Burnt Forest
Something something something.

Burnt Forest
Something something something.

You can see a ring here.

Burnt Forest
Something something something.

Cave Exterior

* * *

>n.ne
Burnt Forest
There's a trail of burned trees and horses' teeth leading to the northeast.

You can see a branch and a pine sap here.

Darkness
It is pitch dark, and you can't see a thing.

>n.n.n.n.n.n.n.n
Burnt Forest
Something something something.

Burnt Forest
Something something something.

Burnt Forest
Something something something.

Burnt Forest
Something something something.

Burnt Forest
Something something something.

Burnt Forest
Something something something.

Burnt Forest
Something something something.

Cave Exterior

* * *

>n.ne
Burnt Forest
There's a trail of burned trees and horses' teeth leading to the northeast.

You can see a branch and a pine sap here.

Darkness
It is pitch dark, and you can't see a thing.

>undo
Castle Ruins
[Previous turn undone.]

>l
Castle Ruins
No more castle. pile of rubble

>undo
Castle Ruins
[Previous turn undone.]

>undo
Throne Room
[Previous turn undone.]

>l
Throne Room
This is it. You're finally getting married!

Your betrothed, Roland, stands before you.

---

>z.z
You beam happily at Roland.

...

You beam happily at Roland.

,,,,

DRAGON!

Please press SPACE to continue.

The Paper Bag Princess
An interactive fairy tale by Adri
Release 1 / Serial number 130920 / Inform 7 build 6G60 (I6/v6.32 lib 6/12N) SD

Castle Ruins
No more castle. pile of rubble

>n
Burnt Forest
There's a trail of burned trees and horses' teeth leading to the northeast.

There is a patch of mushrooms here.

>l
Burnt Forest
There's a trail of burned trees and horses' teeth leading to the northeast.

There is a patch of mushrooms here.

>take mushrooms
Taken.

>l
Burnt Forest
There's a trail of burned trees and horses' teeth leading to the northeast.

>i
You are carrying some mushrooms and a bouquet.

>x mushrooms
You see nothing special about the mushrooms.

* * *

>undo
Castle Ruins
[Previous turn undone.]

>take branch
You can't see any such thing.

>remove gown
You strip off the remains of your wedding gown and discard them in a pile of rubble.

>make torchi
I didn't understand that sentence.

>make torch
How do you plan to do that?

>n
Burnt Forest
There's a trail of burned trees and horses' teeth leading to the northeast.

You can see a branch and a pine sap here.

>take branch
Taken.

>l
Burnt Forest
There's a trail of burned trees and horses' teeth leading to the northeast.

You can see a pine sap here.

>make torch
You make a torch!

>i
You are carrying a torch and a bouquet.

>x torch
You can't see any such thing.

* * *

The Paper Bag Princess
An interactive fairy tale by Adri
Release 1 / Serial number 130921 / Inform 7 build 6G60 (I6/v6.32 lib 6/12N) SD

Castle Ruins
No more castle. pile of rubble flame

>n.ne.n.n.n.n.n.n.n.n.n.n
Burnt Forest
There's a trail of burned trees and horses' teeth leading to the northeast.

Burnt Forest
Something something something.

Burnt Forest
Something something something.

Burnt Forest
Something something something.

Burnt Forest
Something something something.

Burnt Forest
Something something something.

Burnt Forest
Something something something.

Burnt Forest
Something something something.

Burnt Forest
Something something something.

Burnt Forest
Something something something.

Burnt Forest
Something something something.

Burnt Forest
Something something something.

>n.n.n.n
Cave Exterior
You can't go that way.

You can't go that way.

You can't go that way.

>knock
(the Cave Door)
You grab the knocker and bang on the door.

The dragon sticks his nose out the door and says, "Well, a princess! I love to eat princesses, but I have already eaten a whole castle today. I am a very busy dragon. Come back tomorrow."
Then he slams the door.

>knock again
You grab the knocker and bang on the door again.

The dragon sticks his nose out the door and says, "Well, a princess! I love to eat princesses, but I have already eaten a whole castle today. I am a very busy dragon. Come back tomorrow."
This time he pauses a moment before slamming the door.

>shout
You shout at the dragon.

lalalalalala.

* * *

The Paper Bag Princess
An interactive fairy tale by Adri
Release 1 / Serial number 130921 / Inform 7 build 6G60 (I6/v6.32 lib 6/12N) SD

Castle Ruins
No more castle. pile of rubble flame

>n.ne.n.n.n.n.n.n.n.n
Burnt Forest
There's a trail of burned trees and horses' teeth leading to the northeast.

Burnt Forest
Something something something.

Burnt Forest
Something something something.

Burnt Forest
Something something something.

Burnt Forest
Something something something.

Burnt Forest
Something something something.

Burnt Forest
Something something something.

Burnt Forest
Something something something.

Burnt Forest
Something something something.

Burnt Forest
Something something something.

>n.n.n.n
Burnt Forest
Something something something.

Burnt Forest
Something something something.

Cave Exterior
You can't go that way.

>knock
(the Cave Door)
You grab the knocker and bang on the door.

The dragon sticks his nose out the door and says, "Well, a princess! I love to eat princesses, but I have already eaten a whole castle today. I am a very busy dragon. Come back tomorrow." 
Then he slams the door.

>g
(the Cave Door)
You grab the knocker and bang on the door again.

The dragon sticks his nose out the door and says, "Well, a princess! I love to eat princesses, but I have already eaten a whole castle today. I am a very busy dragon. Come back tomorrow." 
This time he pauses a moment before slamming the door.

* * *

The Paper Bag Princess
An interactive fairy tale by Adri
Release 1 / Serial number 130921 / Inform 7 build 6G60 (I6/v6.32 lib 6/12N) SD

Castle Ruins
No more castle. pile of rubble flame

>n
Burnt Forest
There's a trail of burned trees and horses' teeth leading to the northeast. One tree in particular catches your eye.

>ne
Darkness
It is pitch dark, and you can't see a thing.

>l
Darkness
It is pitch dark, and you can't see a thing.

>sw
Burnt Forest
Something something something.

* * *

>n
Burnt Forest
There's a trail of burned trees and horses' teeth leading to the northeast. One tree in particular catches your eye.

>take pine sap
With your bare hands?

Taken.

>i
You are carrying a bouquet.

>l
Burnt Forest
There's a trail of burned trees and horses' teeth leading to the northeast.

You can see a branch and pine sap here.

* * *

>n
Burnt Forest
There's a trail of burned trees and horses' teeth leading to the northeast. One tree in particular catches your eye.

>take sap
What, with your bare hands?

>take sap with branch
What, with your bare hands?

>take branch
Taken.

>take sap with branch
You take it.

>i
You are carrying a branch and a bouquet.

>x branch
You see nothing special about the branch.

>undo
Burnt Forest
[Previous turn undone.]

>undo
Burnt Forest
[Previous turn undone.]

>take sap
You take it.

>i
You are carrying a branch and a bouquet.

>remove dress
You strip off the remains of your wedding gown and discard them in a pile of rubble.

>i
You are carrying a branch and a bouquet.

>make bouquet
I didn't understand that sentence.

>make torch
I didn't understand that sentence.

* * *

>n
Burnt Forest
There's a trail of burned trees and horses' teeth leading to the northeast. One tree in particular catches your eye.

>take pine ap
I only understood you as far as wanting to take pine sap.

>take sap
What, with your bare hands?

>i
You are carrying a bouquet.

* * *

>l
Burnt Forest
There's a trail of burned trees and horses' teeth leading to the northeast.

You can see a branch and pine sap here.

>take branch
Taken.

>take pine sap with branch
I only understood you as far as wanting to take pine sap.

* * *

>n
Burnt Forest
There's a trail of burned trees and horses' teeth leading to the northeast. One tree in particular catches your eye.

>remove gown
You strip off the remains of your wedding gown and discard them in a pile of rubble.

>i
You are carrying a bouquet and a handful of rags.

>take all
branch: Taken.
pine sap: You take it.

>make torch
NO.

>i
You are carrying a branch, a bouquet, and a handful of rags.

* * *

>n
Burnt Forest
There's a trail of burned trees and horses' teeth leading to the northeast. One tree in particular catches your eye.

>take all
branch: Taken.
pine sap: You take it.

>i
You are carrying pine sap, a branch, and a bouquet.

>remove dress
You strip off the remains of your wedding gown and discard them in a pile of rubble.

>i
You are carrying pine sap, a branch, a bouquet, and a handful of rags.

>make torch
YES.

>i
You are carrying Making a torch and a bouquet.

* * *

>take all
branch: Taken.
pine sap: You take it.

>remove gown
You strip off the remains of your wedding gown and discard them in a pile of rubble.

>make torch
YES.

>i
You are carrying a torch and a bouquet.

>x torch
.....

>ne
Burnt Forest
Something something something.

>drop torch
Dropped.

>l
Burnt Forest
Something something something.

You can see a torch (providing light) here.

>take torch
Taken.

>sw
Burnt Forest
Something something something.

>undo
Burnt Forest
[Previous turn undone.]

>sw
Burnt Forest
Something something something.

There is a shiny ring here.

>drop torch
Dropped.

>n
Burnt Forest
Something something something.

* * *

>n
Burnt Forest
There's a trail of burned trees and horses' teeth leading to the northeast. One tree in particular catches your eye.

>take branch.remove dress
Taken.

You strip off the remains of your wedding gown and discard them in a pile of rubble.

>i
You are carrying a branch, a bouquet, and a handful of rags.

>make torch
You make a torch!

* * *

>i
You are carrying a torch and a bouquet.

>drop torch
Dropped.

>l
Burnt Forest
There's a trail of burned trees and horses' teeth leading to the northeast.

You can see a torch here.

* * *

>n
Burnt Forest
There's a trail of burned trees and horses' teeth leading to the northeast. One tree in particular catches your eye.

>x teeth
The trail seems to be leading northeast.

>x horses' teeth
You can't see any such thing.

>x horses teeth
The trail seems to be leading northeast.

* * *

>n
Burnt Forest
There's a trail of burned trees and horses' teeth leading to the northeast. One tree in particular catches your eye.

>x horses' teeth
The trail seems to be leading northeast.

* * *

>n
Burnt Forest
There's a trail of burned trees and horses' teeth leading to the northeast. One tree in particular catches your eye.

>x trail
You find a large branch lying on the trail.

* * *

>n
Burnt Forest
There's a trail of burned trees and horses' teeth leading to the northeast. One tree in particular catches your eye.

>x tree
You examine the tree more closely. Someone has carved "PLUGH" into the trunk.

>plugh
POOF! Your fairy godmother appears. "Tsk," she says. "Poor girl. I'm not sure I can help you with this one." She pauses and rummages around in her pockets, pulling out a vial. She hands it to you. "This is the best I can do. Use it wisely." Then she vanishes, as quickly as she appeared.

>x trail
The trail seems to be leading northeast.

You find a large branch lying on the trail.

>x trail
The trail seems to be leading northeast.

>l
Burnt Forest
There's a trail of burned trees and horses' teeth leading to the northeast. One tree in particular catches your eye.

You can see a branch here.

* * *

The Paper Bag Princess
An interactive fairy tale by Adri
Release 1 / Serial number 130921 / Inform 7 build 6G60 (I6/v6.32 lib 6/12N) SD

Castle Ruins
No more castle. pile of rubble flame

>remove dress.n.take branch.make torch
You strip off the remains of your wedding gown and discard them in a pile of rubble.

Burnt Forest
There's a trail of burned trees and horses' teeth leading to the northeast.

You can see a branch here.

Taken.

You make a torch!

>i
You are carrying a torch and a bouquet.

* * *

>l
Burnt Forest
There's a trail of burned trees and horses' teeth leading to the northeast.

You can see a torch here.

>take torch
Taken.

>ne
Burnt Forest
Something something something.

* * *

>take torch
Taken.

>i
You are carrying a torch (providing light) and a bouquet.

>combine
That's not a verb I recognize.

* * *

The Paper Bag Princess
An interactive fairy tale by Adri
Release 1 / Serial number 130921 / Inform 7 build 6G60 (I6/v6.32 lib 6/12N) SD

Castle Ruins
No more castle. pile of rubble flame

>x me
You are still the loveliest princess in the land.

You are wearing a gift bag that has been fashioned into a rather respectable dress, a handful of rags, and a tarnished gold crown.

>undo
Castle Ruins
[Previous turn undone.]

>restart
Are you sure you want to restart?

* * *

>xyzzy
POOF! Your fairy godmother appears. She smiles at you and places a necklace around your neck.

---

>z.z
You beam happily at Roland.

...

You beam happily at Roland.

,,,,

DRAGON!

Please press SPACE to continue.

The Paper Bag Princess
An interactive fairy tale by Adri
Release 1 / Serial number 130921 / Inform 7 build 6G60 (I6/v6.32 lib 6/12N) SD

Castle Ruins
No more castle. pile of rubble

>x me
You are still the loveliest princess in the land.

You are wearing a gift bag that has been fashioned into a rather respectable dress, a handful of rags, a necklace, and a tarnished gold crown.

>remove dress
You take off the handful of rags.

>x me
You are still the loveliest princess in the land.

You are wearing a gift bag that has been fashioned into a rather respectable dress, a necklace, and a tarnished gold crown.

>i
You are carrying a handful of rags and a bouquet.

>remove bag
You remove the gift bag, folding it carefully.

>x me
You are still the loveliest princess in the land.

You are stark naked, save for a necklace and a tarnished gold crown.

>i
You are carrying a paper bag, a handful of rags, and a bouquet.

>x bag
It's a gift bag made out of paper. It looks like it used to have polka dots on it, but now it's just scorched. It has been fashioned into a crude dress.

>x rags
The tattered remains of your wedding gown.

>x necklace
It's a necklace.

>x crown
Your gold crown. It's looking a little worse for the wear.

* * *

The Paper Bag Princess
An interactive fairy tale by Adri
Release 1 / Serial number 130921 / Inform 7 build 6G60 (I6/v6.32 lib 6/12N) SD

Castle Ruins
No more castle. pile of rubble flame

>xyzzy
POOF! Your fairy godmother appears. "Tsk," she says. "Poor girl. I'm not sure I can help you with this one." She pauses and rummages around in her pockets, pulling out a vial. She hands it to you. "This is the best I can do. Use it wisely." Then she vanishes, as quickly as she appeared.

>i
You are carrying a vial (closed) and a bouquet.

>x vial
it's a vial of what appears to be oil.

>open vial
You open the vial, revealing an oil.

* * *

>x vial
it's a vial of what appears to be oil.

>x oil
You can't see any such thing.

* * *

>xyzzy
POOF! Your fairy godmother appears. "Tsk," she says. "Poor girl. I'm not sure I can help you with this one." She pauses and rummages around in her pockets, pulling out a vial. She hands it to you. "This is the best I can do. Use it wisely." Then she vanishes, as quickly as she appeared.

>x oil
A clear, thick liquid.

>open vial
You open the vial.

>pour vial
That's not a verb I recognize.

* * *

>xyzzy
POOF! Your fairy godmother appears. "Tsk," she says. "Poor girl. I'm not sure I can help you with this one." She pauses and rummages around in her pockets, pulling out a vial. She hands it to you. "This is the best I can do. Use it wisely." Then she vanishes, as quickly as she appeared.

>x vial
It's a vial of thick, black liquid.

>x vial
It's a vial of what appears to be oil.

In the vial is a quantity of oil.

>smell vial
The vial isn't open.

>drink vial
The vial isn't open.

>x vial
It's a vial of what appears to be oil.

In the vial is a quantity of oil.

>open vial
You open the vial.

>smell oil
It's pretty foul-smelling.

>x oil
A clear, thick liquid.

>drink oil
As you bring vial towards your mouth, you catch a whiff of the quantity of oil and gag. Drinking that seems like a bad idea.

>pour oil
What do you want to pour the quantity of oil on?

>me
You shouldn't waste quantity of oil like that.

* * *

>x vial
It's a vial of thick, black liquid.

>open vial
You open the vial, revealing an oily black liquid.

>pour vial on rags
You pour oily black liquid onto handful of rags.

* * *

>xyzzy
POOF! Your fairy godmother appears. "Tsk," she says. "Poor girl. I'm not sure I can help you with this one." She pauses and rummages around in her pockets, pulling out a vial. She hands it to you. "This is the best I can do. Use it wisely." Then she vanishes, as quickly as she appeared.

>pour oil
You can't see any such thing.

>pour vial
What do you want to pour the vial on?

>me
The vial isn't open.

>open vial
You open the vial, revealing a quantity of oil.

>pour vial on me
You shouldn't waste quantity of oil like that.

* * *

>xyzzy
POOF! Your fairy godmother appears. "Tsk," she says. "Poor girl. I'm not sure I can help you with this one." She pauses and rummages around in her pockets, pulling out a vial. She hands it to you. "This is the best I can do. Use it wisely." Then she vanishes, as quickly as she appeared.

>open vial
You open the vial, revealing a oil.

>pour oil on me
You shouldn't waste quantity of oil like that.

* * *

>open vial
You open the vial, revealing a oil.

>x oil
A clear, thick liquid that appears to be oil.

>x vial
It's a vial of clear, thick liquid.

In the vial is an oil.

* * *

>xyzzy
POOF! Your fairy godmother appears. "Tsk," she says. "Poor girl. I'm not sure I can help you with this one." She pauses and rummages around in her pockets, pulling out a vial. She hands it to you. "This is the best I can do. Use it wisely." Then she vanishes, as quickly as she appeared.

>drop vial
You drop the vial. It bounces harmlessly on the ground.

>take vial
Taken.

I beg your pardon?

* * *

The Paper Bag Princess
An interactive fairy tale by Adri
Release 1 / Serial number 130921 / Inform 7 build 6G60 (I6/v6.32 lib 6/12N) SD

Castle Ruins
No more castle. pile of rubble flame

>xyzzy.open vial.remove rags.pour oil on rags
POOF! Your fairy godmother appears. "Tsk," she says. "Poor girl. I'm not sure I can help you with this one." She pauses and rummages around in her pockets, pulling out a vial. She hands it to you. "This is the best I can do. Use it wisely." Then she vanishes, as quickly as she appeared.

You open the vial, revealing an oily black liquid.

You take off the handful of rags.

You pour the oily black liquid onto the handful of rags.

>x vial
It's a vial of thick, black liquid.

>open vial
That's already open.

>i
You are carrying a vial (empty), a handful of rags, and a bouquet.

* * *

The Paper Bag Princess
An interactive fairy tale by Adri
Release 1 / Serial number 130921 / Inform 7 build 6G60 (I6/v6.32 lib 6/12N) SD

Castle Ruins
No more castle. pile of rubble flame

>n.x trail.take branch
Burnt Forest
There's a trail of burned trees and horses' teeth leading to the northeast. One tree in particular catches your eye.

The trail seems to be leading northeast.

You find a large branch lying on the trail.

Taken.

>remove rags.put rags on branch
You take off the handful of rags.

Putting things on the branch would achieve nothing.

>make torch
You make a torch!

>ne
Burnt Forest
Something something something.

>i
You are carrying a flaming torch (providing light) and a bouquet.

* * *

>n.x trail.take branch
Burnt Forest
There's a trail of burned trees and horses' teeth leading to the northeast. One tree in particular catches your eye.

The trail seems to be leading northeast.

You find a large branch lying on the trail.

Taken.

>put rags on branch
You make a torch!

* * *

The Paper Bag Princess
An interactive fairy tale by Adri
Release 1 / Serial number 130921 / Inform 7 build 6G60 (I6/v6.32 lib 6/12N) SD

Castle Ruins
No more castle. pile of rubble flame

>n.x trail.take branch.put rags on branch
Burnt Forest
There's a trail of burned trees and horses' teeth leading to the northeast. One tree in particular catches your eye.

The trail seems to be leading northeast.

You find a large branch lying on the trail.

Taken.

*** Run-time problem P7: Too many rulebooks in simultaneous use.

* * *

The Paper Bag Princess
An interactive fairy tale by Adri
Release 1 / Serial number 130921 / Inform 7 build 6G60 (I6/v6.32 lib 6/12N) SD

Castle Ruins
No more castle. pile of rubble flame

>touch rubble with me
I only understood you as far as wanting to touch the pile of rubble.

>take rubble
That's hardly portable.

>tabke rubble with me
That's not a verb I recognize.

>take rubble with me
I only understood you as far as wanting to take the pile of rubble.

* * *

The Paper Bag Princess
An interactive fairy tale by Adri
Release 1 / Serial number 130921 / Inform 7 build 6G60 (I6/v6.32 lib 6/12N) SD

Castle Ruins
No more castle. pile of rubble flame

>x flame
You see nothing special about the flame.

* * *

The Paper Bag Princess
An interactive fairy tale by Adri
Release 1 / Serial number 130921 / Inform 7 build 6G60 (I6/v6.32 lib 6/12N) SD

Castle Ruins
No more castle. pile of rubble flame

>xyzzy.open vial.drop vial
POOF! Your fairy godmother appears. "Tsk," she says. "Poor girl. I'm not sure I can help you with this one." She pauses and rummages around in her pockets, pulling out a vial. She hands it to you. "This is the best I can do. Use it wisely." Then she vanishes, as quickly as she appeared.

You open the vial, revealing an oily black liquid.

You drop the vial. It bounces harmlessly on the ground. The lid snaps shut in the process, and you don't lose more than a few drops of the oily black liquid.

>take vial
Taken.

>x vial
 It's a vial of thick, black liquid.

* * *

The Paper Bag Princess
An interactive fairy tale by Adri
Release 1 / Serial number 130921 / Inform 7 build 6G60 (I6/v6.32 lib 6/12N) SD

Castle Ruins
No more castle. pile of rubble flame

>xyzzy.break vial
POOF! Your fairy godmother appears. "Tsk," she says. "Poor girl. I'm not sure I can help you with this one." She pauses and rummages around in her pockets, pulling out a vial. She hands it to you. "This is the best I can do. Use it wisely." Then she vanishes, as quickly as she appeared.

You are not strong enough to do that.

>smile
That's not a verb I recognize.

>restart
Are you sure you want to restart?

* * *

>y
Something something something

Throne Room
This is it. You're finally getting married!

Your betrothed, Roland, stands before you.

>attack roladn
You can't see any such thing.

>attack roland
Violence isn't the answer to this one.

---

>kiss roland
Keep your mind on the game.

...

>hug roland
Keep your mind on the game.

,,,,

DRAGON!

Please press SPACE to continue.

* * *

The Paper Bag Princess
An interactive fairy tale by Adri
Release 1 / Serial number 130921 / Inform 7 build 6G60 (I6/v6.32 lib 6/12N) SD

Castle Ruins
No more castle. pile of rubble flame

>xyzzy.n.x trail.take branch
POOF! Your fairy godmother appears. "Tsk," she says. "Poor girl. I'm not sure I can help you with this one." She pauses and rummages around in her pockets, pulling out a vial. She hands it to you. "This is the best I can do. Use it wisely." Then she vanishes, as quickly as she appeared.

Burnt Forest
There's a trail of burned trees and horses' teeth leading to the northeast. One tree in particular catches your eye.

The trail seems to be leading northeast.

You find a large branch lying on the trail.

Taken.

>make torch
You fashion a torch from the branch and the remains of your wedding gown.

>light torch
This dangerous act would achieve little.

>burn torch
This dangerous act would achieve little.

* * *

The Paper Bag Princess
An interactive fairy tale by Adri
Release 1 / Serial number 130921 / Inform 7 build 6G60 (I6/v6.32 lib 6/12N) SD

Castle Ruins
No more castle. pile of rubble flame

>xyzzy.n.x trail.take branch.make torch
POOF! Your fairy godmother appears. "Tsk," she says. "Poor girl. I'm not sure I can help you with this one." She pauses and rummages around in her pockets, pulling out a vial. She hands it to you. "This is the best I can do. Use it wisely." Then she vanishes, as quickly as she appeared.

Burnt Forest
There's a trail of burned trees and horses' teeth leading to the northeast. One tree in particular catches your eye.

The trail seems to be leading northeast.

You find a large branch lying on the trail.

Taken.

You fashion a torch from the branch and the remains of your wedding gown.

>open vial.pour oil on torch
You open the vial, revealing an oily black liquid.

You pour the oily black liquid onto the torch.

>s
Castle Ruins
No more castle. pile of rubble flame

>light torch
You light the torch with the flame

>light torch
You light the torch with the flame

* * *

The Paper Bag Princess
An interactive fairy tale by Adri
Release 1 / Serial number 130921 / Inform 7 build 6G60 (I6/v6.32 lib 6/12N) SD

Castle Ruins
No more castle. pile of rubble flame

>take flame
This dangerous act would achieve little.

>rurn me with flame
That's not a verb I recognize.

>burn me with flame
This dangerous act would achieve little.

>xyzzy.open vial
POOF! Your fairy godmother appears. "Tsk," she says. "Poor girl. I'm not sure I can help you with this one." She pauses and rummages around in her pockets, pulling out a vial. She hands it to you. "This is the best I can do. Use it wisely." Then she vanishes, as quickly as she appeared.

You open the vial, revealing an oily black liquid.

>pour oil on flame
There isn't very much in the bottle. You shouldn't waste it.

>burn oil
This dangerous act would achieve little.

>put rag on flame
You can't see any such thing.

>put rags on flame
(first taking the flame)
This dangerous act would achieve little.

* * *

>take flame
This dangerous act would achieve little.

>burn me with flame
This dangerous act would achieve little.

>burn oil with flame
You can't see any such thing.

>put rags on flame
(first taking the flame)
This dangerous act would achieve little.

* * *

The Paper Bag Princess
An interactive fairy tale by Adri
Release 1 / Serial number 130921 / Inform 7 build 6G60 (I6/v6.32 lib 6/12N) SD

Castle Ruins
No more castle. pile of rubble flame

>put rags on flame
This dangerous act would achieve little.

* * *

The Paper Bag Princess
An interactive fairy tale by Adri
Release 1 / Serial number 130921 / Inform 7 build 6G60 (I6/v6.32 lib 6/12N) SD

Castle Ruins
No more castle. pile of rubble flame

>n.x trail.take branch.make torch.s
Burnt Forest
There's a trail of burned trees and horses' teeth leading to the northeast. One tree in particular catches your eye.

The trail seems to be leading northeast.

You find a large branch lying on the trail.

Taken.

You fashion a torch from the branch and the remains of your wedding gown.

Castle Ruins
No more castle. pile of rubble flame

>xyzzy.open vial.pour oil on torch
POOF! Your fairy godmother appears. "Tsk," she says. "Poor girl. I'm not sure I can help you with this one." She pauses and rummages around in her pockets, pulling out a vial. She hands it to you. "This is the best I can do. Use it wisely." Then she vanishes, as quickly as she appeared.

You open the vial, revealing an oily black liquid.

You pour the oily black liquid onto the torch.

>light torch
You light the torch with the flame.

>extinguish torch
That's not a verb I recognize.

* * *

The Paper Bag Princess
An interactive fairy tale by Adri
Release 1 / Serial number 130819 / Inform 7 build 6G60 (I6/v6.32 lib 6/12N) SD

Castle Ruins
No more castle. pile of rubble

* * *

>knock
(the Cave Door)
You knock on the Cave Door.

The dragon opens the door and tells you to beat it.

>ask about fire
(addressing the dragon)
"Is it true," you say, "that you can burn up ten forests with your fiery breath?"

"Oh, yes", says the dragon, and he takes a huge, deep breath and breathes out so much fire that he burns up fifty forests.

Were you impressed by that display?

>y
"Fantastic!" you say.

The dragon takes another huge breath and breathes out so much fire that he burns up one hundred forests.

Were you impressed by that display?

>y
"Magnificent!" you say.

The dragon takes another huge breath. But this time, nothing comes out.

>ask dragon about fire
The dragon doesn't have enough fire left to cook a meatball!

>restart
Are you sure you want to restart?

* * *

>y
Something something something

Throne Room
This is it. You're finally getting married!

Your betrothed, Roland, stands before you.

>z.z
You beam happily at Roland.

---

You beam happily at Roland.

...

>z
You beam happily at Roland.

,,,,

DRAGON!

Please press SPACE to continue.

* * *

The Paper Bag Princess
An interactive fairy tale by Adri
Release 1 / Serial number 130819 / Inform 7 build 6G60 (I6/v6.32 lib 6/12N) SD

Castle Ruins
No more castle. pile of rubble

>search rubble.wear bag.n.ne.knock
You find a paper bag.

(first taking the paper bag)
You quickly fashion a dress out of the gift bag. It's not as fancy as you're used to, but it'll get the job done.

You strip off the remains of your wedding gown and discard them in a pile of rubble.

First Forest
There's a trail of burned trees and horses' teeth leading to the northeast.

Cave Exterior
(the Cave Door)
You knock on the Cave Door.

The dragon opens the door and tells you to beat it.

>ask dragon about fire
"Is it true," you say, "that you can burn up ten forests with your fiery breath?"

"Oh, yes", says the dragon, and he takes a huge, deep breath and breathes out so much fire that he burns up fifty forests.

Were you impressed by that display?

>n
Of course you were, but you're not going to let the dragon know that. You shake your head in disappointment.

The dragon takes another huge breath and breathes out so much fire that he burns up one hundred forests.

Were you impressed by that display?

>n
Of course you were, but you're not going to let the dragon know that. You shake your head in disappointment.

The dragon takes another huge breath. But this time, nothing comes out.

* * *

The Paper Bag Princess
An interactive fairy tale by Adri
Release 1 / Serial number 130916 / Inform 7 build 6G60 (I6/v6.32 lib 6/12N) SD

Castle Ruins
No more castle. pile of rubble

>n.ne.n.n.n.n.n.n.n.n..n
Burnt Forest
There's a trail of burned trees and horses' teeth leading to the northeast.

Burnt Forest
Something something something.

Burnt Forest
Something something something.

Burnt Forest
Something something something.

Burnt Forest
Something something something.

Burnt Forest
Something something something.

Burnt Forest
Something something something.

Cave Exterior
You can't go that way.

You can't go that way.

That's not a verb I recognize.

>knock
(the Cave Door)
You grab the knocker and bang on the door.

The dragon sticks his nose out the door and says, "Well, a princess! I love to eat princesses, but I have already eaten a whole castle today. I am a very busy dragon. Come back tomorrow."

Then he slams the door.

* * *

The Paper Bag Princess
An interactive fairy tale by Adri
Release 1 / Serial number 130916 / Inform 7 build 6G60 (I6/v6.32 lib 6/12N) SD

Castle Ruins
No more castle. pile of rubble

>n.ne.n.n.n.n.n.n.n.n.n.n.n.n.n
Burnt Forest
There's a trail of burned trees and horses' teeth leading to the northeast.

Burnt Forest
Something something something.

Burnt Forest
Something something something.

Burnt Forest
Something something something.

Burnt Forest
Something something something.

Burnt Forest
Something something something.

Burnt Forest
Something something something.

Burnt Forest
Something something something.

Burnt Forest
Something something something.

Burnt Forest
Something something something.

Cave Exterior
You can't go that way.

You can't go that way.

You can't go that way.

You can't go that way.

>knock.g
You can't see any such thing.

>knock
(the Cave Door)
You grab the knocker and bang on the door.

The dragon sticks his nose out the door and says, "Well, a princess! I love to eat princesses, but I have already eaten a whole castle today. I am a very busy dragon. Come back tomorrow." 

Then he slams the door.

>knock
(the Cave Door)
You grab the knocker and bang on the door again.

The dragon sticks his nose out the door and says, "Well, a princess! I love to eat princesses, but I have already eaten a whole castle today. I am a very busy dragon. Come back tomorrow." 
This time he pauses a moment before slamming the door.

* * *

The Paper Bag Princess
An interactive fairy tale by Adri
Release 1 / Serial number 130921 / Inform 7 build 6G60 (I6/v6.32 lib 6/12N) SD

Castle Ruins
No more castle. pile of rubble

>xyzzy
POOF! Your fairy godmother appears. "Tsk," she says. "Poor girl. I'm not sure I can help you with this one." She pauses and rummages around in her pockets, pulling out a vial. She hands it to you. "This is the best I can do. Use it wisely." Then she vanishes, as quickly as she appeared.

>open vial
You open the vial, revealing a quantity of oil.

>pour vial
What do you want to pour the vial on?

>pour vial on rags
There isn't very much in the bottle. You shouldn't waste it.

>remove rags
You take off the handful of rags.

>pour vial on rags
There isn't very much in the bottle. You shouldn't waste it.

* * *

The Paper Bag Princess
An interactive fairy tale by Adri
Release 1 / Serial number 130921 / Inform 7 build 6G60 (I6/v6.32 lib 6/12N) SD

Castle Ruins
No more castle. pile of rubble

>xyzzy.open vial
POOF! Your fairy godmother appears. "Tsk," she says. "Poor girl. I'm not sure I can help you with this one." She pauses and rummages around in her pockets, pulling out a vial. She hands it to you. "This is the best I can do. Use it wisely." Then she vanishes, as quickly as she appeared.

You open the vial, revealing a quantity of oil.

>pour vial on vial
There isn't very much in the bottle. You shouldn't waste it.

>pour oil on rags
You pour quantity of oil onto torch.

* * *

The Paper Bag Princess
An interactive fairy tale by Adri
Release 1 / Serial number 130921 / Inform 7 build 6G60 (I6/v6.32 lib 6/12N) SD

Castle Ruins
No more castle. pile of rubble flame

>burn dress
This dangerous act would achieve little.

>burn me
This dangerous act would achieve little.

>xyzzy.n.x trail.take branch.make torch
POOF! Your fairy godmother appears. "Tsk," she says. "Poor girl. I'm not sure I can help you with this one." She pauses and rummages around in her pockets, pulling out a vial. She hands it to you. "This is the best I can do. Use it wisely." Then she vanishes, as quickly as she appeared.

Burnt Forest
There's a trail of burned trees and horses' teeth leading to the northeast. One tree in particular catches your eye.

The trail seems to be leading northeast.

You find a large branch lying on the trail.

Taken.

You fashion a torch from the branch and the remains of your wedding gown.

>burn torch.burn torch with flame
The torch needs something else.

You can't see any such thing.

>open vial.pour oil on torch
You open the vial, revealing an oily black liquid.

You pour the oily black liquid onto the torch.

>burn torch.burn torch with flame.s.burn torch with flame
There is no source of fire here.

You can't see any such thing.

>s
Castle Ruins
No more castle. pile of rubble flame

>burn torch with flame.burn torch
You light the torch with the flame
That is already on fire.

>light torch with flame
You can't see any such thing.

* * *

The Paper Bag Princess
An interactive fairy tale by Adri
Release 1 / Serial number 130921 / Inform 7 build 6G60 (I6/v6.32 lib 6/12N) SD

Castle Ruins
No more castle. pile of rubble flame

>burn me with flame
That noun did not make sense in this context.

* * *

>z.z.z
You beam happily at Roland.

"We are gathered here today to witness the joining of two hearts."

You beam happily at Roland.

"Speak now or forever hold your peace."

You hold your breath for a second, wondering whether anyone will speak up. Nobody does. You visibly relax.

You beam happily at Roland.

"Who gives this woman--"

You glare icily at the minister. You are nobody's property. "Ahem. Moving on.." Roland furrows his brow, but says nothing.

>z
You beam happily at Roland.

"Blah blah blah love." And so on. You're not really paying attention to the whole thing.

The minister is waiting for your answer. Please say "yes" or "no".

"Elizabeth, do you take Roland to be your husband blah blah blah."

>n
You shake your head. "No. I don't."

Oh. There's a pause, and then the guests begin to murmur. The minister frowns. "Elizabeth, are you sure?" he asks. Roland just stares at you in shock. You whisper, "I'm so sorry," and run off.

    *** Rocks fall. Everyone dies. ***

Would you like to RESTART, RESTORE a saved game, QUIT, or UNDO the last command?

>undo
Throne Room
[Previous turn undone.]

>y
(addressing Roland)
Roland shakes his head and puts a finger up to his lips.

And so on. You're not really paying attention to the whole thing.

"Elizabeth, do you take Roland to be your husband blah blah blah."

>y
Of course you do! But just as you're about to say so, you're interrupted by a cry of "Dragon!!!!".

DRAGON!

Please press SPACE to continue.

* * *

>z
You beam happily at Roland.

"Blah blah blah love." And so on. You're not really paying attention to the whole thing.

The minister is waiting for your answer. Please say "yes" or "no".

"Elizabeth, do you take Roland to be your husband blah blah blah."

>yes
(addressing Roland)
Of course you do! But just as you're about to say so, you're interrupted by a cry of "Dragon!!!!".

DRAGON!

Please press SPACE to continue.

The Paper Bag Princess
An interactive fairy tale by Adri
Release 1 / Serial number 130926 / Inform 7 build 6G60 (I6/v6.32 lib 6/12N) SD

Castle Ruins
No more castle. pile of rubble the embers

>undo
Throne Room
[Previous turn undone.]

>no
(addressing Roland)
You shake your head. "No. I don't."

Oh. There's a pause, and then the guests begin to murmur. The minister frowns. "Elizabeth, are you sure?" he asks. Roland just stares at you in shock. You whisper, "I'm so sorry," and run off.

    *** Rocks fall. Everyone dies. ***

Would you like to RESTART, RESTORE a saved game, QUIT, or UNDO the last command?

* * *

This is the day you've always dreamed of. You are finally marrying the love of your life, Prince Roland.

Castle Garden
You are standing in the garden behind your family's castle. On this lovely fall evening, it is doing double duty as a wedding chapel.

Your betrothed, Roland, stands before you.

You can also see Father Alfred here.

>xyzzy
POOF! Your fairy godmother appears. She smiles at you and places a necklace around your neck. Then she fades out of view.

Father Alfred begins the ceremony, "We are gathered here today to witness the joining of two hearts." Roland smiles shyly at you.

>i
You are carrying a bouquet.

...

* * *

>xyzzy
POOF! Your fairy godmother appears. She smiles at you and places a necklace around your neck. Then she fades out of view.

Father Alfred begins the ceremony, "We are gathered here today to witness the joining of two hearts." Roland smiles shyly at you.

>xyzzy
The necklace suddenly begins to glow.

...

>xyzzy
The necklace abruptly stops glowing.

,,,,

DRAGON!

Please press SPACE to continue.

The Paper Bag Princess
An interactive fairy tale by Adri
Release 1 / Serial number 130921 / Inform 7 build 6G60 (I6/v6.32 lib 6/12N) SD

Castle Ruins
No more castle. pile of rubble

>remove necklace
You take off the necklace.

>xyzzy
The necklace suddenly begins to glow.

>xyzzy
The necklace abruptly stops glowing.

>plugh
The necklace suddenly begins to glow.

* * *

>xyzzy
POOF! Your fairy godmother appears. She smiles at you and places a necklace around your neck. Then she fades out of view.

Father Alfred begins the ceremony, "We are gathered here today to witness the joining of two hearts." Roland smiles shyly at you.

>x me
You are the loveliest princess in the land.

You are wearing a sparkly gold crown and a long, white wedding gown.

...

>i
You are carrying a bouquet.

,,,,

DRAGON!

Please press SPACE to continue.

* * *

>x me
You are the loveliest princess in the land.

You are wearing a sparkly gold crown and a long, white wedding gown.

...

>x necklace
You can't see any such thing.

>x thingamajig
It's a necklace.

,,,,

DRAGON!

Please press SPACE to continue.

* * *

>xyzzy
POOF! Your fairy godmother appears. She smiles at you and places a necklace around your neck. Then she fades out of view.

Father Alfred begins the ceremony, "We are gathered here today to witness the joining of two hearts." Roland smiles shyly at you.

>z.z.
You beam happily at Roland.

...

You beam happily at Roland.

,,,,

DRAGON!

Please press SPACE to continue.

The Paper Bag Princess
An interactive fairy tale by Adri
Release 1 / Serial number 130921 / Inform 7 build 6G60 (I6/v6.32 lib 6/12N) SD

Castle Ruins
No more castle. pile of rubble

>n
Burnt Forest
There's a trail of burned trees and horses' teeth leading to the northeast.

You can see a branch here.

>ne
The woods seem pretty dark. Maybe you should find a light source.

* * *

>i
You are carrying a bouquet.

>x me
You are still the loveliest princess in the land.

You are wearing a gift bag that has been fashioned into a rather respectable dress, a handful of rags, a necklace, and a tarnished gold crown.

* * *

>ne
The woods seem pretty dark. Maybe you should find a light source.

* * *

>xyzzy
POOF! Your fairy godmother appears. She smiles at you and places a necklace around your neck. Then she fades out of view.

Father Alfred begins the ceremony, "We are gathered here today to witness the joining of two hearts." Roland smiles shyly at you.

>z.z
You beam happily at Roland.

...

You beam happily at Roland.

,,,,

DRAGON!

Please press SPACE to continue.

* * *

The Paper Bag Princess
An interactive fairy tale by Adri
Release 1 / Serial number 130921 / Inform 7 build 6G60 (I6/v6.32 lib 6/12N) SD

Castle Ruins
No more castle. pile of rubble

>x necklace
It's a necklace.

>ne
You can't go that way.

>n
Burnt Forest
There's a trail of burned trees and horses' teeth leading to the northeast.

You can see a branch here.

* * *

>xyzzy
POOF! Your fairy godmother appears. She smiles at you and places a necklace around your neck. Then she fades out of view.

Father Alfred begins the ceremony, "We are gathered here today to witness the joining of two hearts." Roland smiles shyly at you.

>x necklace
A heart-shaped pendant on a gold chain.

...

>xyzzy
The necklace suddenly begins to glow.

,,,,

DRAGON!

Please press SPACE to continue.

* * *

The Paper Bag Princess
An interactive fairy tale by Adri
Release 1 / Serial number 130921 / Inform 7 build 6G60 (I6/v6.32 lib 6/12N) SD

Castle Ruins
No more castle. pile of rubble

>x necklace
A heart-shaped pendant on a gold chain. It is glowing with a soft white light.

>i
You are carrying a bouquet.

* * *

>x me
You are still the loveliest princess in the land.

You are wearing a gift bag that has been fashioned into a rather respectable dress, a handful of rags, a necklace, and a tarnished gold crown.

>n
Burnt Forest
There's a trail of burned trees and horses' teeth leading to the northeast. One tree in particular catches your eye.

>ne
The woods seem pretty dark. Maybe you should find a light source.

>i
You are carrying a bouquet.

* * *

>x me
You are still the loveliest princess in the land.

You are wearing a gift bag that has been fashioned into a rather respectable dress, a handful of rags, a necklace, and a tarnished gold crown.

>xyzzy
The necklace abruptly stops glowing.

>ne
The woods seem pretty dark. Maybe you should find a light source.

* * *

>xyzzy
POOF! Your fairy godmother appears. She smiles at you and places a necklace around your neck. Then she fades out of view.

Father Alfred begins the ceremony, "We are gathered here today to witness the joining of two hearts." Roland smiles shyly at you.

>burn roland
You have no way to do that.

"If anyone has a reason why these two should not be wed, speak now or forever hold your peace." You hold your breath for a second, wondering whether anyone will speak up. Fortunately, nobody does and you relax.

>xyzzy
The necklace suddenly begins to glow.

"Who gives this woman--" You glare icily at the minister. You are nobody's property. "Ahem. Moving on," says the minister, visibly flustered. Roland looks at you questioningly, but says nothing.

>burn roland
The necklace is imbued with a magical light. It is not on fire.

"Love is a wonderful thing." And so on. You're too excited to pay attention to every word.

* * *

This is the day you've always dreamed of. You are finally marrying the love of your life, Prince Roland.

Castle Garden
You are standing in the garden behind your family's castle. On this lovely fall evening, it is doing double duty as a wedding chapel.

Your betrothed, Roland, stands before you.

You can also see Father Alfred here.

>shout
What do you want to shout hello to?

>roland
Roland shakes his head and puts a finger up to his lips.

---

* * *

This is the day you've always dreamed of. You are finally marrying the love of your life, Prince Roland.

Castle Garden
You are standing in the garden behind your family's castle. On this lovely fall evening, it is doing double duty as a wedding chapel.

Your betrothed, Roland, stands before you.

You can also see Father Alfred here.

>x him
Roland is the most attractive man you have ever laid eyes on.

Father Alfred begins the ceremony, "We are gathered here today to witness the joining of two hearts." Roland smiles shyly at you.

>x her
I'm not sure what "her" refers to.

>heteronormativity off
Ok!

>x her
Rolande is the most attractive woman you have ever laid eyes on.

"If anyone has a reason why these two should not be wed, speak now or forever hold your peace." You hold your breath for a second, wondering whether anyone will speak up. Fortunately, nobody does and you relax.

>x him
Rolande is the most attractive woman you have ever laid eyes on.

"Who gives this woman--" You glare icily at the minister. You are nobody's property. "Ahem. Moving on," says the minister, visibly flustered. Rolande looks at you questioningly, but says nothing.

* * *

>x him
Roland is the most attractive man you have ever laid eyes on.

Father Alfred begins the ceremony, "We are gathered here today to witness the joining of two hearts." Roland smiles shyly at you.

>heteronormativity off
Ok!

* * *

This is the day you've always dreamed of. You are finally marrying the love of your life, Prince Roland.

Castle Garden
You are standing in the garden behind your family's castle. On this lovely fall evening, it is doing double duty as a wedding chapel.

Your betrothed, Roland, stands before you.

You can also see Father Alfred here.

>heteronormativity on
Ok!

>l
Throne Room
This is it. You're finally getting married!

Your betrothed, Roland, stands before you.

---

>heteronormativity off
Ok!

>l
Throne Room
This is it. You're finally getting married!

Your betrothed, Rolande, stands before you.

...

>x roland
Rolande is the most attractive person you have ever laid eyes on.

,,,,

DRAGON!

Please press SPACE to continue.

The Paper Bag Princess
An interactive fairy tale by Adri
Release 1 / Serial number 130916 / Inform 7 build 6G60 (I6/v6.32 lib 6/12N) SD

Castle Ruins
No more castle. pile of rubble

>x rolande
You can't see any such thing.

* * *

This is the day you've always dreamed of. You are finally marrying the love of your life, Prince Roland.

Castle Garden
You are standing in the garden behind your family's castle. On this lovely fall evening, it is doing double duty as a wedding chapel.

Your betrothed, Roland, stands before you.

You can also see Father Alfred here.

>x princess
You can't see any such thing.

>x prince
Roland is the most attractive man you have ever laid eyes on.

---

* * *

This is the day you've always dreamed of. You are finally marrying the love of your life, Prince Roland.

Castle Garden
You are standing in the garden behind your family's castle. On this lovely fall evening, it is doing double duty as a wedding chapel.

Your betrothed, Roland, stands before you.

You can also see Father Alfred here.

>n.n.n
You can't go that way.

---

You can't go that way.

...

You can't go that way.

,,,,

DRAGON!

Please press SPACE to continue.

The Paper Bag Princess
An interactive fairy tale by Adri
Release 1 / Serial number 130916 / Inform 7 build 6G60 (I6/v6.32 lib 6/12N) SD

Castle Ruins
No more castle. pile of rubble

>n.ne.n.n.n.n.n.n.n.n.n.n
Burnt Forest
There's a trail of burned trees and horses' teeth leading to the northeast.

Burnt Forest
Something something something.

Burnt Forest
Something something something.

Burnt Forest
Something something something.

Burnt Forest
Something something something.

Burnt Forest
Something something something.

Burnt Forest
Something something something.

Burnt Forest
Something something something.

Burnt Forest
Something something something.

Cave Exterior
You can't go that way.

You can't go that way.

>knock
(the Cave Door)
You grab the knocker and bang on the door.

The dragon sticks his nose out the door and says, "Well, a princess! I love to eat princesses, but I have already eaten a whole castle today. I am a very busy dragon. Come back tomorrow."

Then he slams the door.

* * *

>knock
(the Cave Door)
You grab the knocker and bang on the door again.

The dragon sticks his nose out the door and says, "Well, a princess! I love to eat princesses, but I have already eaten a whole castle today. I am a very busy dragon. Come back tomorrow."

This time he pauses a moment before slamming the door.

>shout
You shout at the dragon.

lalalalalala.

* * *

This is the day you've always dreamed of. You are finally marrying the love of your life, Prince Roland.

Castle Garden
You are standing in the garden behind your family's castle. On this lovely fall evening, it is doing double duty as a wedding chapel.

Your betrothed, Roland, stands before you.

You can also see Father Alfred here.

>z.z
You beam happily at Roland.

---

You beam happily at Roland.

...

* * *

>z
You beam happily at Roland.

,,,,

DRAGON!

Please press SPACE to continue.

The Paper Bag Princess
An interactive fairy tale by Adri
Release 1 / Serial number 130920 / Inform 7 build 6G60 (I6/v6.32 lib 6/12N) SD

Castle Ruins
No more castle. pile of rubble

>n.ne.n.n.n.n.n.n.n
Burnt Forest
There's a trail of burned trees and horses' teeth leading to the northeast.

Burnt Forest
Something something something.

Burnt Forest
Something something something.

Burnt Forest
Something something something.

Burnt Forest
Something something something.

Burnt Forest
Something something something.

Burnt Forest
Something something something.

Burnt Forest
Something something something.

Cave Exterior

>knock
(the Cave Door)
You grab the knocker and bang on the door.

The dragon sticks his nose out the door and says, "Well, a princess! I love to eat princesses, but I have already eaten a whole castle today. I am a very busy dragon. Come back tomorrow."

Then he slams the door.

* * *

The Paper Bag Princess
An interactive fairy tale by Adri
Release 1 / Serial number 130920 / Inform 7 build 6G60 (I6/v6.32 lib 6/12N) SD

Castle Ruins
No more castle. pile of rubble

>n
Burnt Forest
There's a trail of burned trees and horses' teeth leading to the northeast.

You can see a branch and pine sap here.

>take pine sap
With your bare hands?

>take branch
Taken.

>take pine sap
You already have that.

>i
You are carrying a branch, pine sap, and a bouquet.

* * *

The Paper Bag Princess
An interactive fairy tale by Adri
Release 1 / Serial number 130920 / Inform 7 build 6G60 (I6/v6.32 lib 6/12N) SD

Castle Ruins
No more castle. pile of rubble

>n.ne
Burnt Forest
There's a trail of burned trees and horses' teeth leading to the northeast.

Burnt Forest
Something something something.

>n
Burnt Forest
Something something something.

You can see some berries here.

>take berries
Taken.

>n
Burnt Forest
Something something something.

>n
Burnt Forest
Something something something.

You can see some mushrooms here.

>take mushrooms
Taken.

>n
Burnt Forest
Something something something.

You can see a ring here.

>n
Burnt Forest
Something something something.

* * *

The Paper Bag Princess
An interactive fairy tale by Adri
Release 1 / Serial number 130920 / Inform 7 build 6G60 (I6/v6.32 lib 6/12N) SD

Castle Ruins
No more castle. pile of rubble

>n.ne
Burnt Forest
There's a trail of burned trees and horses' teeth leading to the northeast.

There is a patch of mushrooms here.

Burnt Forest
Something something something.

>smell
You smell nothing.

>listen
You hear nothing unexpected.

* * *

This is the day you've always dreamed of. You are finally marrying the love of your life, Prince Roland.

Castle Garden
You are standing in the garden behind your family's castle. On this lovely fall evening, it is doing double duty as a wedding chapel.

Your betrothed, Roland, stands before you.

You can also see Father Alfred here.

>start
Are you sure you want to restart?

>y
Something something something

Throne Room
This is it. You're finally getting married!

Your betrothed, Roland, stands before you.

* * *

This is the day you've always dreamed of. You are finally marrying the love of your life, Prince Roland.

Castle Garden
You are standing in the garden behind your family's castle. On this lovely fall evening, it is doing double duty as a wedding chapel.

Your betrothed, Roland, stands before you.

You can also see Father Alfred here.

>pick roland
You can't see any such thing.

>undo
[You can't "undo" what hasn't been done!]

>drop bouquet
Dropped.

---

>pick bouquet
You can't see any such thing.

>take bouquet
Taken.

...

* * *

>pick roland
You can't see any such thing.

>take roland
To be your lawfully wedded husband? Yes, Elizabeth. Be patient.

---

* * *

This is the day you've always dreamed of. You are finally marrying the love of your life, Prince Roland.

Castle Garden
You are standing in the garden behind your family's castle. On this lovely fall evening, it is doing double duty as a wedding chapel.

Your betrothed, Roland, stands before you.

You can also see Father Alfred here.

>RULES
Rules tracing now switched on. Type "rules off" to switch it off again, or "rules all" to include even rules which do not apply.

>brief
The Paper Bag Princess is now in its "brief" printing mode, which gives long descriptions of places never before visited and short descriptions otherwise.

* * *

This is the day you've always dreamed of. You are finally marrying the love of your life, Prince Roland.

Castle Garden
You are standing in the garden behind your family's castle. On this lovely fall evening, it is doing double duty as a wedding chapel.

Your betrothed, Roland, stands before you.

You can also see Father Alfred here.

>brief
Brief mode is disabled in this game.

>verbose
The Paper Bag Princess is now in its "verbose" mode, which always gives long descriptions of locations (even if you've been there before).

* * *

>brief
Brief mode is disabled in this game.

>superbrief
Superbrief mode is disabled in this game.

>verbose
This game is always in verbose mode.

>brief
The Paper Bag Princess is now in its "brief" printing mode, which gives long descriptions of places never before visited and short descriptions otherwise.

>RULES
Rules tracing now switched on. Type "rules off" to switch it off again, or "rules all" to include even rules which do not apply.

>brief
[Rule "Carry out preferring sometimes abbreviated room descriptions" applies.]
The Paper Bag Princess is now in its "brief" printing mode, which gives long descriptions of places never before visited and short descriptions otherwise.

* * *

>verbose
This game is always in verbose mode.

>z
You beam happily at Roland.

---

* * *

>verbose
This game is always in verbose mode.

>long
This game is always in verbose mode.

>short
Superbrief mode is disabled in this game.

* * *

This is the day you've always dreamed of. You are finally marrying the love of your life, Prince Roland.

Castle Garden
You are standing in the garden behind your family's castle. On this lovely fall evening, it is doing double duty as a wedding chapel.

Your betrothed, Roland, stands before you.

You can also see Father Alfred here.

>verbose
The Paper Bag Princess is now in its "verbose" mode, which always gives long descriptions of locations (even if you've been there before).

>brief
The Paper Bag Princess is now in its "brief" printing mode, which gives long descriptions of places never before visited and short descriptions otherwise.

>superbrief
The Paper Bag Princess is now in its "superbrief" mode, which always gives short descriptions of locations (even if you haven't been there before).

* * *

This is the day you've always dreamed of. You are finally marrying the love of your life, Prince Roland.

Castle Garden
You are standing in the garden behind your family's castle. On this lovely fall evening, it is doing double duty as a wedding chapel.

Your betrothed, Roland, stands before you.

You can also see Father Alfred here.

>make a torch
How do you plan to do that?

---

>i
You are carrying a bouquet.

...

* * *

>make a torch
How do you plan to do that?

---

>z.z
You beam happily at Roland.

...

You beam happily at Roland.

,,,,

DRAGON!

Please press SPACE to continue.

* * *

The Paper Bag Princess
An interactive fairy tale by Adri
Release 1 / Serial number 130920 / Inform 7 build 6G60 (I6/v6.32 lib 6/12N) SD

Castle Ruins
No more castle. pile of rubble

>n
Burnt Forest
There's a trail of burned trees and horses' teeth leading to the northeast.

You can see a branch and a pine sap here.

>remove dress
You strip off the remains of your wedding gown and discard them in a pile of rubble.

>take branch
Taken.

>put branch on dress
You make a torch!

>undo
Burnt Forest
[Previous turn undone.]

>put dress on branch
You make a torch!

>undo
Burnt Forest
[Previous turn undone.]

>make a torch
You make a torch!

>i
You are carrying a torch and a bouquet.

* * *

This is the day you've always dreamed of. You are finally marrying the love of your life, Prince Roland.

Castle Garden
You are standing in the garden behind your family's castle. On this lovely fall evening, it is doing double duty as a wedding chapel.

Your betrothed, Roland, stands before you.

You can also see Father Alfred here.

>make torch
You can't see any such thing.

* * *

This is the day you've always dreamed of. You are finally marrying the love of your life, Prince Roland.

Castle Garden
You are standing in the garden behind your family's castle. On this lovely fall evening, it is doing double duty as a wedding chapel.

Your betrothed, Roland, stands before you.

You can also see Father Alfred here.

>xyzz
That's not a verb I recognize.

>xyzzy
POOF! Your fairy godmother appears. She smiles at you and places a necklace around your neck.

---

>x me
You are the loveliest princess in the land.

You are wearing necklace, wedding gown, and sparkly gold crown and a long, white wedding gown.

...

>i
You are carrying a bouquet.

,,,,

DRAGON!

Please press SPACE to continue.

* * *

This is the day you've always dreamed of. You are finally marrying the love of your life, Prince Roland.

Castle Garden
You are standing in the garden behind your family's castle. On this lovely fall evening, it is doing double duty as a wedding chapel.

Your betrothed, Roland, stands before you.

You can also see Father Alfred here.

>drink
What do you want to drink?

* * *

This is the day you've always dreamed of. You are finally marrying the love of your life, Prince Roland.

Castle Garden
You are standing in the garden behind your family's castle. On this lovely fall evening, it is doing double duty as a wedding chapel.

Your betrothed, Roland, stands before you.

You can also see Father Alfred here.

>xyzzy.z.z
POOF! Your fairy godmother appears. She smiles at you and places a a necklace around your neck.

---

You beam happily at Roland.

...

You beam happily at Roland.

,,,,

DRAGON!

Please press SPACE to continue.

The Paper Bag Princess
An interactive fairy tale by Adri
Release 1 / Serial number 130921 / Inform 7 build 6G60 (I6/v6.32 lib 6/12N) SD

Castle Ruins
No more castle. pile of rubble flame

>n.xyzzy.ne
Burnt Forest
There's a trail of burned trees and horses' teeth leading to the northeast. One tree in particular catches your eye.

The necklace suddenly begins to glow.

The woods seem pretty dark. Maybe you should find a light source.

* * *

The Paper Bag Princess
An interactive fairy tale by Adri
Release 1 / Serial number 130921 / Inform 7 build 6G60 (I6/v6.32 lib 6/12N) SD

Castle Ruins
No more castle. pile of rubble flame

>xyzzy.n.ne
The necklace suddenly begins to glow.

Burnt Forest
There's a trail of burned trees and horses' teeth leading to the northeast. One tree in particular catches your eye.

The woods seem pretty dark. Maybe you should find a light source.

>x necklace
A heart-shaped pendant on a gold chain. It is glowing with a soft white light.

>ne
The woods seem pretty dark. Maybe you should find a light source.

* * *

The Paper Bag Princess
An interactive fairy tale by Adri
Release 1 / Serial number 130921 / Inform 7 build 6G60 (I6/v6.32 lib 6/12N) SD

Castle Ruins
No more castle. pile of rubble flame

>n.ne
Burnt Forest
There's a trail of burned trees and horses' teeth leading to the northeast. One tree in particular catches your eye.

The woods seem pretty dark. Maybe you should find a light source.

>restart
Are you sure you want to restart?

* * *

>y
Something something something

Throne Room
This is it. You're finally getting married!

Your betrothed, Roland, stands before you.

>z.z.z
You beam happily at Roland.

---

You beam happily at Roland.

...

You beam happily at Roland.

,,,,

DRAGON!

Please press SPACE to continue.

The Paper Bag Princess
An interactive fairy tale by Adri
Release 1 / Serial number 130921 / Inform 7 build 6G60 (I6/v6.32 lib 6/12N) SD

Castle Ruins
No more castle. pile of rubble

* * *

This is the day you've always dreamed of. You are finally marrying the love of your life, Prince Roland.

Castle Garden
You are standing in the garden behind your family's castle. On this lovely fall evening, it is doing double duty as a wedding chapel.

Your betrothed, Roland, stands before you.

You can also see Father Alfred here.

>xyzzy.xyzzy.z
POOF! Your fairy godmother appears. She smiles at you and places a a necklace around your neck.

---

The necklace suddenly begins to glow.

...

You beam happily at Roland.

,,,,

DRAGON!

Please press SPACE to continue.

The Paper Bag Princess
An interactive fairy tale by Adri
Release 1 / Serial number 130926 / Inform 7 build 6G60 (I6/v6.32 lib 6/12N) SD

Castle Ruins
No more castle. pile of rubble the embers

>n.ne
Burnt Forest
There's a trail of burned trees and horses' teeth leading to the northeast. One tree in particular catches your eye.

Dimly Lit Forest
Something something something.

>drop necklace
(first taking the necklace off)
You drop the necklace. The light immediately winks out.

You are now alone in the dark.

>n
You stumble and cannot find your way.

>n
Darkness
In the darkness something something something.

>ne
Darkness
In the darkness something something something.

* * *

>n
You stumble and cannot find your way.

>e
You stumble and cannot find your way.

>w
You stumble and cannot find your way.

>undo
Darkness
[Previous turn undone.]

>l
Darkness
In the darkness something something something.

>x me
It's not totally dark here, perhaps, but certainly too dim for close-up examination of anything.

* * *

>n
You stumble and cannot find your way.

>x me
It's not totally dark here, perhaps, but certainly too dim for close-up examination of anything.

>i
You are carrying nothing.

* * *

>drop necklace
(first taking the necklace off)
You drop the necklace. The light immediately winks out.

You are now alone in the dark.

>l
Dark Forest
In the darkness something something something

>take necklace
You can't see any such thing.

>x necklace
You can't see any such thing.

>x me
It's not totally dark here, perhaps, but certainly too dim for close-up examination of anything.

* * *

>i
You are carrying nothing.

>x rags
It's not totally dark here, perhaps, but certainly too dim for close-up examination of anything.

>find
That's not a verb I recognize.

* * *

>l
Dark Forest
In the darkness something something something

>x necklace
You can't see that in the dark.

>take necklace
You drop to your hands and knees and desperately feel around for the necklace. You eventually find it, although you break a nail in the process.

>xyzzy
The necklace suddenly begins to glow.

Dimly Lit Forest
Something something something.

>break
What do you want to break?

>break necklace
Violence isn't the answer to this one.

* * *

>drop necklace
(first taking the necklace off)
You drop the necklace. The light immediately winks out.

You are now alone in the dark.

>x necklace
You can't see any such thing.

>take necklace
You can't see any such thing.

>undo
Dark Forest
[Previous turn undone.]

>undo
Dark Forest
[Previous turn undone.]

>l
Dark Forest
In the darkness something something something

>xyzzy
You need to be holding the necklace for that to work.

>undo
Dark Forest
[Previous turn undone.]

>undo
Castle Ruins
[Previous turn undone.]

>ne
You can't go that way.

>n
Burnt Forest
There's a trail of burned trees and horses' teeth leading to the northeast. One tree in particular catches your eye.

>ne
Dark Forest
Something something something.

>xyzzy.drop necklace
The necklace abruptly stops glowing.

You are now alone in the dark.

That's a great way to lose something.

>xyzzy
The necklace suddenly begins to glow.

Dark Forest
Something something something.

* * *

>n.ne
Burnt Forest
There's a trail of burned trees and horses' teeth leading to the northeast. One tree in particular catches your eye.

Dimly Lit Forest
Something something something.

>xyzzy
The necklace abruptly stops glowing.

You are now alone in the dark.

>l
Dark Forest
In the darkness something something something

>x necklace
It's not totally dark here, perhaps, but certainly too dim for close-up examination of anything.

>xyzzy
The necklace suddenly begins to glow.

Dark Forest
Something something something.

>undo
Dark Forest
[Previous turn undone.]

>drop necklace
(first taking the necklace off)
You drop the necklace. The light immediately winks out.

* * *

The Paper Bag Princess
An interactive fairy tale by Adri
Release 1 / Serial number 130926 / Inform 7 build 6G60 (I6/v6.32 lib 6/12N) SD

Castle Ruins
No more castle. pile of rubble the embers

>x necklace
A heart-shaped pendant on a gold chain.

* * *

The Paper Bag Princess
An interactive fairy tale by Adri
Release 1 / Serial number 130926 / Inform 7 build 6G60 (I6/v6.32 lib 6/12N) SD

Castle Ruins
No more castle. pile of rubble the embers

>search rubble.wear bag.n.ne.n.n.n.n.n.n.n.n.n.n
You find a paper bag.

(first taking the paper bag)
You quickly fashion a dress out of the gift bag. It's not as fancy as you're used to, but it'll get the job done.

Burnt Forest
There's a trail of burned trees and horses' teeth leading to the northeast. One tree in particular catches your eye.

Dimly Lit Forest
Something something something.

Dimly Lit Forest
Something something something.

Dimly Lit Forest
Something something something.

Dimly Lit Forest
Something something something.

Dimly Lit Forest
Something something something.

Dimly Lit Forest
Something something something.

Dimly Lit Forest
Something something something.

Dimly Lit Forest
Something something something.

Dimly Lit Forest
Something something something.

Dimly Lit Forest
Something something something.

There is a bush here covered with berries.

Cave Exterior
Cave Door.

>n.n.n
Cave Exterior
You can't go that way.

You can't go that way.

>knock
(the Cave Door)
You grab the knocker and bang on the door.

The dragon sticks his nose out the door and says, "Well, a princess! I love to eat princesses, but I have already eaten a whole castle today. I am a very busy dragon. Come back tomorrow." 

Then he slams the door.

>knock.shout
You can't see any such thing.

>knock
(the Cave Door)
You grab the knocker and bang on the door again.

The dragon sticks his nose out the door and says, "Well, a princess! I love to eat princesses, but I have already eaten a whole castle today. I am a very busy dragon. Come back tomorrow." 

This time he pauses a moment before slamming the door.

>shout
You shout at the dragon.

lalalalalala.

>ask about flame
(addressing the dragon)
The dragon says, "I don't know anything about that."

* * *

>knock on door.g.shout
You grab the knocker and bang on the door.

The dragon sticks his nose out the door and says, "Well, a princess! I love to eat princesses, but I have already eaten a whole castle today. I am a very busy dragon. Come back tomorrow." 

Then he slams the door.

You grab the knocker and bang on the door again.

The dragon sticks his nose out the door and says, "Well, a princess! I love to eat princesses, but I have already eaten a whole castle today. I am a very busy dragon. Come back tomorrow." 

This time he pauses a moment before slamming the door.

You shout at the dragon.

lalalalalala.

>ask dragon about fire
"Is it true," you say, "that you can burn up ten forests with your fiery breath?"

"Oh, yes", says the dragon, and he takes a huge, deep breath and breathes out so much fire that he burns up fifty forests.

Wasn't that amazing?

>y
"Fantastic!" you exclaim. "Do it again!"
The dragon takes another huge breath and breathes out so much fire that he burns up one hundred forests.

Were you impressed by that display?

>y
"Magnificent!" you shout. "Do it again!"

* * *

>knock on door.g
You grab the knocker and bang on the door.

The dragon sticks his nose out the door and says, "Well, a princess! I love to eat princesses, but I have already eaten a whole castle today. I am a very busy dragon. Come back tomorrow." 

Then he slams the door.

You grab the knocker and bang on the door again.

The dragon sticks his nose out the door and says, "Well, a princess! I love to eat princesses, but I have already eaten a whole castle today. I am a very busy dragon. Come back tomorrow." 

This time he pauses a moment before slamming the door.

>shout
You shout at the dragon.

lalalalalala.

>ask dragon about fire
"Is it true," you say, "that you can burn up ten forests with your fiery breath?"

"Oh, yes", says the dragon, and he takes a huge, deep breath and breathes out so much fire that he burns up fifty forests.

Wasn't that amazing?

>no
You shake your head in disappointment.

* * *

The Paper Bag Princess
An interactive fairy tale by Adri
Release 1 / Serial number 130926 / Inform 7 build 6G60 (I6/v6.32 lib 6/12N) SD

Castle Ruins
No more castle. pile of rubble the embers

>x embers
dragon fire.

>x fire
dragon fire.

I beg your pardon?

>x flame
dragon fire.

>search rubble.wear bag.n.ne.n.n.n.n.n.n
You find a paper bag.

(first taking the paper bag)
You quickly fashion a dress out of the gift bag. It's not as fancy as you're used to, but it'll get the job done.

Burnt Forest
There's a trail of burned trees and horses' teeth leading to the northeast. One tree in particular catches your eye.

Dimly Lit Forest
Something something something.

Dimly Lit Forest
Something something something.

There is a shiny ring here.

Dimly Lit Forest
Something something something.

Dimly Lit Forest
Something something something.

There is a bush here covered with berries.

Dimly Lit Forest
Something something something.

Dimly Lit Forest
Something something something.

Dimly Lit Forest
Something something something.

>n.n.n.n
Dimly Lit Forest
Something something something.

Dimly Lit Forest
Something something something.

There is a dagger here.

Cave Exterior
You can't go that way.

>knock on door
You grab the knocker and bang on the door.

The dragon sticks his nose out the door and says, "Well, a princess! I love to eat princesses, but I have already eaten a whole castle today. I am a very busy dragon. Come back tomorrow." 

Then he slams the door.

>knock
(the Cave Door)
You grab the knocker and bang on the door again.

The dragon sticks his nose out the door and says, "Well, a princess! I love to eat princesses, but I have already eaten a whole castle today. I am a very busy dragon. Come back tomorrow." 

This time he pauses a moment before slamming the door.

* * *

>shout
You shout at the dragon.

lalalalalala.

>ask about flame
(addressing the dragon)
"Is it true," you say, "that you can burn up ten forests with your fiery breath?"

"Oh, yes", says the dragon, and he takes a huge, deep breath and breathes out so much fire that he burns up fifty forests.

Were you impressed by that display?

>yes
"Fantastic!" you exclaim. "Do it again!"

The dragon says, "I don't know anything about that."

>ask about flame
The dragon takes another huge breath and breathes out so much fire that he burns up one hundred forests.

Wasn't that amazing?

>no
You shake your head in disappointment.

The dragon says, "I don't know anything about that."

>ask about fire
The dragon takes another huge breath. But this time, nothing comes out.

>ask about flame
The dragon doesn't have enough fire left to cook a meatball!

>ask about flame
The dragon doesn't have enough fire left to cook a meatball!

>dragon, eat me
(The dragon first taking yourself)
The dragon has better things to do.

* * *

The Paper Bag Princess
An interactive fairy tale by Adri
Release 1 / Serial number 130926 / Inform 7 build 6G60 (I6/v6.32 lib 6/12N) SD

Castle Ruins
No more castle. pile of rubble the embers

>search rubble.wear bag.n.ne.n.n.n.n.n.n.n.n.n.n.n.n.n.n
You find a paper bag.

(first taking the paper bag)
You quickly fashion a dress out of the gift bag. It's not as fancy as you're used to, but it'll get the job done.

Burnt Forest
There's a trail of burned trees and horses' teeth leading to the northeast. One tree in particular catches your eye.

Dimly Lit Forest
Something something something.

Dimly Lit Forest
Something something something.

Dimly Lit Forest
Something something something.

Dimly Lit Forest
Something something something.

Dimly Lit Forest
Something something something.

Dimly Lit Forest
Something something something.

Dimly Lit Forest
Something something something.

Dimly Lit Forest
Something something something.

Dimly Lit Forest
Something something something.

Cave Exterior
Cave Door.

You can't go that way.

You can't go that way.

You can't go that way.

You can't go that way.

You can't go that way.

>s
You can't go that way.

>knock
(the Cave Door)
You grab the knocker and bang on the door.

The dragon sticks his nose out the door and says, "Well, a princess! I love to eat princesses, but I have already eaten a whole castle today. I am a very busy dragon. Come back tomorrow." 

Then he slams the door.

>knock
(the Cave Door)
You grab the knocker and bang on the door again.

The dragon sticks his nose out the door and says, "Well, a princess! I love to eat princesses, but I have already eaten a whole castle today. I am a very busy dragon. Come back tomorrow." 

This time he pauses a moment before slamming the door.

* * *

>shout
You shout at the dragon.

lalalalalala.

>ask about fire
(addressing the dragon)
"Is it true," you say, "that you can burn up ten forests with your fiery breath?"

"Oh, yes", says the dragon, and he takes a huge, deep breath and breathes out so much fire that he burns up fifty forests.

Were you impressed by that display?

>y
"Fantastic!" you exclaim. "Do it again!"

The dragon says, "I don't know anything about that."

* * *

>knock on door.g.shout
You grab the knocker and bang on the door.

The dragon sticks his nose out the door and says, "Well, a princess! I love to eat princesses, but I have already eaten a whole castle today. I am a very busy dragon. Come back tomorrow." 

Then he slams the door.

You grab the knocker and bang on the door again.

The dragon sticks his nose out the door and says, "Well, a princess! I love to eat princesses, but I have already eaten a whole castle today. I am a very busy dragon. Come back tomorrow." 

This time he pauses a moment before slamming the door.

You shout at the dragon.

lalalalalala.

>ask about fire
(addressing the dragon)
"Is it true," you say, "that you can burn up ten forests with your fiery breath?"

"Oh, yes", says the dragon, and he takes a huge, deep breath and breathes out so much fire that he burns up fifty forests.

Wasn't that amazing?

>y
"Fantastic!" you exclaim. "Do it again!"

The dragon takes another huge breath and breathes out so much fire that he burns up one hundred forests.

Were you impressed by that display?

>y
"Magnificent!" you shout. "Do it again!"

The dragon takes another huge breath. But this time, nothing comes out.

>ask dragon about fire
The dragon doesn't have enough fire left to cook a meatball!

* * *

The Paper Bag Princess
An interactive fairy tale by Adri
Release 1 / Serial number 130926 / Inform 7 build 6G60 (I6/v6.32 lib 6/12N) SD

Castle Ruins
No more castle. pile of rubble the embers

>search rubble.wear bag.n.ne.n.n.n.n.n.n.n.n.n
You find a paper bag.

(first taking the paper bag)
You quickly fashion a dress out of the gift bag. It's not as fancy as you're used to, but it'll get the job done.

Burnt Forest
There's a trail of burned trees and horses' teeth leading to the northeast. One tree in particular catches your eye.

Dimly Lit Forest
Something something something.

Dimly Lit Forest
Something something something.

Dimly Lit Forest
Something something something.

Dimly Lit Forest
Something something something.

There is a patch of mushrooms here.

Dimly Lit Forest
Something something something.

There is a shiny ring here.

Dimly Lit Forest
Something something something.

Cave Exterior
Cave Door.

You can't go that way.

You can't go that way.

You can't go that way.

>knock on door
You grab the knocker and bang on the door.

The dragon sticks his nose out the door and says, "Well, a princess! I love to eat princesses, but I have already eaten a whole castle today. I am a very busy dragon. Come back tomorrow." 

Then he slams the door.

* * *

>knock
(the Cave Door)
You grab the knocker and bang on the door again.

The dragon sticks his nose out the door and says, "Well, a princess! I love to eat princesses, but I have already eaten a whole castle today. I am a very busy dragon. Come back tomorrow." 

This time he pauses a moment before slamming the door.

>ask dragon about fire
The dragon slams the door in your face.

>undo
Cave Exterior
[Previous turn undone.]

>shout
You shout at the dragon.

lalalalalala.

>ask dragon about fire
"Is it true," you say, "that you can burn up ten forests with your fiery breath?"

"Oh, yes", says the dragon, and he takes a huge, deep breath and breathes out so much fire that he burns up fifty forests.

Were you impressed by that display?

>yes
"Fantastic!" you exclaim. "Do it again!"

The dragon says, "I don't know anything about that."

* * *

The Paper Bag Princess
An interactive fairy tale by Adri
Release 1 / Serial number 130926 / Inform 7 build 6G60 (I6/v6.32 lib 6/12N) SD

Castle Ruins
No more castle. pile of rubble the embers

>search rubble.wear bag.n.ne.n.n.n.n.n.n.n.n.n.n.n.n
You find a paper bag.

(first taking the paper bag)
You quickly fashion a dress out of the gift bag. It's not as fancy as you're used to, but it'll get the job done.

Burnt Forest
There's a trail of burned trees and horses' teeth leading to the northeast. One tree in particular catches your eye.

Dimly Lit Forest
Something something something.

Dimly Lit Forest
Something something something.

There is a shiny ring here.

Dimly Lit Forest
Something something something.

There is a dagger here.

Dimly Lit Forest
Something something something.

Dimly Lit Forest
Something something something.

Dimly Lit Forest
Something something something.

Dimly Lit Forest
Something something something.

Dimly Lit Forest
Something something something.

Dimly Lit Forest
Something something something.

Dimly Lit Forest
Something something something.

There is a bush here covered with berries.

Dimly Lit Forest
Something something something.

Cave Exterior
Cave Door.

You can't go that way.

>knock on cave door.g
You grab the knocker and bang on the door.

The dragon sticks his nose out the door and says, "Well, a princess! I love to eat princesses, but I have already eaten a whole castle today. I am a very busy dragon. Come back tomorrow." 

Then he slams the door.

You grab the knocker and bang on the door again.

The dragon sticks his nose out the door and says, "Well, a princess! I love to eat princesses, but I have already eaten a whole castle today. I am a very busy dragon. Come back tomorrow." 

This time he pauses a moment before slamming the door.

>shout
You shout at the dragon.

lalalalalala.

* * *

>ask about fire
(addressing the dragon)
"Is it true," you say, "that you can burn up ten forests with your fiery breath?"

"Oh, yes", says the dragon, and he takes a huge, deep breath and breathes out so much fire that he burns up fifty forests.

Were you impressed by that display?

>y
"Fantastic!" you exclaim. "Do it again!"

The dragon takes another huge breath and breathes out so much fire that he burns up one hundred forests.

Wasn't that amazing?

* * *

>y
"Magnificent!" you shout. "Do it again!"

The dragon takes another huge breath. But this time, nothing comes out.

>dragon, eat me
Nah

>ask dragon about flying
You say, "Dragon, is it true that you can fly around the world in just ten seconds?"

"Why, yes," says the dragon, and he jumps up and flies around the world in just ten seconds. He seems very tired when he returns.

Were you impressed by that display?

>y
"Fantastic!" you exclaim. "Do it again!"

The dragon jumps up and flies around the whole world in just twenty seconds. When he returns, he flops down on the ground.

The dragon falls asleep.

* * *

The Paper Bag Princess
An interactive fairy tale by Adri
Release 1 / Serial number 130926 / Inform 7 build 6G60 (I6/v6.32 lib 6/12N) SD

Castle Ruins
No more castle. pile of rubble the embers

>search rubble.wear bag.n.ne.n.n.n.n.n.n.n.n.n.n.n
You find a paper bag.

(first taking the paper bag)
You quickly fashion a dress out of the gift bag. It's not as fancy as you're used to, but it'll get the job done.

Burnt Forest
There's a trail of burned trees and horses' teeth leading to the northeast. One tree in particular catches your eye.

Dimly Lit Forest
Something something something.

Dimly Lit Forest
Something something something.

Dimly Lit Forest
Something something something.

Dimly Lit Forest
Something something something.

Dimly Lit Forest
Something something something.

Dimly Lit Forest
Something something something.

Dimly Lit Forest
Something something something.

Cave Exterior
Cave Door.

You can't go that way.

You can't go that way.

You can't go that way.

You can't go that way.

>knock on door.g.shout
You grab the knocker and bang on the door.

The dragon sticks his nose out the door and says, "Well, a princess! I love to eat princesses, but I have already eaten a whole castle today. I am a very busy dragon. Come back tomorrow." 

Then he slams the door.

You grab the knocker and bang on the door again.

The dragon sticks his nose out the door and says, "Well, a princess! I love to eat princesses, but I have already eaten a whole castle today. I am a very busy dragon. Come back tomorrow." 

This time he pauses a moment before slamming the door.

You shout at the dragon.

lalalalalala.

>ask about fire
(addressing the dragon)
"Is it true," you say, "that you can burn up ten forests with your fiery breath?"

"Oh, yes", says the dragon, and he takes a huge, deep breath and breathes out so much fire that he burns up fifty forests.

Were you impressed by that display?

>y
"Fantastic!" you exclaim. "Do it again!"
The dragon takes another huge breath and breathes out so much fire that he burns up one hundred forests.

>n
You can't go that way.

* * *

The Paper Bag Princess
An interactive fairy tale by Adri
Release 1 / Serial number 130926 / Inform 7 build 6G60 (I6/v6.32 lib 6/12N) SD

Castle Ruins
No more castle. pile of rubble the embers

>search rubble.wear bag.n.ne.n.n.n.n.n.n.n
You find a paper bag.

(first taking the paper bag)
You quickly fashion a dress out of the gift bag. It's not as fancy as you're used to, but it'll get the job done.

Burnt Forest
There's a trail of burned trees and horses' teeth leading to the northeast. One tree in particular catches your eye.

Dimly Lit Forest
Something something something.

Dimly Lit Forest
Something something something.

Dimly Lit Forest
Something something something.

Dimly Lit Forest
Something something something.

Dimly Lit Forest
Something something something.

Dimly Lit Forest
Something something something.

Dimly Lit Forest
Something something something.

Dimly Lit Forest
Something something something.

>n.n.n.n.n
Dimly Lit Forest
Something something something.

Dimly Lit Forest
Something something something.

Cave Exterior
Cave Door.

You can't go that way.

You can't go that way.

>knock on door.g.shout
You grab the knocker and bang on the door.

The dragon sticks his nose out the door and says, "Well, a princess! I love to eat princesses, but I have already eaten a whole castle today. I am a very busy dragon. Come back tomorrow." 

Then he slams the door.

You grab the knocker and bang on the door again.

The dragon sticks his nose out the door and says, "Well, a princess! I love to eat princesses, but I have already eaten a whole castle today. I am a very busy dragon. Come back tomorrow." 

This time he pauses a moment before slamming the door.

You shout at the dragon.

lalalalalala.

* * *

>ask dragon about fire
"Is it true," you say, "that you can burn up ten forests with your fiery breath?"

"Oh, yes", says the dragon, and he takes a huge, deep breath and breathes out so much fire that he burns up fifty forests.

Wasn't that amazing?

>y
"Fantastic!" you exclaim. "Do it again!"

The dragon takes another huge breath and breathes out so much fire that he burns up one hundred forests.

Were you impressed by that display?

>n
Apparently it takes a lot to impress you! But you force yourself to look delighted as you shout, "Do it again!"

The dragon does not respond.

* * *

The Paper Bag Princess
An interactive fairy tale by Adri
Release 1 / Serial number 130926 / Inform 7 build 6G60 (I6/v6.32 lib 6/12N) SD

Castle Ruins
No more castle. pile of rubble the embers

>search rubble.wear bag.ne.n.n.n.n.n.n.n.n.n.n.n.n.n.n.n
You find a paper bag.

(first taking the paper bag)
You quickly fashion a dress out of the gift bag. It's not as fancy as you're used to, but it'll get the job done.

You can't go that way.

Burnt Forest
There's a trail of burned trees and horses' teeth leading to the northeast. One tree in particular catches your eye.

The trees are impassable in that direction. The trail seems to be leading northeast.

The trees are impassable in that direction. The trail seems to be leading northeast.

The trees are impassable in that direction. The trail seems to be leading northeast.

The trees are impassable in that direction. The trail seems to be leading northeast.

The trees are impassable in that direction. The trail seems to be leading northeast.

The trees are impassable in that direction. The trail seems to be leading northeast.

The trees are impassable in that direction. The trail seems to be leading northeast.

The trees are impassable in that direction. The trail seems to be leading northeast.

The trees are impassable in that direction. The trail seems to be leading northeast.

The trees are impassable in that direction. The trail seems to be leading northeast.

The trees are impassable in that direction. The trail seems to be leading northeast.

The trees are impassable in that direction. The trail seems to be leading northeast.

The trees are impassable in that direction. The trail seems to be leading northeast.

The trees are impassable in that direction. The trail seems to be leading northeast.

>ne.n.n.n.n.n.n.n.n.n.n.n.n.n.n
Dimly Lit Forest
Something something something.

Dimly Lit Forest
Something something something.

Dimly Lit Forest
Something something something.

Dimly Lit Forest
Something something something.

Dimly Lit Forest
Something something something.

Dimly Lit Forest
Something something something.

There is a bush here covered with berries.

Dimly Lit Forest
Something something something.

Dimly Lit Forest
Something something something.

Dimly Lit Forest
Something something something.

Dimly Lit Forest
Something something something.

Cave Exterior
Cave Door.

You can't go that way.

You can't go that way.

You can't go that way.

You can't go that way.

>knock on door.g.shout
You grab the knocker and bang on the door.

The dragon sticks his nose out the door and says, "Well, a princess! I love to eat princesses, but I have already eaten a whole castle today. I am a very busy dragon. Come back tomorrow." 

Then he slams the door.

You grab the knocker and bang on the door again.

The dragon sticks his nose out the door and says, "Well, a princess! I love to eat princesses, but I have already eaten a whole castle today. I am a very busy dragon. Come back tomorrow." 

This time he pauses a moment before slamming the door.

You shout at the dragon.

lalalalalala.

>ask dragon about fire
"Is it true," you say, "that you can burn up ten forests with your fiery breath?"

"Oh, yes", says the dragon, and he takes a huge, deep breath and breathes out so much fire that he burns up fifty forests.

Were you impressed by that display?

>y
"Fantastic!" you exclaim. "Do it again!"

The dragon takes another huge breath and breathes out so much fire that he burns up one hundred forests.

Wasn't that amazing?

>n
Apparently it takes a lot to impress you! But you force yourself to look delighted as you shout, "Do it again!"

The dragon says, "I'm afraid I don't know anything about that."

* * *

The Paper Bag Princess
An interactive fairy tale by Adri
Release 1 / Serial number 130926 / Inform 7 build 6G60 (I6/v6.32 lib 6/12N) SD

Castle Ruins
No more castle. pile of rubble the embers

>search rubble.wear bag.n.ne.n.n.n.n.n.n.n.n.n.n.n.n.n
You find a paper bag.

(first taking the paper bag)
You quickly fashion a dress out of the gift bag. It's not as fancy as you're used to, but it'll get the job done.

Burnt Forest
There's a trail of burned trees and horses' teeth leading to the northeast. One tree in particular catches your eye.

Dimly Lit Forest
Something something something.

Dimly Lit Forest
Something something something.

There is a patch of mushrooms here.

Dimly Lit Forest
Something something something.

Dimly Lit Forest
Something something something.

Dimly Lit Forest
Something something something.

Dimly Lit Forest
Something something something.

Dimly Lit Forest
Something something something.

Dimly Lit Forest
Something something something.

There is a patch of mushrooms here.

Cave Exterior
Cave Door.

You can't go that way.

You can't go that way.

You can't go that way.

You can't go that way.

You can't go that way.

>knock on door.g.shout
You grab the knocker and bang on the door.

The dragon sticks his nose out the door and says, "Well, a princess! I love to eat princesses, but I have already eaten a whole castle today. I am a very busy dragon. Come back tomorrow." 

Then he slams the door.

You grab the knocker and bang on the door again.

The dragon sticks his nose out the door and says, "Well, a princess! I love to eat princesses, but I have already eaten a whole castle today. I am a very busy dragon. Come back tomorrow." 

This time he pauses a moment before slamming the door.

You shout at the dragon.

lalalalalala.

* * *

>ask dragon about fire
"Is it true," you say, "that you can burn up ten forests with your fiery breath?"

"Oh, yes", says the dragon, and he takes a huge, deep breath and breathes out so much fire that he burns up fifty forests.

Were you impressed by that display?

>n
Apparently it takes a lot to impress you! But you force yourself to look delighted as you shout, "Do it again!"

The dragon takes another huge breath and breathes out so much fire that he burns up one hundred forests.

Wasn't that amazing?

>y
"Fantastic!" you exclaim. "Do it again!"

The dragon takes another huge breath. But this time, nothing comes out.

>tell dragon about flight
You say, "Dragon, is it true that you can fly around the world in just ten seconds?"

"Why, yes," says the dragon, and he jumps up and flies around the world in just ten seconds. He seems very tired when he returns.

Were you impressed by that display?

>n
Apparently it takes a lot to impress you! But you force yourself to look delighted as you shout, "Do it again!"

The dragon jumps up and flies around the whole world in just twenty seconds. When he returns, he flops down on the ground.

The dragon falls asleep.

>undo
Cave Exterior
[Previous turn undone.]

>ask dragon about life
The dragon says, "I'm afraid I don't know anything about that."

>ask dragon about me
The dragon says, "I love to eat princesses, but I have already eaten a whole castle today. Come back tomorrow."

>dragon, eat me
Nah.

>dragon, eat necklace
Nah.

>flatter dragon
Maybe you could try asking the dragon about fire or flight.

* * *

This is the day you've always dreamed of. You are finally marrying the love of your life, Prince Roland.

Castle Garden
You are standing in the garden behind your family's castle. On this lovely fall evening, it is doing double duty as a wedding chapel.

Your betrothed, Roland, stands before you.

You can also see Father Alfred here.

>attack roland
Violence isn't the answer to this one.

---

>hug roland
You'll have your chance soon enough!

...

>take roland
I don't suppose Roland would care for that.

,,,,

DRAGON!

Please press SPACE to continue.

* * *

This is the day you've always dreamed of. You are finally marrying the love of your life, Prince Roland.

Castle Garden
You are standing in the garden behind your family's castle. On this lovely fall evening, it is doing double duty as a wedding chapel.

Your betrothed, Roland, stands before you.

You can also see Father Alfred here.

>marry me
You are always self-possessed.

---

>marry priest
You can only do that to something animate.

>marry roland
Yes, Elizabeth. That's why you're here.

...

* * *

This is the day you've always dreamed of. You are finally marrying the love of your life, Prince Roland.

Castle Garden
You are standing in the garden behind your family's castle. On this lovely fall evening, it is doing double duty as a wedding chapel.

Your betrothed, Roland, stands before you.

You can also see Father Alfred here.

>burn
What do you want to burn?

* * *

This is the day you've always dreamed of. You are finally marrying the love of your life, Prince Roland.

Castle Garden
You are standing in the garden behind your family's castle. On this lovely fall evening, it is doing double duty as a wedding chapel.

Your betrothed, Roland, stands before you.

You can also see Father Alfred here.

>burn me with rags
You can't see any such thing.

>burn me with dress
---

* * *

This is the day you've always dreamed of. You are finally marrying the love of your life, Prince Roland.

Castle Garden
You are standing in the garden behind your family's castle. On this lovely fall evening, it is doing double duty as a wedding chapel.

Your betrothed, Roland, stands before you.

You can also see Father Alfred here.

>burn me with dress
Don't be silly.

---

* * *

This is the day you've always dreamed of. You are finally marrying the love of your life, Prince Roland.

Castle Garden
You are standing in the garden behind your family's castle. On this lovely fall evening, it is doing double duty as a wedding chapel.

Your betrothed, Roland, stands before you.

You can also see Father Alfred here.

>fuck
Real adventurers do not use such language.

---

>curses
Quite.

...

>sing
Your singing is abominable.

,,,,

DRAGON!

Please press SPACE to continue.

* * *

This is the day you've always dreamed of. You are finally marrying the love of your life, Prince Roland.

Castle Garden
You are standing in the garden behind your family's castle. On this lovely fall evening, it is doing double duty as a wedding chapel.

Your betrothed, Roland, stands before you.

You can also see Father Alfred here.

>curses
The priest blushes profusely and continues the ceremony.

---

>fuck roland
I only understood you as far as wanting to fuck.

* * *

This is the day you've always dreamed of. You are finally marrying the love of your life, Prince Roland.

Castle Garden
You are standing in the garden behind your family's castle. On this lovely fall evening, it is doing double duty as a wedding chapel.

Your betrothed, Roland, stands before you.

You can also see Father Alfred here.

>score
There is no score in this story.

>full score
That's not a verb I recognize.

* * *

This is the day you've always dreamed of. You are finally marrying the love of your life, Prince Roland.

Castle Garden
You are standing in the garden behind your family's castle. On this lovely fall evening, it is doing double duty as a wedding chapel.

Your betrothed, Roland, stands before you.

You can also see Father Alfred here.

>xyzzy.g.z
POOF! Your fairy godmother appears. She smiles at you and places a a necklace around your neck.

---

The necklace suddenly begins to glow.

...

You beam happily at Roland.

,,,,

DRAGON!

Please press SPACE to continue.

The Paper Bag Princess
An interactive fairy tale by Adri
Release 1 / Serial number 130926 / Inform 7 build 6G60 (I6/v6.32 lib 6/12N) SD

Castle Ruins
No more castle. pile of rubble the embers

>search rubble.wear bag.n.ne.n.n.n.n.n.n.n.n.n.n.n
You find a paper bag.

(first taking the paper bag)
You quickly fashion a dress out of the gift bag. It's not as fancy as you're used to, but it'll get the job done.

Burnt Forest
There's a trail of burned trees and horses' teeth leading to the northeast. One tree in particular catches your eye.

Dimly Lit Forest
Something something something.

Dimly Lit Forest
Something something something.

Dimly Lit Forest
Something something something.

Dimly Lit Forest
Something something something.

Dimly Lit Forest
Something something something.

Dimly Lit Forest
Something something something.

Cave Exterior
Cave Door.

You can't go that way.

You can't go that way.

You can't go that way.

You can't go that way.

You can't go that way.

>knock on door.g.shout
You grab the knocker and bang on the door.

The dragon sticks his nose out the door and says, "Well, a princess! I love to eat princesses, but I have already eaten a whole castle today. I am a very busy dragon. Come back tomorrow." 

Then he slams the door.

You grab the knocker and bang on the door again.

The dragon sticks his nose out the door and says, "Well, a princess! I love to eat princesses, but I have already eaten a whole castle today. I am a very busy dragon. Come back tomorrow." 

This time he pauses a moment before slamming the door.

You shout at the dragon.

lalalalalala.

* * *

>ask about fire
(addressing the dragon)
"Is it true," you say, "that you can burn up ten forests with your fiery breath?"

"Oh, yes", says the dragon, and he takes a huge, deep breath and breathes out so much fire that he burns up fifty forests.

Wasn't that amazing?

>yes
"Fantastic!" you exclaim. "Do it again!"

>ask about fire
The dragon takes another huge breath and breathes out so much fire that he burns up one hundred forests.

>ask about fire
The dragon takes another huge breath. But this time, nothing comes out.

>ask about fire
The dragon doesn't have enough fire left to cook a meatball!

>yes
The dragon does not respond.

* * *

This is the day you've always dreamed of. You are finally marrying the love of your life, Prince Roland.

Castle Garden
You are standing in the garden behind your family's castle. On this lovely fall evening, it is doing double duty as a wedding chapel.

Your betrothed, Roland, stands before you.

You can also see Father Alfred here.

>z.z.z.z.z
You beam happily at Roland.

Father Alfred begins the ceremony, "We are gathered here today to witness the joining of two hearts." Roland smiles shyly at you.

You beam happily at Roland.

"If anyone has a reason why these two should not be wed, speak now or forever hold your peace." You hold your breath for a second, wondering whether anyone will speak up. Fortunately, nobody does and you relax.

You beam happily at Roland.

"Who gives this woman--" You glare icily at the minister. You are nobody's property. "Ahem. Moving on," says the minister, visibly flustered. Roland looks at you questioningly, but says nothing.

You beam happily at Roland.

"Love is a wonderful thing." And so on. You're too excited to pay attention to every word.

You beam happily at Roland.

"Elizabeth, do you take Roland to be your husband?"

>dance
That's not a verb I recognize.

* * *

>z
You beam happily at Roland.

>dance
That's not a verb I recognize.

>sing
Please answer YES or NO.

>say yes
Whom do you want to say that to?

>y
You need to specify who you want to speak to.

>yes
You need to specify who you want to speak to.

* * *

>yes
Of course you do!

The minister smiles at you and turns to Roland. "And, Roland, do you take Elizabeth to be your wife?"

Roland grins at you and exclaims, "I do!".

"I now pronounce you man and... dragon?!?" The minister's eyes go wide, seconds before he is incinerated by a burst of flame.

A large dragon flies overhead. The wedding guests scatter in every direction. You cower against Roland, but he pushes you towards the dragon and runs towards the road.

The dragon eats all the guests it can catch, and when it has had its fill, it smashes your castle to smithereens with its heavy tail and sets the remains on fire. You are nearly caught in a blaze of flame as you duck behind what used to be the stone wall of the garden. You are unhurt, but your fine gown snags on a rose bush and tears.

As the dragon finally turns to go, it catches sight of Roland, running down the road towards the river. It swoops down and smashes the bridge just as Roland is about to cross it and catches him up in its claws. The dragon flies away with your beloved prince.

Please press SPACE to continue.

* * *

The Paper Bag Princess
An interactive fairy tale by Adri
Release 1 / Serial number 130926 / Inform 7 build 6G60 (I6/v6.32 lib 6/12N) SD

Castle Ruins
No more castle. pile of rubble the embers

* * *

>undo
Throne Room
[Previous turn undone.]

>no
You shake your head. "No. I don't."

Oh. There's a pause, and then the guests begin to murmur. The minister frowns. "Elizabeth, are you sure?" he asks. Roland just stares at you in shock. You whisper, "I'm so sorry," and run off.

    *** Rocks fall. Everyone dies. ***

Would you like to RESTART, RESTORE a saved game, QUIT, or UNDO the last command?

>undo
Throne Room
[Previous turn undone.]

>i do
Of course you do! But just as you're about to say so, you're interrupted by a cry of "Dragon!!!!".

DRAGON!

Please press SPACE to continue.

* * *

The Paper Bag Princess
An interactive fairy tale by Adri
Release 1 / Serial number 130928 / Inform 7 build 6G60 (I6/v6.32 lib 6/12N) SD

Castle Ruins
This used to be your home. Now it is nothing more than a smoking pile of rubble. The smoke obscures your view of the stars, and the primary source of light is the burning remains of your furniture.

The only road away from the castle now ends abruptly at the river bank. The forest surrounds you thickly on all sides, except for an area to the north where the trees have been broken and scorched.

>xyzzy.open vial.drop vial
POOF! Your fairy godmother appears. "Tsk," she says. "Poor girl. I'm not sure I can help you with this one." She pauses and rummages around in her pockets, pulling out a vial. She hands it to you. "This is the best I can do. Use it wisely." Then she vanishes, as quickly as she appeared.

You open the vial, revealing an oily black liquid.

You drop the vial. It bounces harmlessly on the ground. The lid snaps shut in the process, and you don't lose more than a few drops of the oily black liquid.

>take vial.drop vial
Taken.

You drop the vial. It bounces harmlessly on the ground.

>restart
Are you sure you want to restart?

>y
This is the day you've always dreamed of. You are finally marrying the love of your life, prince Roland.

Garden
You are standing in the garden behind your family's castle. On this lovely fall evening, it is doing double duty as a wedding chapel.

Your betrothed, Roland, stands before you.

You can also see Father Alfred here.

>xyzzy.xyzzy.x light
POOF! Your fairy godmother appears. She smiles at you and places a a necklace around your neck.

Father Alfred begins the ceremony, "We are gathered here today to witness the joining of two hearts." Roland smiles shyly at you.

The necklace suddenly begins to glow.

"If anyone has a reason why these two should not be wed, speak now or forever hold your peace." You hold your breath for a second, wondering whether anyone will speak up. Fortunately, nobody does and you relax.

A heart-shaped pendant on a gold chain. It is glowing with a soft white light.

"Who gives this woman--" You glare icily at the minister. You are nobody's property. "Ahem. Moving on," says the minister, visibly flustered. Roland looks at you questioningly, but says nothing.

* * *

The Paper Bag Princess
An interactive fairy tale by Adri
Release 1 / Serial number 130928 / Inform 7 build 6G60 (I6/v6.32 lib 6/12N) SD

Castle Ruins
This used to be your home. Now it is nothing more than a smoking pile of rubble. The smoke obscures your view of the stars, and the primary source of light is the burning remains of your furniture.

The only road away from the castle now ends abruptly at the river bank. The forest surrounds you thickly on all sides, except for an area to the north where the trees have been broken and scorched.

>search rubble.wear bag.n
You dig through the piles of rubble until you find a paper bag.

Taken.

You quickly fashion a dress out of the gift bag. It's not as fancy as you're used to, but it'll get the job done.

You strip off the remains of your wedding gown.

You slip the makeshift dress over your head and pull it down past your hips.

Burnt Forest
There's a trail of burned trees and what appear to be teeth leading to the northeast. One tree in particular catches your eye.

>yes
There's no one here to talk to.

* * *

The Paper Bag Princess
An interactive fairy tale by Adri
Release 1 / Serial number 130928 / Inform 7 build 6G60 (I6/v6.32 lib 6/12N) SD

Castle Ruins
This used to be your home. Now it is nothing more than a smoking pile of rubble. The smoke obscures your view of the stars, and the primary source of light is the burning remains of your furniture.

The only road away from the castle now ends abruptly at the river bank. The forest surrounds you thickly on all sides, except for an area to the north where the trees have been broken and scorched.

>yes
That was a rhetorical question.

>no
Don't be such a pessimist, Elizabeth.

>hello
There's no one here but you.

>say hello
There's no one here but you.

>talk to myself
You does not respond.

* * *

The Paper Bag Princess
An interactive fairy tale by Adri
Release 1 / Serial number 130928 / Inform 7 build 6G60 (I6/v6.32 lib 6/12N) SD

Castle Ruins
This used to be your home. Now it is nothing more than a smoking pile of rubble. The smoke obscures your view of the stars, and the primary source of light is the burning remains of your furniture.

The only road away from the castle now ends abruptly at the river bank. The forest surrounds you thickly on all sides, except for an area to the north where the trees have been broken and scorched.

>xyzzy
POOF! Your fairy godmother appears. "Tsk," she says. "Poor girl. I'm not sure I can help you with this one." She pauses and rummages around in her pockets, pulling out a vial. She hands it to you. "This is the best I can do. Use it wisely." Then she vanishes, as quickly as she appeared.

>put vial on me
(first taking yourself)
You are always self-possessed.

* * *

>open vial
You open the vial, revealing an oily black liquid.

* * *

>pour vial on rag
Maybe you should remove the handful of rags first.

>put oil on rag
(first taking the oily black liquid)

* * *

The Paper Bag Princess
An interactive fairy tale by Adri
Release 1 / Serial number 130928 / Inform 7 build 6G60 (I6/v6.32 lib 6/12N) SD

Castle Ruins
This used to be your home. Now it is nothing more than a smoking pile of rubble. The smoke obscures your view of the stars, and the primary source of light is the burning remains of your furniture.

The only road away from the castle now ends abruptly at the river bank. The forest surrounds you thickly on all sides, except for an area to the north where the trees have been broken and scorched.

>xyzzy.x vial
POOF! Your fairy godmother appears. "Tsk," she says. "Poor girl. I'm not sure I can help you with this one." She pauses and rummages around in her pockets, pulling out a vial. She hands it to you. "This is the best I can do. Use it wisely." Then she vanishes, as quickly as she appeared.

It's a vial, containing a dark liquid.

>open vial.x vial
You open the vial, revealing an oily black liquid.

In the vial is an oily black liquid.

* * *

>x rubble
These piles of brick and wood used to be your home. You catch a glimpse of something colorful hidden in one of the piles.

>search rubble.x rubble
You dig through the piles of rubble until you find a paper bag.

These piles of brick and wood used to be your home.

* * *

>x rubble
These piles of brick and wood used to be your home. You catch a glimpse of something colorful hidden in one of the piles.

>x colorful
You can't quite make it out from here. Why don't you try digging through the rubble?

>dig through rubble
You dig through the piles of rubble until you find a paper bag.

>dig in rubble
You don't find anything else.

>x bag
It's a gift bag made out of paper. It looks like it used to have polka dots on it, but now it's just scorched.

* * *

The Paper Bag Princess
An interactive fairy tale by Adri
Release 1 / Serial number 130928 / Inform 7 build 6G60 (I6/v6.32 lib 6/12N) SD

Castle Ruins
This used to be your home. Now it is nothing more than a smoking pile of rubble. The smoke obscures your view of the stars, and the primary source of light is the burning remains of your furniture.

The only road away from the castle now ends abruptly at the river bank. The forest surrounds you thickly on all sides, except for an area to the north where the trees have been broken and scorched.

>x her
I'm not sure what "her" refers to.

* * *

>heteronormativity off
Ok!

>x her
I'm not sure what "her" refers to.

>test me
(Testing.)

>[1] test wedding
(Testing.)

>[2] z
Time passes.

>[3] z
Time passes.

>[4] z
Time passes.

>[5] z
Time passes.

>[6] z
Time passes.

>[7] yes
That was a rhetorical question.

>[8] test ruins
(Testing.)

>[9] search rubble
You dig through the piles of rubble until you find a paper bag.

>[10] take bag
Taken.

>[11] wear bag
You quickly fashion a dress out of the gift bag. It's not as fancy as you're used to, but it'll get the job done.

You strip off the remains of your wedding gown.

You slip the makeshift dress over your head and pull it down past your hips.

>[12] n

Burnt Forest
There's a trail of burned trees and what appear to be teeth leading to the northeast. One tree in particular catches your eye.

>[13] test burnt
(Testing.)

>[14] x trail
The trail disappears into the woods.

You find a large branch lying on the trail.

>[15] take branch
Taken.

>[16] x tree
You examine the tree more closely. Someone has carved "PLUGH" into the trunk.

>[17] plugh
POOF! Your fairy godmother appears. "Tsk," she says. "Poor girl. I'm not sure I can help you with this one." She pauses and rummages around in her pockets, pulling out a vial. She hands it to you. "This is the best I can do. Use it wisely." Then she vanishes, as quickly as she appeared.

>[18] test torch
(Testing.)

>[19] make torch
You fashion a torch from the branch and the remains of your wedding gown.

>[20] open vial
You open the vial, revealing an oily black liquid.

>[21] pour oil on torch
You pour the oily black liquid onto the torch and discard the empty vial.

>[22] s

Castle Ruins
This used to be your home. Now it is nothing more than a smoking pile of rubble. The smoke obscures your view of the stars, and the primary source of light is the burning remains of your furniture.

The only road away from the castle now ends abruptly at the river bank. The forest surrounds you thickly on all sides, except for an area to the north where the trees have been broken and scorched.

>[23] light torch
You light the torch with the flames.

>tetest maze
That's not a verb I recognize.

>test maze
(Testing.)

>[1] n

Burnt Forest
There's a trail of burned trees and what appear to be teeth leading to the northeast. One tree in particular catches your eye.

>[2] ne

Dimly Lit Forest
You feel as if you are in a maze of twisting giant trees.

>[3] n

Dimly Lit Forest
You feel as if you are in a maze of twisty giant trees.

>[4] n

Dimly Lit Forest
You feel as if you are in a maze of twisty giant trees.

>[5] n

Dimly Lit Forest
You feel as if you are in a giant maze of twisting trees.

>[6] n

Dimly Lit Forest
You feel as if you are in a twisting maze of giant trees.

>[7] n

Dimly Lit Forest
You feel as if you are in a maze of giant twisty trees.

>[8] n

Dimly Lit Forest
You feel as if you are in a twisty maze of giant trees.

>[9] n
The torch starts to flicker. It will probably burn out soon.

Dimly Lit Forest
You feel as if you are in a maze of twisty giant trees.

>[10] n

Dimly Lit Forest
You feel as if you are in a maze of twisting giant trees.

>[11] n

Outside the Dragon's Cave
You are standing before a large cave. The entrance has been blocked by a large wooden door.

>[12] n
You came to rescue Rolande, and you are not leaving without her!

>[13] n
You came to rescue Rolande, and you are not leaving without her!

>knock on door.knock again.shout
You grab the knocker and bang on the door.

The door opens and the dragon sticks his nose through the opening. He says, "Well, a princess! I love to eat princesses, but I have already eaten a whole castle today. I am a very tired dragon. Come back tomorrow." 

Then he slams the door in your face.

You bang on the door again.

The dragon sticks his nose out the door and says, "I am sure you are very delicious, but I am rather tired and stuffed. Please do come back tomorrow."

This time he pauses a moment before slamming the door.

"Wait!" you exclaim.

The dragon rolls his eyes and steps entirely out of the cave, nudging the door shut with his tail.

>ask dragon about fire
"Is it true," you say, "that you can burn up ten forests with your fiery breath?"

"Oh, yes", says the dragon, and he takes a huge, deep breath and breathes out so much fire that he burns up fifty forests.

Wasn't that amazing?

>y
> yes

"Fantastic!" you exclaim. "Do it again!"

The dragon takes another huge breath and breathes out so much fire that he burns up one hundred forests.

Were you impressed by that display?

>n
> no

Apparently it takes a lot to impress you! But you force yourself to look delighted as you shout, "Do it again!"

The dragon takes another huge breath. But this time, nothing comes out.

* * *

This is the day you've always dreamed of. You are finally marrying the love of your life, Prince Roland.

Castle Garden
You are standing in the garden behind your family's castle. On this lovely fall evening, it is doing double duty as a wedding chapel.

Your betrothed, Roland, stands before you.

You can also see Father Alfred here.

>i do
You need to specify who you want to speak to.

"We are gathered here today to witness the joining of two hearts."

* * *

This is the day you've always dreamed of. You are finally marrying the love of your life, Prince Roland.

Castle Garden
You are standing in the garden behind your family's castle. On this lovely fall evening, it is doing double duty as a wedding chapel.

Your betrothed, Roland, stands before you.

You can also see Father Alfred here.

>yes
You need to specify who you want to speak to.

Father Alfred begins the ceremony, "We are gathered here today to witness the joining of two hearts." Roland smiles shyly at you.

>i do
"Speak now or forever hold your peace."

You hold your breath for a second, wondering whether anyone will speak up. Nobody does. You visibly relax.

>dance
That's not a verb I recognize.

>say dance
Whom do you want to say that to?

>minister
The minister does not respond.

"Who gives this woman--"

You glare icily at the minister. You are nobody's property. "Ahem. Moving on.." Roland furrows his brow, but says nothing.

>z.z
You beam happily at Roland.

"Blah blah blah love." And so on. You're not really paying attention to the whole thing.

"Elizabeth, do you take Roland to be your husband blah blah blah."

You beam happily at Roland.

>xyzzy
POOF! Your fairy godmother appears. She smiles at you and places a a necklace around your neck.

>sing
The minister is waiting for your answer. Please say "yes" or "no".

>yes
Of course you do! But just as you're about to say so, you're interrupted by a cry of "Dragon!!!!".

DRAGON!

Please press SPACE to continue.

* * *

>yes
You need to specify who you want to speak to.

Father Alfred begins the ceremony, "We are gathered here today to witness the joining of two hearts." Roland smiles shyly at you.

>talk to roland
Roland shakes his head and puts a finger up to his lips.

"Speak now or forever hold your peace."

You hold your breath for a second, wondering whether anyone will speak up. Nobody does. You visibly relax.

>talk to priest
The minister does not respond.

"Who gives this woman--"

You glare icily at the minister. You are nobody's property. "Ahem. Moving on.." Roland furrows his brow, but says nothing.

* * *

>yes
You need to specify who you want to speak to.

Father Alfred begins the ceremony, "We are gathered here today to witness the joining of two hearts." Roland smiles shyly at you.

>z.z.z.z
You beam happily at Roland.

"If anyone has a reason why these two should not be wed, speak now or forever hold your peace." You hold your breath for a second, wondering whether anyone will speak up. Fortunately, nobody does and you relax.

You beam happily at Roland.

"Who gives this woman--" You glare icily at the minister. You are nobody's property. "Ahem. Moving on," says the minister, visibly flustered. Roland looks at you questioningly, but says nothing.

You beam happily at Roland.

"Love is a wonderful thing." And so on. You're too excited to pay attention to every word.

You beam happily at Roland.

"Elizabeth, do you take Roland to be your husband?"

>yes
Of course you do!

The minister smiles at you and turns to Roland. "And, Roland, do you take Elizabeth to be your wife?"

Roland grins at you and exclaims, "I do!".

"I now pronounce you man and... dragon?!?" The minister's eyes go wide, seconds before he is incinerated by a burst of flame.

DRAGON!

Please press SPACE to continue.

The Paper Bag Princess
An interactive fairy tale by Adri
Release 1 / Serial number 130928 / Inform 7 build 6G60 (I6/v6.32 lib 6/12N) SD

Castle Ruins
This used to be your home. Now it is nothing more than a smoking pile of rubble. The smoke obscures your view of the stars, and the primary source of light is the burning remains of your furniture.

The only road away from the castle now ends abruptly at the river bank. The forest surrounds you thickly on all sides, except for an area to the north where the trees have been broken and scorched.

* * *

>search rubble.wear bag.n
You dig through the piles of rubble until you find a paper bag.

Taken.

You quickly fashion a dress out of the gift bag. It's not as fancy as you're used to, but it'll get the job done.

You strip off the remains of your wedding gown.

You slip the makeshift dress over your head and pull it down past your hips.

Burnt Forest
There's a trail of burned trees and what appear to be teeth leading to the northeast. One tree in particular catches your eye.

>x teeth
Which do you mean, the teeth or the trail?

* * *

>yes
You need to specify who you want to speak to.

Father Alfred begins the ceremony, "We are gathered here today to witness the joining of two hearts." Roland smiles shyly at you.

>z.z.z.z.z
You beam happily at Roland.

"If anyone has a reason why these two should not be wed, speak now or forever hold your peace." You hold your breath for a second, wondering whether anyone will speak up. Fortunately, nobody does and you relax.

You beam happily at Roland.

"Who gives this woman--" You glare icily at the minister. You are nobody's property. "Ahem. Moving on," says the minister, visibly flustered. Roland looks at you questioningly, but says nothing.

You beam happily at Roland.

"Love is a wonderful thing." And so on. You're too excited to pay attention to every word.

You beam happily at Roland.

"Elizabeth, do you take Roland to be your husband?"

You beam happily at Roland.

>yes
That was a rhetorical question.

* * *

This is the day you've always dreamed of. You are finally marrying the love of your life, Prince Roland.

Castle Garden
You are standing in the garden behind your family's castle. On this lovely fall evening, it is doing double duty as a wedding chapel.

Your betrothed, Roland, stands before you.

You can also see Father Alfred here.

>i don't
I only understood you as far as wanting to take inventory.

>z.z.z
You beam happily at Roland.

"We are gathered here today to witness the joining of two hearts."

You beam happily at Roland.

"Speak now or forever hold your peace."

You hold your breath for a second, wondering whether anyone will speak up. Nobody does. You visibly relax.

You beam happily at Roland.

"Who gives this woman--"

You glare icily at the minister. You are nobody's property. "Ahem. Moving on.." Roland furrows his brow, but says nothing.

>yesz
That's not a verb I recognize.

>z
You beam happily at Roland.

"Blah blah blah love." And so on. You're not really paying attention to the whole thing.

"Elizabeth, do you take Roland to be your husband blah blah blah."

>yes
You need to specify who you want to speak to.

* * *

This is the day you've always dreamed of. You are finally marrying the love of your life, Prince Roland.

Castle Garden
You are standing in the garden behind your family's castle. On this lovely fall evening, it is doing double duty as a wedding chapel.

Your betrothed, Roland, stands before you.

You can also see Father Alfred here.

>walkthrough
 > About "The Paper Bag Princess"
   How to Play
   Hints
   Walkthrough
   Credits

   About "The Paper Bag Princess"
 > How to Play
   Hints
   Walkthrough
   Credits
   About "The Paper Bag Princess"
 > How to Play
   Hints
   Walkthrough
   Credits

   About "The Paper Bag Princess"
   How to Play
 > Hints
   Walkthrough
   Credits
   About "The Paper Bag Princess"
   How to Play
 > Hints
   Walkthrough
   Credits

>w
   About "The Paper Bag Princess"
   How to Play
 > Hints
   Walkthrough
   Credits

>q
Garden
You are standing in the garden behind your family's castle. On this lovely fall evening, it is doing double duty as a wedding chapel.

Your betrothed, Roland, stands before you.

You can also see Father Alfred here.

>start
Are you sure you want to restart?

>y
This is the day you've always dreamed of. You are finally marrying the love of your life, prince Roland.

Garden
You are standing in the garden behind your family's castle. On this lovely fall evening, it is doing double duty as a wedding chapel.

Your betrothed, Roland, stands before you.

You can also see Father Alfred here.

>x me
You are young and beautiful, too lovely to be described in mere words.

You are wearing a wedding gown and a sparkly gold crown.

Father Alfred begins the ceremony, "We are gathered here today to witness the joining of two hearts." Roland smiles shyly at you.

>i
You are carrying a bouquet.

"If anyone has a reason why these two should not be wed, speak now or forever hold your peace." You hold your breath for a second, wondering whether anyone will speak up. Fortunately, nobody does and you relax.

>x bouquet
The bouquet needs a description.

"Who gives this woman--" You glare icily at the minister. You are nobody's property. "Ahem. Moving on," says the minister, visibly flustered. Roland looks at you questioningly, but says nothing.

* * *

This is the day you've always dreamed of. You are finally marrying the love of your life, Prince Roland.

Castle Garden
You are standing in the garden behind your family's castle. On this lovely fall evening, it is doing double duty as a wedding chapel.

Your betrothed, Roland, stands before you.

You can also see Father Alfred here.

>untie ribbon
That's not a verb I recognize.

* * *

This is the day you've always dreamed of. You are finally marrying the love of your life, Prince Roland.

Castle Garden
You are standing in the garden behind your family's castle. On this lovely fall evening, it is doing double duty as a wedding chapel.

Your betrothed, Roland, stands before you.

You can also see Father Alfred here.

>x ribbon
It is a length of white satin ribbon, wrapped around the stems of the flowers to hold them together.

Father Alfred begins the ceremony, "We are gathered here today to witness the joining of two hearts." Roland smiles shyly at you.

>take ribbon
That seems to be a part of the bouquet.

"If anyone has a reason why these two should not be wed, speak now or forever hold your peace." You hold your breath for a second, wondering whether anyone will speak up. Fortunately, nobody does and you relax.

* * *

This is the day you've always dreamed of. You are finally marrying the love of your life, Prince Roland.

Castle Garden
You are standing in the garden behind your family's castle. On this lovely fall evening, it is doing double duty as a wedding chapel.

Your betrothed, Roland, stands before you.

You can also see Father Alfred here.

>x alfred
The minister still needs a description.

Father Alfred begins the ceremony, "We are gathered here today to witness the joining of two hearts." Roland smiles shyly at you.

>x bouquet
Your bouquet contains a collection of purple and orange flowers, tied up with a white ribbon. You don't even know what most of those flowers are called.

"If anyone has a reason why these two should not be wed, speak now or forever hold your peace." You hold your breath for a second, wondering whether anyone will speak up. Fortunately, nobody does and you relax.

>dance
That's not a verb I recognize.

>crown
That's not a verb I recognize.

>talk to roland
Roland shakes his head and puts a finger up to his lips, partially hiding an amused smile.

"Who gives this woman--" You glare icily at the minister. You are nobody's property. "Ahem. Moving on," says the minister, visibly flustered. Roland looks at you questioningly, but says nothing.

>roland, i love you
Roland shakes his head and puts a finger up to his lips, partially hiding an amused smile.

"Love is a wonderful thing." And so on. You're too excited to pay attention to every word.

>roland, love me
Roland shakes his head and puts a finger up to his lips, partially hiding an amused smile.

Roland has better things to do.

"Elizabeth, do you take Roland to be your husband?"

* * *

This is the day you've always dreamed of. You are finally marrying the love of your life, Prince Roland.

Castle Garden
You are standing in the garden behind your family's castle. On this lovely fall evening, it is doing double duty as a wedding chapel.

Your betrothed, Roland, stands before you.

You can also see Father Alfred here.

>zyxzzy
That's not a verb I recognize.

>xyzzy
POOF! Your fairy godmother appears. She smiles at you and places a a necklace around your neck.

Father Alfred begins the ceremony, "We are gathered here today to witness the joining of two hearts." Roland smiles shyly at you.

>smile
That's not a verb I recognize.

* * *

This is the day you've always dreamed of. You are finally marrying the love of your life, Prince Roland.

Castle Garden
You are standing in the garden behind your family's castle. On this lovely fall evening, it is doing double duty as a wedding chapel.

Your betrothed, Roland, stands before you.

You can also see Father Alfred here.

>dance
That's not a verb I recognize.

>sing
You promised your parents you would behave. All you need to do is stand there and look pretty.

Father Alfred begins the ceremony, "We are gathered here today to witness the joining of two hearts." Roland smiles shyly at you.

>xyzzy
You promised your parents you would behave. All you need to do is stand there and look pretty.

"If anyone has a reason why these two should not be wed, speak now or forever hold your peace." You hold your breath for a second, wondering whether anyone will speak up. Fortunately, nobody does and you relax.

* * *

This is the day you've always dreamed of. You are finally marrying the love of your life, Prince Roland.

Castle Garden
You are standing in the garden behind your family's castle. On this lovely fall evening, it is doing double duty as a wedding chapel.

Your betrothed, Roland, stands before you.

You can also see Father Alfred here.

>marry roland
You promised your parents you would behave. All you need to do is stand there and look pretty.

Father Alfred begins the ceremony, "We are gathered here today to witness the joining of two hearts." Roland smiles shyly at you.

* * *

This is the day you've always dreamed of. You are finally marrying the love of your life, Prince Roland.

Castle Garden
You are standing in the garden behind your family's castle. On this lovely fall evening, it is doing double duty as a wedding chapel.

Your betrothed, Roland, stands before you.

You can also see Father Alfred here.

>l
You promised your parents you would behave. All you need to do is stand there and look pretty.

Father Alfred begins the ceremony, "We are gathered here today to witness the joining of two hearts." Roland smiles shyly at you.

* * *

This is the day you've always dreamed of. You are finally marrying the love of your life, Prince Roland.

Castle Garden
You are standing in the garden behind your family's castle. On this lovely fall evening, it is doing double duty as a wedding chapel.

Your betrothed, Roland, stands before you.

You can also see Father Alfred here.

>roland, kiss me
You lean in towards Roland and whisper in his ear. Roland smiles at you, shaking his head.

Father Alfred begins the ceremony, "We are gathered here today to witness the joining of two hearts." Roland smiles shyly at you.

>roland, i love you
You lean in towards Roland and whisper in his ear. Roland smiles at you, shaking his head.

"If anyone has a reason why these two should not be wed, speak now or forever hold your peace." You hold your breath for a second, wondering whether anyone will speak up. Fortunately, nobody does and you relax.

* * *

This is the day you've always dreamed of. You are finally marrying the love of your life, Prince Roland.

Castle Garden
You are standing in the garden behind your family's castle. On this lovely fall evening, it is doing double duty as a wedding chapel.

Your betrothed, Roland, stands before you.

You can also see Father Alfred here.

>roland,i love you
You lean in towards Roland and whisper in his ear. Roland smiles at you and holds a finger over his lips in an exaggerated "shush" motion.

Father Alfred begins the ceremony, "We are gathered here today to witness the joining of two hearts." Roland smiles shyly at you.

>roland, kiss me
You lean in towards Roland and whisper in his ear. Roland smiles at you, shaking his head.

"If anyone has a reason why these two should not be wed, speak now or forever hold your peace." You hold your breath for a second, wondering whether anyone will speak up. Fortunately, nobody does and you relax.

>cry
That's not a verb I recognize.

* * *

This is the day you've always dreamed of. You are finally marrying the love of your life, Prince Roland.

Castle Garden
You are standing in the garden behind your family's castle. On this lovely fall evening, it is doing double duty as a wedding chapel.

Your betrothed, Roland, stands before you.

You can also see Father Alfred here.

>test me
(Testing.)

>[1] test wedding
(Testing.)

>[2] z
You beam happily at Roland.

Father Alfred begins the ceremony, "We are gathered here today to witness the joining of two hearts." Roland smiles shyly at you.

>[3] z
You beam happily at Roland.

"If anyone has a reason why these two should not be wed, speak now or forever hold your peace." You hold your breath for a second, wondering whether anyone will speak up. Fortunately, nobody does and you relax.

>[4] z
You beam happily at Roland.

"Who gives this woman--" You glare icily at the minister. You are nobody's property. "Ahem. Moving on," says the minister, visibly flustered. Roland looks at you questioningly, but says nothing.

>[5] z
You beam happily at Roland.

"Love is a wonderful thing." And so on. You're too excited to pay attention to every word.

>[6] z
You beam happily at Roland.

"Elizabeth, do you take Roland to be your husband?"

>[7] yes
Of course you do!

The minister smiles at you and turns to Roland. "And, Roland, do you take Elizabeth to be your wife?"

Roland grins at you and exclaims, "I do!"

"I now pronounce you man and... dragon?!?" The minister's eyes go wide, seconds before he is incinerated by a burst of flame.

A large dragon flies overhead. The wedding guests scatter in every direction. You cower against Roland, but he pushes you towards the dragon and runs towards the road.

The dragon eats all the guests it can catch, and when it has had its fill, it smashes your castle to smithereens with its heavy tail and sets the remains on fire. You are nearly caught in a blaze of flame as you duck behind what used to be the stone wall of the garden. You are unhurt, but your fine gown snags on a rose bush and tears.

As the dragon finally turns to go, it catches sight of Roland, running down the road towards the river. It swoops down and smashes the bridge just as Roland is about to cross it and catches him up in its claws. The dragon flies away with your beloved prince.

Please press SPACE to continue.

* * *

>talk to dragon
"Wait!" you exclaim.

Surprised, the dragon steps entirely out of the cave, nudging the door shut with its tail.

There is no reply.

* * *

>undo
Castle Ruins
[Previous turn undone.]

>l
Castle Ruins
No more castle. pile of rubble the embers

You can see a paper bag here.

>take bag.wear bag
Taken.

You slip the makeshift dress over your head and pull it down past your hips.

* * *

>y
"Fantastic!" you exclaim. "Do it again!"

The dragon takes another huge breath and breathes out so much fire that he burns up one hundred forests.

Were you impressed by that display?

* * *

>remove bag
You remove the gift bag, folding it carefully.

>wear bag
You slip the makeshift dress over your head and pull it down past your hips.

* * *

>x light
The flames burn brightly.

>x furniture
These piles of brick and wood used to be your home.

>x smoke
You can't see any such thing.

* * *

>x door
The large door almost perfectly fills in the natural opening in the rock. There is a golden knocker in the shape of a dragon's tail about a foot above your head.

>knock
(the Cave Door)
You grab the knocker and bang on the door.

The dragon sticks his nose out the door and says, "Well, a princess! I love to eat princesses, but I have already eaten a whole castle today. I am a very busy dragon. Come back tomorrow." 

Then he slams the door.

* * *

>knock.knock.shout
You can't see any such thing.

>knock on door.g.shout
You grab the knocker and bang on the door.

The door opens and the dragon sticks his nose through the opening. He says, "Well, a princess! I love to eat princesses, but I have already eaten a whole castle today. I am a very tired dragon. Come back tomorrow." 

Then he slams the door in your face.

You bang on the door again.

The dragon sticks his nose out the door and says, "I am sure you are very delicious, but I am rather tired and stuffed. Please do come back tomorrow."

This time he pauses a moment before slamming the door.

"Dragon!" you exclaim. "I have come to rescue my beloved prince."

>talk to dragon
The dragon slams the door in your face.

>undo
Outside the Dragon's Cave
[Previous turn undone.]

* * *

>knock on door
You grab the knocker and bang on the door.

The door opens and the dragon sticks his nose through the opening. He says, "Well, a princess! I love to eat princesses, but I have already eaten a whole castle today. I am a very tired dragon. Come back tomorrow." 

Then he slams the door in your face.

>knock on door
You bang on the door again.

The dragon sticks his nose out the door and says, "I am sure you are very delicious, but I am rather tired and stuffed. Please do come back tomorrow."

This time he pauses a moment before slamming the door.

>talk to dragon
The dragon quietly observes you.

>shout
"Dragon!" you exclaim. "I have come to rescue my beloved prince."

>talk to dragon
The dragon quietly observes you.

* * *

>knock on door.g
You grab the knocker and bang on the door.

The door opens and the dragon sticks his nose through the opening. He says, "Well, a princess! I love to eat princesses, but I have already eaten a whole castle today. I am a very tired dragon. Come back tomorrow." 

Then he slams the door in your face.

You bang on the door again.

The dragon sticks his nose out the door and says, "I am sure you are very delicious, but I am rather tired and stuffed. Please do come back tomorrow."

This time he pauses a moment before slamming the door.

>talk to dragon
"Dragon!" you exclaim. "I have come to rescue my beloved prince."

The dragon rolls his eyes and steps entirely out of the cave, nudging the door shut with his tail.

* * *

>knock on door.g
You grab the knocker and bang on the door.

The door opens and the dragon sticks his nose through the opening. He says, "Well, a princess! I love to eat princesses, but I have already eaten a whole castle today. I am a very tired dragon. Come back tomorrow." 

Then he slams the door in your face.

You bang on the door again.

The dragon sticks his nose out the door and says, "I am sure you are very delicious, but I am rather tired and stuffed. Please do come back tomorrow."

This time he pauses a moment before slamming the door.

>dance
You practice a few steps of the Pemberletten waltz.

>sing
You sing a few lines of a lullaby your mother used to sing to you.

>z
Time passes.

>x dragon
The dragon quietly observes you.

>g
The dragon sighs and slams the door.

* * *

>knock on door.knock on door
You grab the knocker and bang on the door.

The door opens and the dragon sticks his nose through the opening. He says, "Well, a princess! I love to eat princesses, but I have already eaten a whole castle today. I am a very tired dragon. Come back tomorrow." 

Then he slams the door in your face.

You bang on the door again.

The dragon sticks his nose out the door and says, "I am sure you are very delicious, but I am rather tired and stuffed. Please do come back tomorrow."

This time he pauses a moment before slamming the door.

>dance.sing.remove bag
You practice a few steps of the Pemberletten waltz.

You sing a few lines of a lullaby your mother used to sing to you.

You remove the gift bag, folding it carefully.

>ask dragon about me
"Dragon!" you exclaim. "I have come to rescue my beloved prince."

The dragon rolls his eyes and steps entirely out of the cave, nudging the door shut with his tail.

>undo
Outside the Dragon's Cave
[Previous turn undone.]

>wear bag
You slip the makeshift dress over your head and pull it down past your hips.

>x dragon
This dragon is not very large, only about 25 feet from the tip of its nose to the end of its tail. Its green scales shimmer in the glow of your torch.

The dragon sighs and slams the door.

>knock on door
You already have the dragon's attention.

>x dragon
This dragon is not very large, only about 25 feet from the tip of its nose to the end of its tail. Its green scales shimmer in the glow of your torch.

>talk to dragon
You say, "Is it true that you are the smartest and fiercest dragon in the whole world?"

"Yes", says the dragon. Boastful fellow, isn't he?

>flatter dragon
Maybe you could try asking the dragon about fire or flight.

>ask dragon about fire
"Is it true," you say, "that you can burn up ten forests with your fiery breath?"

"Oh, yes", says the dragon, and he takes a huge, deep breath and breathes out so much fire that he burns up fifty forests.

Were you impressed by that display?

* * *

>y
"Fantastic!" you exclaim. "Do it again!"

The dragon takes another huge breath and breathes out so much fire that he burns up one hundred forests.

Wasn't that amazing?

>n
Apparently it takes a lot to impress you! But you force yourself to look delighted as you shout, "Do it again!"

The dragon takes another huge breath. But this time, nothing comes out.

>ask dragon about flight
You say, "Dragon, is it true that you can fly around the world in just ten seconds?"

"Why, yes," says the dragon, and he jumps up and flies around the world in just ten seconds. He seems very tired when he returns.

Were you impressed by that display?

>n
Apparently it takes a lot to impress you! But you force yourself to look delighted as you shout, "Do it again!"

The dragon jumps up and flies around the whole world in just twenty seconds. When he returns, he flops down on the ground.

The dragon falls asleep.

>x dragon
The dragon seems to be fast asleep. You could probably sneak right past it now.

>talk to dragon
You say, "Is it true that you are the smartest and fiercest dragon in the whole world?"

"Yes", says the dragon. Boastful fellow, isn't he?

* * *

>knock on door.knock on door
You grab the knocker and bang on the door.

The door opens and the dragon sticks his nose through the opening. He says, "Well, a princess! I love to eat princesses, but I have already eaten a whole castle today. I am a very tired dragon. Come back tomorrow." 

Then he slams the door in your face.

You bang on the door again.

The dragon sticks his nose out the door and says, "I am sure you are very delicious, but I am rather tired and stuffed. Please do come back tomorrow."

This time he pauses a moment before slamming the door.

>talk to dragon
"Dragon!" you exclaim. "I have come to rescue my beloved prince."

The dragon rolls his eyes and steps entirely out of the cave, nudging the door shut with his tail.

>talk to dragon
You say hello to the dragon.

>hello, dragon
(dragon, hello)
You say, "Is it true that you are the smartest and fiercest dragon in the whole world?"

"Yes", says the dragon. Boastful fellow, isn't he?

>rules
Rules tracing now switched on. Type "rules off" to switch it off again, or "rules all" to include even rules which do not apply.

>talk to dragon
[Rule "Instead of saying hello to someone when the greeting type is explicit" applies.]
[Rule "instead of quizzing dragon about dragon" applies.]
You say, "Is it true that you are the smartest and fiercest dragon in the whole world?"

"Yes", says the dragon. Boastful fellow, isn't he?

* * *

>talk to dragon
You say hello to the dragon.

>talk to dragon
You are already talking to the dragon.

>hello
You are already talking to the dragon.

>rules
Rules tracing now switched on. Type "rules off" to switch it off again, or "rules all" to include even rules which do not apply.

>talk to dragon
[Rule "can't greet current interlocutor rule" applies.]
You are already talking to the dragon.

>ask dragon about life
[Rule "standard response rule" applies.]
[Rule "default asking rule" applies.]
[Rule "try default ask-tell response rule" applies.]
[Rule "default ask-tell response for Dragon" applies.]
The dragon says, "I'm afraid I don't know anything about that."

* * *

>knock on door.knock on door
You grab the knocker and bang on the door.

The door opens and the dragon sticks his nose through the opening. He says, "Well, a princess! I love to eat princesses, but I have already eaten a whole castle today. I am a very tired dragon. Come back tomorrow." 

Then he slams the door in your face.

You bang on the door again.

The dragon sticks his nose out the door and says, "I am sure you are very delicious, but I am rather tired and stuffed. Please do come back tomorrow."

This time he pauses a moment before slamming the door.

>talk to dragon.talk to dragon
"Dragon!" you exclaim. "I have come to rescue my beloved prince."

The dragon rolls his eyes and steps entirely out of the cave, nudging the door shut with his tail.

*** Run-time problem P7: Too many rulebooks in simultaneous use.

* * *

>knock on door.knock on door.talk to dragon
You grab the knocker and bang on the door.

The door opens and the dragon sticks his nose through the opening. He says, "Well, a princess! I love to eat princesses, but I have already eaten a whole castle today. I am a very tired dragon. Come back tomorrow." 

Then he slams the door in your face.

You bang on the door again.

The dragon sticks his nose out the door and says, "I am sure you are very delicious, but I am rather tired and stuffed. Please do come back tomorrow."

This time he pauses a moment before slamming the door.

"Dragon!" you exclaim. "I have come to rescue my beloved prince."

The dragon rolls his eyes and steps entirely out of the cave, nudging the door shut with his tail.

>talk to dragon
You say, "Is it true that you are the smartest and fiercest dragon in the whole world?"

"Yes", says the dragon. Boastful fellow, isn't he?

>ask dragon about fire
"Is it true," you say, "that you can burn up ten forests with your fiery breath?"

"Oh, yes", says the dragon, and he takes a huge, deep breath and breathes out so much fire that he burns up fifty forests.

Wasn't that amazing?

* * *

>y
"Magnificent!" you shout. "Do it again!"

The dragon takes another huge breath. But this time, nothing comes out.

>ask dragon about flying
You say, "Dragon, is it true that you can fly around the world in just ten seconds?"

"Why, yes," says the dragon, and he jumps up and flies around the world in just ten seconds. He seems very tired when he returns.

Wasn't that amazing?

>y
"Fantastic!" you exclaim. "Do it again!"

The dragon jumps up and flies around the whole world in just twenty seconds. When he returns, he flops down on the ground.

The dragon falls asleep.

>talk to dragon
You say, "Is it true that you are the smartest and fiercest dragon in the whole world?"

"Yes", says the dragon. Boastful fellow, isn't he?

>ask dragon about life
The dragon seems to be fast asleep. You could probably sneak right past it now.

>ask dragon about dragon
The dragon seems to be fast asleep. You could probably sneak right past it now.

>ask dragon about fire
The dragon seems to be fast asleep. You could probably sneak right past it now.

>shout
"Dragon!" you exclaim. "I have come to rescue my beloved prince."

The dragon rolls his eyes and steps entirely out of the cave, nudging the door shut with his tail.

* * *

>ask dragon about fire
"Is it true," you say, "that you can burn up ten forests with your fiery breath?"

"Oh, yes", says the dragon, and he takes a huge, deep breath and breathes out so much fire that he burns up fifty forests.

Were you impressed by that display?

>y
>yes
"Fantastic!" you exclaim. "Do it again!"

The dragon takes another huge breath and breathes out so much fire that he burns up one hundred forests.

Wasn't that amazing?

>y
"Magnificent!" you shout. "Do it again!"

The dragon takes another huge breath. But this time, nothing comes out.

>ask dragon about flight
You say, "Dragon, is it true that you can fly around the world in just ten seconds?"

"Why, yes," says the dragon, and he jumps up and flies around the world in just ten seconds. He seems very tired when he returns.

Were you impressed by that display?

>y
"Fantastic!" you exclaim. "Do it again!"

The dragon jumps up and flies around the whole world in just twenty seconds. When he returns, he flops down on the ground.

The dragon is so tired that he falls fast asleep.

>ask dragon about fire
The dragon seems to be fast asleep. You could probably sneak right past it now.

>ask dragon about dragon
The dragon seems to be fast asleep. You could probably sneak right past it now.

>talk to dragon
You say, "Is it true that you are the smartest and fiercest dragon in the whole world?"

"Yes", says the dragon. Boastful fellow, isn't he?

>whisper
That's not a verb I recognize.

>sing
You sing a few lines of a lullaby your mother used to sing to you.

>dance
You practice a few steps of the Pemberletten waltz.

>shout
The dragon seems to be fast asleep. You could probably sneak right past it now.

* * *

>y
"Fantastic!" you exclaim. "Do it again!"

The dragon jumps up and flies around the whole world in just twenty seconds. When he returns, he flops down on the ground.

The dragon is so tired that he falls fast asleep.

>e
(first opening the cave door)
You step over the dragon and open the door to the cave.

The dragon seems to be fast asleep. You could probably sneak right past it now.

The Dragon's Cave
This is where the dragon lives. Piles of treasure fill the room, reflecting light in every direction.

Your betrothed, Roland, stands before you.

Roland looks at you and says, "Elizabeth, you are a mess! You smell like ashes, your hair is all tangled, and you are wearing a dirty paper bag. Come back when you are dressed like a real princess."

* * *

>y
"Magnificent!" you shout. "Do it again!"

The dragon takes another huge breath. But this time, nothing comes out.

>ask dragon about flame
The dragon doesn't have enough fire left to cook a meatball!

>ask dragon about flight
You say, "Dragon, is it true that you can fly around the world in just ten seconds?"

"Why, yes," says the dragon, and he jumps up and flies around the world in just ten seconds. He seems very tired when he returns.

Were you impressed by that display?

* * *

>y
"Fantastic!" you exclaim. "Do it again!"

The dragon jumps up and flies around the whole world in just twenty seconds. When he returns, he flops down on the ground.

The dragon is so tired that he falls fast asleep.

>e
(first opening the cave door)
You step over the dragon and open the door to the cave.

The Dragon's Cave
This is where the dragon lives. Piles of treasure fill the room, reflecting light in every direction.

Your betrothed, Roland, stands before you.

Roland looks at you and says, "Elizabeth, you are a mess! You smell like ashes, your hair is all tangled, and you are wearing a dirty paper bag. Come back when you are dressed like a real princess."

>shout
You can't reach into the Outside the Dragon's Cave.

>shout at roland
"Roland," you say, "your clothes are really pretty, and your hair is very neat. You look like a real prince, but you are a jerk.

    *** And Elizabeth lived happily ever after! ***

Would you like to RESTART, RESTORE a saved game, QUIT, or UNDO the last command?

* * *

>y
>yes
"Fantastic!" you exclaim. "Do it again!"

The dragon takes another huge breath and breathes out so much fire that he burns up one hundred forests.

Wasn't that amazing?

>n
>no
Apparently it takes a lot to impress you! But you force yourself to look delighted as you shout, "Do it again!"

The dragon takes another huge breath. But this time, nothing comes out.

>ask dragon about fire
The dragon doesn't have enough fire left to cook a meatball!

* * *

>ask dragon about fire
"Is it true," you say, "that you can burn up ten forests with your fiery breath?"

"Oh, yes", says the dragon, and he takes a huge, deep breath and breathes out so much fire that he burns up fifty forests.

Were you impressed by that display?

>n
>no

Apparently it takes a lot to impress you! But you force yourself to look delighted as you shout, "Do it again!"

The dragon takes another huge breath and breathes out so much fire that he burns up one hundred forests.
Were you impressed by that display?

>y
>yes

"Fantastic!" you exclaim. "Do it again!"

The dragon takes another huge breath. But this time, nothing comes out.

* * *

>ask about fire
(addressing the dragon)
"Wait!" you exclaim.

Surprised, the dragon steps entirely out of the cave, nudging the door shut with its tail.

"Is it true," you say, "that you can burn up ten forests with your fiery breath?"

"Oh, yes," says the dragon, and it takes a huge, deep breath and breathes out so much fire that it burns up fifty forests.

Were you impressed by that display? (Y/N)

>y
yes
"Fantastic!" you exclaim. "Do it again!"

The dragon takes another huge breath and breathes out so much fire that it burns up one hundred forests.

Wasn't that amazing?

>y
yes
"Magnificent!" you shout. "Do it again!"

The dragon takes another huge breath. But this time, nothing comes out.

>ask dragon about flight
You say, "Dragon, is it true that you can fly around the world in just ten seconds?"

"Why, yes," says the dragon, and he jumps up and flies around the world in just ten seconds. He seems very tired when he returns.

Wasn't that amazing?

>y
"Fantastic!" you exclaim. "Do it again!"

The dragon jumps up and flies around the whole world in just twenty seconds. When he returns, he flops down on the ground.

The dragon falls asleep.

* * *

>talk to dragon
You say, "Is it true that you are the smartest and fiercest dragon in the whole world?"

"Yes", says the dragon. Boastful fellow, isn't he?

>shout
The dragon seems to be fast asleep. You could probably sneak right past it now.

* * *

>y
yes
"Magnificent!" you shout. "Do it again!"

The dragon takes another huge breath. But this time, nothing comes out.

>ask about flight
You say, "Dragon, is it true that you can fly around the world in just ten seconds?"

"Why, yes," says the dragon, and it jumps up and flies around the world in just ten seconds. It seems very tired when it returns.

Were you impressed by that display?

>y
yes
"Fantastic!" you exclaim. "Do it again!"

The dragon jumps up and flies around the whole world in just twenty seconds. When it returns, it flops down on the ground.

The dragon is so tired that he falls fast asleep.

>shout at dragon
You whisper very softly, "Hey, dragon."

The dragon doesn't stir.

>talk to dragon
You lift the dragon's ear and put your head right inside. You shout as loudly as you can, "Hey, dragon!"

The dragon doesn't react.

>ask dragon about dragon
The dragon seems to be fast asleep. You could probably sneak right past it now.

>talk to dragon
The dragon seems to be fast asleep. You could probably sneak right past it now.

>e
(first opening the Cave Door)
The dragon seems to be fast asleep. You could probably sneak right past it now.

Cave Interior
There is no description here. Go away.

Your betrothed, Roland, stands before you.

>undo
Outside the Dragon's Cave
[Previous turn undone.]

>open door
You open the Cave Door.

>enter door
The dragon seems to be fast asleep. You could probably sneak right past it now.

Cave Interior
There is no description here. Go away.

Your betrothed, Roland, stands before you.

* * *

>y
yes
"Fantastic!" you exclaim. "Do it again!"

The dragon jumps up and flies around the whole world in just twenty seconds. When it returns, it flops down on the ground.

The dragon is so tired that he falls fast asleep.

>in
(first opening the cave door)
You step over the dragon and open the door to the cave.

The Dragon's Cave
This is where the dragon lives. Piles of treasure fill the room, reflecting light in every direction.

Your betrothed, Roland, stands before you.

Roland looks at you and says, "Elizabeth, you are a mess! You smell like ashes, your hair is all tangled, and you are wearing a dirty paper bag. Come back when you are dressed like a real princess."

>hit roland
You slap Roland!

"Roland," you say, "your clothes are really pretty, and your hair is very neat. You look like a real prince, but you are also a real toad."

You turn around and walk out the door.

    *** And Elizabeth lived happily ever after! ***

Would you like to RESTART, RESTORE a saved game, see some suggestions for AMUSING things to do, UNDO the last command, view EASTER eggs, or QUIT?

Please give one of the answers above.

Would you like to RESTART, RESTORE a saved game, see some suggestions for AMUSING things to do, UNDO the last command, view EASTER eggs, or QUIT?

* * *

>y
yes
"Fantastic!" you exclaim. "Do it again!"

The dragon takes another huge breath and breathes out so much fire that it burns up one hundred forests.

Wasn't that amazing?

>n
>no

Apparently it takes a lot to impress you! But you force yourself to look delighted as you shout, "Do it again!"

The dragon takes another huge breath. But this time, nothing comes out.

>ask dragon about fire
The dragon doesn't have enough fire left to cook a meatball!

* * *

>x dragon
This dragon is not very large, only about 25 feet from the tip of its nose to the end of its tail. Its green scales shimmer in the glow of your torch. The dragon is sleeping peacefully, with its tail curled around its snout.

* * *

>attack dragon
The dragon is much larger and stronger than you. Perhaps you can outwit it in some way.

>ask about flight
(addressing the dragon)
You say, "Dragon, is it true that you can fly around the world in just ten seconds?"

"Why, yes," says the dragon, and he jumps up and flies around the world in just ten seconds. He seems very tired when he returns.

Wasn't that amazing?

>y
"Fantastic!" you exclaim. "Do it again!"

The dragon jumps up and flies around the whole world in just twenty seconds. When he returns, he flops down on the ground.

>ask about fire
"Is it true," you say, "that you can burn up ten forests with your fiery breath?"

"Oh, yes", says the dragon, and he takes a huge, deep breath and breathes out so much fire that he burns up fifty forests.

Were you impressed by that display?

>y
"Magnificent!" you shout. "Do it again!"

The dragon takes another huge breath and breathes out so much fire that he burns up one hundred forests.

Wasn't that amazing?

>y
"Fantastic!" you exclaim. "Do it again!"

The dragon takes another huge breath. But this time, nothing comes out.

The dragon is so tired that he falls fast asleep.

>e
(first opening the cave door)
You step over the dragon and open the door to the cave.

The dragon is finally asleep. You should rescue Roland and leave, before it wakes up.

The Dragon's Cave
This is where the dragon lives. Piles of treasure fill the room, reflecting light in every direction.

Your betrothed, Roland, stands before you.

Roland looks at you and says, "Elizabeth, you are a mess! You smell like ashes, your hair is all tangled, and you are wearing a dirty paper bag. Come back when you are dressed like a real princess."

>undo
Outside the Dragon's Cave
[Previous turn undone.]

>rule
That's not a verb I recognize.

>rules
Rules tracing now switched on. Type "rules off" to switch it off again, or "rules all" to include even rules which do not apply.

* * *

>tie rags to branch
You fashion a torch from the branch and the remains of your wedding gown.

>tie branch to me
You can't see any such thing.

* * *

>n.ne.n
Burnt Forest
There's a trail of burned trees and what appear to be teeth leading to the northeast. One tree in particular catches your eye.

Dimly Lit Forest
You feel as if you are in a giant maze of twisty trees.

Dimly Lit Forest
You feel as if you are in a twisty giant maze of trees.

>x maze
Don't worry. You'll figure it out.

>x trees
Dimly Lit Forest
You feel as if you are in a twisting maze of giant trees.

You can see some dark trees and a maze here.

* * *

>n.ne.n
Burnt Forest
There's a trail of burned trees and what appear to be teeth leading to the northeast. One tree in particular catches your eye.

Dimly Lit Forest
You feel as if you are in a giant maze of twisty trees.

Dimly Lit Forest
You feel as if you are in a twisty giant maze of trees.

>x maze.x trees
Don't worry. You'll figure it out.

Dimly Lit Forest
You feel as if you are in a giant maze of twisting trees.

>up.down
You, unlike the dragons, are not able to fly.

There is nowhere to go in that direction.

>n.n.n.n
The torch starts to flicker. It will probably burn out soon.

Dimly Lit Forest
You feel as if you are in a maze of twisty giant trees.

Dimly Lit Forest
You feel as if you are in a twisting giant maze of trees.

Outside the Dragon's Cave
You are standing before a large cave. The entrance has been blocked by a large wooden door.

You came to rescue Roland, and you are not leaving without him!

* * *

>test maze
(Testing.)

>[1] n

Burnt Forest
There's a trail of burned trees and what appear to be teeth leading to the northeast. One tree in particular catches your eye.

>[2] ne

Dimly Lit Forest
You feel as if you are in a maze of twisting giant trees.

>[3] n

Dimly Lit Forest
You feel as if you are in a twisting maze of giant trees.

>[4] n

Dimly Lit Forest
You feel as if you are in a maze of twisting giant trees.

>[5] n

Dimly Lit Forest
You feel as if you are in a giant twisty maze of trees.

>[6] n

Dimly Lit Forest
You feel as if you are in a twisting maze of giant trees.

>[7] n

Dimly Lit Forest
You feel as if you are in a twisting giant maze of trees.

>[8] n

Dimly Lit Forest
You feel as if you are in a twisting maze of giant trees.

>[9] n

Dimly Lit Forest
You feel as if you are in a giant maze of twisty trees.

>[10] n

Dimly Lit Forest
You feel as if you are in a giant twisty maze of trees.

>[11] n
The torch starts to flicker. It will probably burn out soon.

Dimly Lit Forest
You feel as if you are in a giant twisty maze of trees.

>[12] n

Dimly Lit Forest
You feel as if you are in a maze of twisty giant trees.

>[13] n

Outside the Dragon's Cave
You are standing before a large cave. The entrance has been blocked by a large wooden door.

>knock on door.knock again.shout
You grab the knocker and bang on the door.

The door opens and the dragon sticks his nose through the opening. He says, "Well, a princess! I love to eat princesses, but I have already eaten a whole castle today. I am a very tired dragon. Come back tomorrow." 

Then he slams the door in your face.

You bang on the door again.

The dragon sticks his nose out the door and says, "I am sure you are very delicious, but I am rather tired and stuffed. Please do come back tomorrow."

This time he pauses a moment before slamming the door.

"Wait!" you exclaim.

The dragon rolls his eyes and steps entirely out of the cave, nudging the door shut with his tail.

>ask dragon about fire
"Is it true," you say, "that you can burn up ten forests with your fiery breath?"

"Oh, yes", says the dragon, and he takes a huge, deep breath and breathes out so much fire that he burns up fifty forests.

Were you impressed by that display?

* * *

>y
"Fantastic!" you exclaim. "Do it again!"

The dragon takes another huge breath and breathes out so much fire that he burns up one hundred forests.

Wasn't that amazing?

>y
"Magnificent!" you shout. "Do it again!"

The dragon takes another huge breath. But this time, nothing comes out.

* * *

>y
"Fantastic!" you exclaim. "Do it again!"

The dragon jumps up and flies around the whole world in just twenty seconds. When he returns, he flops down on the ground.

The dragon is so tired that he falls fast asleep.

I beg your pardon?

>e
(first opening the cave door)
You step over the dragon and open the door to the cave.

The Dragon's Cave
This is where the dragon lives. Piles of treasure fill the room, reflecting light in every direction.

Your betrothed, Roland, stands before you.

Roland looks at you and says, "Elizabeth, you are a mess! You smell like ashes, your hair is all tangled, and you are wearing a dirty paper bag. Come back when you are dressed like a real princess."

>out
"Roland," you say, "your clothes are really pretty, and your hair is very neat. You look like a real prince, but you are a jerk.

    *** And Elizabeth lived happily ever after! ***

Would you like to RESTART, RESTORE a saved game, QUIT, or UNDO the last command?

* * *

>undo
Outside the Dragon's Cave
[Previous turn undone.]

* * *

>ask dragon about roland
"Wait!" you exclaim.

The dragon rolls his eyes and steps entirely out of the cave, nudging the door shut with his tail.

The dragon says, "I love to eat royals, but I have already eaten a whole castle today. I am saving your beloved for later."

* * *

>shout
"Wait!" you exclaim.

The dragon rolls his eyes and steps entirely out of the cave, nudging the door shut with his tail.

>outwit dragonout
You can't see any such thing.

>outwit dragon
Maybe you could try asking the dragon about fire or flight.

>burn dragon
This dangerous act would achieve little.

* * *

>shout.burn dragon
"Wait!" you exclaim.

The dragon rolls his eyes and steps entirely out of the cave, nudging the door shut with his tail.

This dangerous act would achieve little.

>burn dragon with torch
The dragon is much larger and stronger than you. Perhaps you can outwit it in some way.

* * *

>ask dragon about dragon
"Wait!" you exclaim.

Surprised, the dragon steps entirely out of the cave, nudging the door shut with its tail.

You say, "Is it true that you are the smartest and fiercest dragon in the whole world?"

"Yes," says the dragon. Boastful fellow, isn't he?

>tell dragon about dragon
You say, "Is it true that you are the smartest and fiercest dragon in the whole world?"

"Yes", says the dragon. Boastful fellow, isn't he?

>ask dragon about me
The dragon says, "I love to eat princesses, but I have already eaten a whole castle today. Come back tomorrow."

* * *

>ask dragon about dragon
"Wait!" you exclaim.

Surprised, the dragon steps entirely out of the cave, nudging the door shut with its tail.

You say, "Is it true that you are the smartest and fiercest dragon in the whole world?"

"Yes," says the dragon. Boastful fellow, isn't he?

>ask dragon about itself
There is no reply.

* * *

>enter cave
(first opening the cave door)
The door is locked. Perhaps you should try knocking.

* * *

>shout.marry dragon
"Wait!" you exclaim.

The dragon rolls his eyes and steps entirely out of the cave, nudging the door shut with his tail.

That would be very weird.

* * *

>ask dragon about castle
"Wait!" you exclaim.

Surprised, the dragon steps entirely out of the cave, nudging the door shut with his tail.

The dragon says, "That's very kind of you to offer, but I have already eaten a whole castle today."

"That was my home!" you shout.

The dragon shrugs. He doesn't seem particularly inclined to apologize.

* * *

>e
The dragon is blocking the doorway and will not allow you to pass.

* * *

>ask dragon about door
"Wait!" you exclaim.

Surprised, the dragon steps entirely out of the cave, nudging the door shut with his tail.

The dragon says, "That is my home, and you are not welcome in there."

* * *

>pour oil on me
The vial isn't open.

>put rags on branch
You must supply a noun.

>poput oil on me
That's not a verb I recognize.

>put oil on me
The vial isn't open.

>open vial.put oil on me
You open the vial.

You must supply a noun.

>wrap rags around branch
You fashion a torch from the branch and the remains of your wedding gown.

>undo
Burnt Forest
[Previous turn undone.]

>tie rags to branch
You fashion a torch from the branch and the remains of your wedding gown.

>undo
Burnt Forest
[Previous turn undone.]

>rules
Rules tracing now switched on. Type "rules off" to switch it off again, or "rules all" to include even rules which do not apply.

>put rags on branch
[Rule "Instead of putting something on something" applies.]
You must supply a noun.

* * *

>open vial
You open the vial.

>put oil on me
Ew. You really don't want that all over your skin.

* * *

>put rags on branch
You fashion a torch from the branch and the remains of your wedding gown.

* * *

>talk to dragon
"Wait!" you exclaim.

Surprised, the dragon steps entirely out of the cave, nudging the door shut with its tail.

You say, "Is it true that you are the smartest and fiercest dragon in the whole world?"

"Yes," says the dragon. Boastful fellow, isn't he?

>g
You say, "Is it true that you are the smartest and fiercest dragon in the whole world?"

"Yes," says the dragon. Boastful fellow, isn't he?

>ask dragon about dragons
You say, "Is it true that you are the smartest and fiercest dragon in the whole world?"

"Yes," says the dragon. Boastful fellow, isn't he?

>ask dragon about itself
You say, "Is it true that you are the smartest and fiercest dragon in the whole world?"

"Yes," says the dragon. Boastful fellow, isn't he?

* * *

>ask dragon about itself
"Wait!" you exclaim.

Surprised, the dragon steps entirely out of the cave, nudging the door shut with its tail.

The dragon says, "I'm afraid I don't know anything about that."

>restart
Are you sure you want to restart?

>y
This is the day you've always dreamed of. You are finally marrying the love of your life, Prince Roland.

Castle Garden
You are standing in the garden behind your family's castle. On this lovely fall evening, it is doing double duty as a wedding chapel.

Your betrothed, Roland, stands before you.

You can also see Father Alfred here.

>ask roland about himself
You lean in towards Roland and whisper in his ear. Roland smiles at you and holds a finger over his lips in an exaggerated "shush" motion.

Father Alfred begins the ceremony, "We are gathered here today to witness the joining of two hearts." Roland smiles shyly at you.

>test me
(Testing.)

>[1] test wedding
(Testing.)

>[2] z
You beam happily at Roland.

"If anyone has a reason why these two should not be wed, speak now or forever hold your peace." You hold your breath for a second, wondering whether anyone will speak up. Fortunately, nobody does and you relax.

>[3] z
You beam happily at Roland.

"Who gives this woman--" You glare icily at the minister. You are nobody's property. "Ahem. Moving on," says the minister, visibly flustered. Roland looks at you questioningly, but says nothing.

>[4] z
You beam happily at Roland.

"Love is a wonderful thing." And so on. You're too excited to pay attention to every word.

>[5] z
You beam happily at Roland.

"Elizabeth, do you take Roland to be your husband?"

>[6] z
The minister is waiting for your answer. Please say "yes" or "no".

>[7] yes
Of course you do!

The minister smiles at you and turns to Roland. "And, Roland, do you take Elizabeth to be your wife?"

Roland grins at you and exclaims, "I do!"

"I now pronounce you man and... dragon?!?" The minister's eyes go wide, seconds before he is incinerated by a burst of flame.

A large dragon flies overhead. The wedding guests scatter in every direction. You cower against Roland, but he pushes you towards the dragon and runs towards the road.

The dragon eats all the guests it can catch, and when it has had its fill, it smashes your castle to smithereens with its heavy tail and sets the remains on fire. You are nearly caught in a blaze of flame as you duck behind what used to be the stone wall of the garden. You are unhurt, but your fine gown snags on a rose bush and tears.

As the dragon finally turns to go, it catches sight of Roland, running down the road towards the river. It swoops down and smashes the bridge just as Roland is about to cross it and catches him up in its claws. The dragon flies away with your beloved prince.

Please press SPACE to continue.

* * *

>x wings
Even furled, the wings nearly double the size of the dragon.

>ask dragon about wings
"Wait!" you exclaim.

Surprised, the dragon steps entirely out of the cave, nudging the door shut with its tail.

The dragon says, "I'm afraid I don't know anything about that."

>ask dragon about himself
You say, "Is it true that you are the smartest and fiercest dragon in the whole world?"

"Yes," says the dragon. Boastful fellow, isn't he?

>x it
Up close, you realize this dragon isn't actually very large, only about fifteen cubits from the tip of its nose to the spiked end of its tail. Its wings are folded neatly at its sides, and a swirl of smoke escapes its nostrils.

>x him
You can't see "him" (Roland) at the moment.

* * *

>n
Burnt Forest
There's a trail of burned trees and what appear to be teeth leading to the northeast. One tree in particular catches your eye.

>ne
Dimly Lit Forest
You feel as if you are in a twisty maze of giant trees.

>n
Dimly Lit Forest
You feel as if you are in a maze of twisty giant trees.

* * *

>ask about flight
(addressing the dragon)
"Wait!" you exclaim.

Surprised, the dragon steps entirely out of the cave, nudging the door shut with its tail.

You say, "Dragon, is it true that you can fly around the world in just ten seconds?"

"Why, yes," says the dragon, and it jumps up and flies around the world in just ten seconds. It seems very tired when it returns.

Were you impressed by that display? (Y/N)

>y
yes
"Fantastic!" you exclaim. "Do it again!"

The dragon jumps up and flies around the whole world in just twenty seconds. When it returns, it flops down on the ground.

>y
That was a rhetorical question.

>ask about flame
"Is it true," you say, "that you can burn up ten forests with your fiery breath?"

"Oh, yes," says the dragon, and it takes a huge, deep breath and breathes out so much fire that it burns up fifty forests.

Wasn't that amazing?

>n
no
Apparently it takes a lot to impress you! But you force yourself to look delighted as you shout, "Do it again!"

The dragon takes another huge breath and breathes out so much fire that it burns up one hundred forests.

Were you impressed by that display?

* * *

>x dragon
This dragon is not very large, only about fifteen feet from the tip of its nose to the end of its tail. Its green scales shimmer in the glow of your torch.

>blow out torch
You put out the torch.

>x torx dragon
You can't see any such thing.

>x dragon
This dragon is not very large, only about fifteen feet from the tip of its nose to the end of its tail.

>talk to dragon
You say, "Is it true that you are the smartest and fiercest dragon in the whole world?"

"Yes", says the dragon. Boastful fellow, isn't he?

>talk to dragon
You say, "Is it true that you are the smartest and fiercest dragon in the whole world?"

"Yes", says the dragon. Boastful fellow, isn't he?

>ask about fire
"Is it true," you say, "that you can burn up ten forests with your fiery breath?"

"Oh, yes", says the dragon, and he takes a huge, deep breath and breathes out so much fire that he burns up fifty forests.

Were you impressed by that display?

>y
"Fantastic!" you exclaim. "Do it again!"

The dragon takes another huge breath and breathes out so much fire that he burns up one hundred forests.

Wasn't that amazing?

* * *

>y
"Magnificent!" you shout. "Do it again!"

The dragon takes another huge breath. But this time, nothing comes out.

>ask about flight
You say, "Dragon, is it true that you can fly around the world in just ten seconds?"

"Why, yes," says the dragon, and he jumps up and flies around the world in just ten seconds. He seems very tired when he returns.

Were you impressed by that display?

>y
"Fantastic!" you exclaim. "Do it again!"

The dragon jumps up and flies around the whole world in just twenty seconds. When he returns, he flops down on the ground.

The dragon falls asleep.

>attack dragon
The dragon is harmless to you while asleep.

>w
You can't go that way.

>s
You can't go that way.

>undo
Outside the Dragon's Cave
[Previous turn undone.]

>undo
Outside the Dragon's Cave
[Previous turn undone.]

>attack dragon
The dragon is harmless to you while asleep.

>undo
Outside the Dragon's Cave
[Previous turn undone.]

* * *

The Paper Bag Princess
An interactive fairy tale by Adri
Release 1 / Serial number 130928 / Inform 7 build 6G60 (I6/v6.32 lib 6/12N) SD

Castle Ruins
This used to be your home. Now it is nothing more than a smoking pile of rubble. The smoke obscures your view of the stars, and the primary source of light is the burning remains of your furniture.

The only road away from the castle now ends abruptly at the river bank. The forest surrounds you thickly on all sides, except for an area to the north where the trees have been broken and scorched.

>[8] test ruins
(Testing.)

>[9] search rubble
You dig through the piles of rubble until you find a paper bag.

>[10] take bag
Taken.

>[11] wear bag
You quickly fashion a dress out of the gift bag. It's not as fancy as you're used to, but it'll get the job done.

You strip off the remains of your wedding gown.

You slip the makeshift dress over your head and pull it down past your hips.

>[12] n

Burnt Forest
There's a trail of burned trees and what appear to be teeth leading to the northeast. One tree in particular catches your eye.

>[13] test burnt
(Testing.)

>[14] x trail
The trail disappears into the woods.

You find a large branch lying on the trail.

>[15] take branch
Taken.

>[16] x tree
You examine the tree more closely. Someone has carved "PLUGH" into the trunk.

>[17] plugh
POOF! Your fairy godmother appears. "Tsk," she says. "Poor girl. I'm not sure I can help you with this one." She pauses and rummages around in her pockets, pulling out a vial. She hands it to you. "This is the best I can do. Use it wisely." Then she vanishes, as quickly as she appeared.

>[18] test torch
(Testing.)

>[19] make torch
You fashion a torch from the branch and the remains of your wedding gown.

>[20] open vial
You open the vial, revealing an oily black liquid.

>[21] pour oil on torch
You pour the oily black liquid onto the torch and discard the empty vial.

>[22] s

Castle Ruins
This used to be your home. Now it is nothing more than a smoking pile of rubble. The smoke obscures your view of the stars, and the primary source of light is the burning remains of your furniture.

The only road away from the castle now ends abruptly at the river bank. The forest surrounds you thickly on all sides, except for an area to the north where the trees have been broken and scorched.

>[23] light torch
You light the torch with the flames.

* * *

This is the day you've always dreamed of. You are finally marrying the love of your life, Prince Roland.

Castle Garden
You are standing in the garden behind your family's castle. On this lovely fall evening, it is doing double duty as a wedding chapel.

Your betrothed, Roland, stands before you.

You can also see Father Alfred here.

>z.z.z.z.z.z
You beam happily at Roland.

Father Alfred begins the ceremony, "We are gathered here today to witness the joining of two hearts." Roland smiles shyly at you.

You beam happily at Roland.

"If anyone has a reason why these two should not be wed, speak now or forever hold your peace." You hold your breath for a second, wondering whether anyone will speak up. Fortunately, nobody does and you relax.

You beam happily at Roland.

"Who gives this woman--" You glare icily at the minister. You are nobody's property. "Ahem. Moving on," says the minister, visibly flustered. Roland looks at you questioningly, but says nothing.

You beam happily at Roland.

"Love is a wonderful thing." And so on. You're too excited to pay attention to every word.

You beam happily at Roland.

"Elizabeth, do you take Roland to be your husband?"

The minister is waiting for your answer. Please say "yes" or "no".

>yes
Of course you do!

The minister smiles at you and turns to Roland. "And, Roland, do you take Elizabeth to be your wife?"

Roland grins at you and exclaims, "I do!".

"I now pronounce you man and... dragon?!?" The minister's eyes go wide, seconds before he is incinerated by a burst of flame.

A large dragon flies overhead. The wedding guests scatter in every direction. You cower against Roland, but he pushes you towards the dragon and runs towards the road.

The dragon eats all the guests it can catch, and when it has had its fill, it smashes your castle to smithereens with its heavy tail and sets the remains on fire. You are nearly caught in a blaze of flame as you duck behind what used to be the stone wall of the garden. You are unhurt, but your fine gown snags on a rose bush and tears.

As the dragon finally turns to go, it catches sight of Roland, running down the road towards the river. It swoops down and smashes the bridge just as Roland is about to cross it and catches him up in its claws. The dragon flies away with your beloved prince.

Please press SPACE to continue.

* * *

The Paper Bag Princess
An interactive fairy tale by Adri
Release 1 / Serial number 130928 / Inform 7 build 6G60 (I6/v6.32 lib 6/12N) SD

Castle Ruins
This used to be your home. Now it is nothing more than a smoking pile of rubble. The smoke obscures your view of the stars, and the primary source of light is the burning remains of your furniture.

The only road away from the castle now ends abruptly at the river bank. The forest surrounds you thickly on all sides, except for an area to the north where the trees have been broken and scorched.

>search rubble.take bag.wear bag
You dig through the piles of rubble until you find a paper bag.

Taken.

You quickly fashion a dress out of the gift bag. It's not as fancy as you're used to, but it'll get the job done.

You strip off the remains of your wedding gown.

You slip the makeshift dress over your head and pull it down past your hips.

>n
Burnt Forest
There's a trail of burned trees and horses' teeth leading to the northeast. One tree in particular catches your eye.

>undo
Castle Ruins
[Previous turn undone.]

>s
You can't go that way.

>swim
That's not a verb I recognize.

* * *

The Paper Bag Princess
An interactive fairy tale by Adri
Release 1 / Serial number 130928 / Inform 7 build 6G60 (I6/v6.32 lib 6/12N) SD

Castle Ruins
This used to be your home. Now it is nothing more than a smoking pile of rubble. The smoke obscures your view of the stars, and the primary source of light is the burning remains of your furniture.

The only road away from the castle now ends abruptly at the river bank. The forest surrounds you thickly on all sides, except for an area to the north where the trees have been broken and scorched.

>xyzzy.put vial on rags
POOF! Your fairy godmother appears. "Tsk," she says. "Poor girl. I'm not sure I can help you with this one." She pauses and rummages around in her pockets, pulling out a vial. She hands it to you. "This is the best I can do. Use it wisely." Then she vanishes, as quickly as she appeared.

Try pouring the vial on the handful of rags.

>put rags on vial
Try combining the handful of rags with the vial.

>combine rags with vial
You're not quite certain how to put those two things together.

* * *

>xyzzy
POOF! Your fairy godmother appears. "Tsk," she says. "Poor girl. I'm not sure I can help you with this one." She pauses and rummages around in her pockets, pulling out a vial. She hands it to you. "This is the best I can do. Use it wisely." Then she vanishes, as quickly as she appeared.

>x vial.open vial.x vial
 It's a vial of thick, black liquid.

You open the vial, revealing an oily black liquid.

 It's a vial of thick, black liquid.

In the vial is an oily black liquid.

>i
You are carrying a vial.

* * *

>x vial
It's a vial of thick, black liquid.

>open vial.x vial.remove rags.pour oil on rags.x vial
You open the vial, revealing an oily black liquid.

It's an open vial of thick, black liquid.

In the vial is an oily black liquid.

You strip off the remains of your wedding gown.

You pour the oily black liquid onto the handful of rags.

It's an open, but empty vial.

>close vial
You close the vial.

* * *

This is the day you've always dreamed of. You are finally marrying the love of your life, Prince Roland.

Castle Garden
You are standing in the garden behind your family's castle. On this lovely fall evening, it is doing double duty as a wedding chapel.

Your betrothed, Roland, stands before you.

You can also see Father Alfred here.

>z.z.z.z.z.z.yes
You beam happily at Roland.

Father Alfred begins the ceremony, "We are gathered here today to witness the joining of two hearts." Roland smiles shyly at you.

You beam happily at Roland.

"If anyone has a reason why these two should not be wed, speak now or forever hold your peace." You hold your breath for a second, wondering whether anyone will speak up. Fortunately, nobody does and you relax.

You beam happily at Roland.

"Who gives this woman--" You glare icily at the minister. You are nobody's property. "Ahem. Moving on," says the minister, visibly flustered. Roland looks at you questioningly, but says nothing.

You beam happily at Roland.

"Love is a wonderful thing." And so on. You're too excited to pay attention to every word.

You beam happily at Roland.

"Elizabeth, do you take Roland to be your husband?"

The minister is waiting for your answer. Please say "yes" or "no".

Of course you do!

The minister smiles at you and turns to Roland. "And, Roland, do you take Elizabeth to be your wife?"

Roland grins at you and exclaims, "I do!".

"I now pronounce you man and... dragon?!?" The minister's eyes go wide, seconds before he is incinerated by a burst of flame.

A large dragon flies overhead. The wedding guests scatter in every direction. You cower against Roland, but he pushes you towards the dragon and runs towards the road.

The dragon eats all the guests it can catch, and when it has had its fill, it smashes your castle to smithereens with its heavy tail and sets the remains on fire. You are nearly caught in a blaze of flame as you duck behind what used to be the stone wall of the garden. You are unhurt, but your fine gown snags on a rose bush and tears.

As the dragon finally turns to go, it catches sight of Roland, running down the road towards the river. It swoops down and smashes the bridge just as Roland is about to cross it and catches him up in its claws. The dragon flies away with your beloved prince.

Please press SPACE to continue.

* * *

This is the day you've always dreamed of. You are finally marrying the love of your life, Prince Roland.

Castle Garden
You are standing in the garden behind your family's castle. On this lovely fall evening, it is doing double duty as a wedding chapel.

Your betrothed, Roland, stands before you.

You can also see Father Alfred here.

>z.z.z.z.z.z.z.z.z
You beam happily at Roland.

Father Alfred begins the ceremony, "We are gathered here today to witness the joining of two hearts." Roland smiles shyly at you.

You beam happily at Roland.

"If anyone has a reason why these two should not be wed, speak now or forever hold your peace." You hold your breath for a second, wondering whether anyone will speak up. Fortunately, nobody does and you relax.

You beam happily at Roland.

"Who gives this woman--" You glare icily at the minister. You are nobody's property. "Ahem. Moving on," says the minister, visibly flustered. Roland looks at you questioningly, but says nothing.

You beam happily at Roland.

"Love is a wonderful thing." And so on. You're too excited to pay attention to every word.

You beam happily at Roland.

"Elizabeth, do you take Roland to be your husband?"

You beam happily at Roland.

You beam happily at Roland.

You beam happily at Roland.

You beam happily at Roland.

>yes
Of course you do!

The minister smiles at you and turns to Roland. "And, Roland, do you take Elizabeth to be your wife?"

Roland grins at you and exclaims, "I do!".

"I now pronounce you man and... dragon?!?" The minister's eyes go wide, seconds before he is incinerated by a burst of flame.

DRAGON!

Please press SPACE to continue.

* * *

The Paper Bag Princess
An interactive fairy tale by Adri
Release 1 / Serial number 130928 / Inform 7 build 6G60 (I6/v6.32 lib 6/12N) SD

Castle Ruins
This used to be your home. Now it is nothing more than a smoking pile of rubble. The smoke obscures your view of the stars, and the primary source of light is the burning remains of your furniture.

The only road away from the castle now ends abruptly at the river bank. The forest surrounds you thickly on all sides, except for an area to the north where the trees have been broken and scorched.

>x castle
These piles of brick and wood used to be your home.

>x brick
These piles of brick and wood used to be your home.

>x wood
You think you can make out the leg of a chair somewhere in that mess.

>x burning
The flames burn brightly.

>take flames
This dangerous act would achieve little.

>x road
This well-traveled road used to connect the castle to the rest of the kingdom. Unfortunately, the bridge across the river has been rendered impassable.

>x forest
The forest surrounds you thickly on all sides, except for an area to the north where the trees have been broken and scorched.

>x river
The water is very deep here, and it moves quickly. Your father used to scare you with stories of sharks, although you have never actually seen one.

>s
The only possible path appears to be through the forest to the north.

>nx me
That's not a verb I recognize.

>x me
You are young and beautiful, too lovely to be described in mere words. You are, however, in dire need of a bath and a change of clothes.

You are stark naked, save for a handful of rags and a tarnished gold crown.

>n
Perhaps you should find something to wear first!

>search rubble.take bag.wear bag
You dig through the piles of rubble until you find a paper bag.

Taken.

You quickly fashion a dress out of the gift bag. It's not as fancy as you're used to, but it'll get the job done.

You strip off the remains of your wedding gown.

You slip the makeshift dress over your head and pull it down past your hips.

* * *

This is the day you've always dreamed of. You are finally marrying the love of your life, Prince Roland.

Castle Garden
You are standing in the garden behind your family's castle. On this lovely fall evening, it is doing double duty as a wedding chapel.

Your betrothed, Roland, stands before you.

You can also see Father Alfred here.

>talk to me
They say talking to oneself is a sign of genius. Or maybe that was madness. Is there really a difference?

Father Alfred begins the ceremony, "We are gathered here today to witness the joining of two hearts." Roland smiles shyly at you.

>yes
They say talking to oneself is a sign of genius. Or maybe that was madness. Is there really a difference?

"If anyone has a reason why these two should not be wed, speak now or forever hold your peace." You hold your breath for a second, wondering whether anyone will speak up. Fortunately, nobody does and you relax.

>no
They say talking to oneself is a sign of genius. Or maybe that was madness. Is there really a difference?

"Who gives this woman--" You glare icily at the minister. You are nobody's property. "Ahem. Moving on," says the minister, visibly flustered. Roland looks at you questioningly, but says nothing.

>z.z.z.z
You beam happily at Roland.

"Love is a wonderful thing." And so on. You're too excited to pay attention to every word.

You beam happily at Roland.

"Elizabeth, do you take Roland to be your husband?"

You beam happily at Roland.

You beam happily at Roland.

>yes
Of course you do!

The minister smiles at you and turns to Roland. "And, Roland, do you take Elizabeth to be your wife?"

Roland grins at you and exclaims, "I do!".

"I now pronounce you man and... dragon?!?" The minister's eyes go wide, seconds before he is incinerated by a burst of flame.

DRAGON!

Please press SPACE to continue.

* * *

The Paper Bag Princess
An interactive fairy tale by Adri
Release 1 / Serial number 130928 / Inform 7 build 6G60 (I6/v6.32 lib 6/12N) SD

Castle Ruins
This used to be your home. Now it is nothing more than a smoking pile of rubble. The smoke obscures your view of the stars, and the primary source of light is the burning remains of your furniture.

The only road away from the castle now ends abruptly at the river bank. The forest surrounds you thickly on all sides, except for an area to the north where the trees have been broken and scorched.

>search rubble.wear bag.n.x teeth
You dig through the piles of rubble until you find a paper bag.

Taken.

You quickly fashion a dress out of the gift bag. It's not as fancy as you're used to, but it'll get the job done.

You strip off the remains of your wedding gown.

You slip the makeshift dress over your head and pull it down past your hips.

Burnt Forest
There's a trail of burned trees and what appear to be teeth leading to the northeast. One tree in particular catches your eye.

Yes. They are definitely teeth. You shudder involuntarily.

>take teeth
You have absolutely no need for those. What are you going to do, make a necklace?

>yes
That was a rhetorical question.

>x teeth
They are definitely teeth. You shudder involuntarily.

* * *

This is the day you've always dreamed of. You are finally marrying the love of your life, Prince Roland.

Castle Garden
You are standing in the garden behind your family's castle. On this lovely fall evening, it is doing double duty as a wedding chapel.

Your betrothed, Roland, stands before you.

You can also see Father Alfred here.

>test wedding
(Testing.)

>[1] z
You beam happily at Roland.

Father Alfred begins the ceremony, "We are gathered here today to witness the joining of two hearts." Roland smiles shyly at you.

>[2] z
You beam happily at Roland.

"If anyone has a reason why these two should not be wed, speak now or forever hold your peace." You hold your breath for a second, wondering whether anyone will speak up. Fortunately, nobody does and you relax.

>[3] z
You beam happily at Roland.

"Who gives this woman--" You glare icily at the minister. You are nobody's property. "Ahem. Moving on," says the minister, visibly flustered. Roland looks at you questioningly, but says nothing.

>[4] z
You beam happily at Roland.

"Love is a wonderful thing." And so on. You're too excited to pay attention to every word.

>[5] z
You beam happily at Roland.

"Elizabeth, do you take Roland to be your husband?"

>[6] yes
Of course you do!

The minister smiles at you and turns to Roland. "And, Roland, do you take Elizabeth to be your wife?"

Roland grins at you and exclaims, "I do!"

"I now pronounce you man and... dragon?!?" The minister's eyes go wide, seconds before he is incinerated by a burst of flame.

A large dragon flies overhead. The wedding guests scatter in every direction. You cower against Roland, but he pushes you towards the dragon and runs towards the road.

The dragon eats all the guests it can catch, and when it has had its fill, it smashes your castle to smithereens with its heavy tail and sets the remains on fire. You are nearly caught in a blaze of flame as you duck behind what used to be the stone wall of the garden. You are unhurt, but your fine gown snags on a rose bush and tears.

As the dragon finally turns to go, it catches sight of Roland, running down the road towards the river. It swoops down and smashes the bridge just as Roland is about to cross it and catches him up in its claws. The dragon flies away with your beloved prince.

Please press SPACE to continue.

The Paper Bag Princess
An interactive fairy tale by Adri
Release 1 / Serial number 130928 / Inform 7 build 6G60 (I6/v6.32 lib 6/12N) SD

Castle Ruins
This used to be your home. Now it is nothing more than a smoking pile of rubble. The smoke obscures your view of the stars, and the primary source of light is the burning remains of your furniture.

The only road away from the castle now ends abruptly at the river bank. The forest surrounds you thickly on all sides, except for an area to the north where the trees have been broken and scorched.

>test ruins
(Testing.)

>[1] search rubble
You dig through the piles of rubble until you find a paper bag.

>[2] take bag
You take the paper bag.

>[3] wear bag
You quickly fashion a dress out of the gift bag. It's not as fancy as you're used to, but it'll get the job done.

You strip off the remains of your wedding gown.

You slip the makeshift dress over your head and pull it down past your hips.

>[4] n

Burnt Forest
There's a trail of burned trees and what appear to be teeth leading to the northeast. One tree in particular catches your eye.

>x trail.take branch.x branch.x tree
The trail disappears into the woods.

You find a large branch lying on the trail.

Taken.

It's a branch. It would be a good size to make a torch with.

You examine the tree more closely. Someone has carved "PLUGH" into the trunk.

>x teeth.g
Yes. Those are definitely teeth.

A variety of teeth, only some of which appear to be human. You wonder briefly where the rest of the bones are.

>plugh
POOF! Your fairy godmother appears. "Tsk," she says. "Poor girl. I'm not sure I can help you with this one." She pauses and rummages around in her pockets, pulling out a vial. She hands it to you. "This is the best I can do. Use it wisely." Then she vanishes, as quickly as she appeared.

>x vial.open vial.pour vial on branch
 It's a vial of thick, black liquid.

You open the vial, revealing an oily black liquid.

You seem to be on the right track, but that's not quite how it works.

>pour vial on rags
You pour the oily black liquid onto the handful of rags.

>take teeth
You have absolutely no need for those. What are you going to do, make a necklace?

* * *

>yes
That was a rhetorical question.

>make torch
You fashion a torch from the branch and the remains of your wedding gown.

>light torch
There is no source of fire here.

>s.light torch
Castle Ruins
This used to be your home. Now it is nothing more than a smoking pile of rubble. The smoke obscures your view of the stars, and the primary source of light is the burning remains of your furniture.

The only road away from the castle now ends abruptly at the river bank. The forest surrounds you thickly on all sides, except for an area to the north where the trees have been broken and scorched.

You light the torch with the flames.

>blow out torch
You put out the torch.

>light torch.x torch
You light the torch with the flames.

It is a torch crafted from a branch and the remains of your wedding gown. It is on fire.

>burn me with torch.burn me with fire.burn me with bag.
That seems like a recipe for disaster.

This dangerous act would achieve little.

Whatever you expected to happen has not happened.

>burn torch
That is already on fire.

>n.ne.n.n.n.n.n.n.n.n.n.n.n.n
Burnt Forest
There's a trail of burned trees and what appear to be teeth leading to the northeast. One tree in particular catches your eye.

Dimly Lit Forest
Something something something.

Dimly Lit Forest
Something something something.

Dimly Lit Forest
Something something something.

Dimly Lit Forest
Something something something.

Dimly Lit Forest
Something something something.

The torch starts to flicker. It will probably burn out soon.

Dimly Lit Forest
Something something something.

There is a patch of mushrooms here.

Dimly Lit Forest
Something something something.

Cave Exterior
Cave Door.

You can't go that way.

You can't go that way.

You can't go that way.

You can't go that way.

You can't go that way.

* * *

>test ruins
(Testing.)

>[1] search rubble
You dig through the piles of rubble until you find a paper bag.

>[2] take bag
You take the paper bag.

>[3] wear bag
You quickly fashion a dress out of the gift bag. It's not as fancy as you're used to, but it'll get the job done.

You strip off the remains of your wedding gown.

You slip the makeshift dress over your head and pull it down past your hips.

>[4] n

Burnt Forest
There's a trail of burned trees and what appear to be teeth leading to the northeast. One tree in particular catches your eye.

>x tee
You can't see any such thing.

>x tree.g
You examine the tree more closely. Someone has carved "PLUGH" into the trunk.

There is a large branch propped up against the base of the tree.

You examine the tree more closely. Someone has carved "PLUGH" into the trunk.

>l
Burnt Forest
There's a trail of burned trees and what appear to be teeth leading to the northeast. One tree in particular catches your eye.

You can see a branch here.

* * *

>test ruins
(Testing.)

>[1] search rubble
You dig through the piles of rubble until you find a paper bag.

>[2] take bag
You take the paper bag.

>[3] wear bag
You quickly fashion a dress out of the gift bag. It's not as fancy as you're used to, but it'll get the job done.

You strip off the remains of your wedding gown.

You slip the makeshift dress over your head and pull it down past your hips.

>[4] n

Burnt Forest
There's a trail of burned trees and what appear to be teeth leading to the northeast. One tree in particular catches your eye.

>xyzzy
POOF! Your fairy godmother appears. "Tsk," she says. "Poor girl. I'm not sure I can help you with this one." She pauses and rummages around in her pockets, pulling out a vial. She hands it to you. "This is the best I can do. Use it wisely." Then she vanishes, as quickly as she appeared.

>drink vial
The vial isn't open.

* * *

>xyzzy
POOF! Your fairy godmother appears. "Tsk," she says. "Poor girl. I'm not sure I can help you with this one." She pauses and rummages around in her pockets, pulling out a vial. She hands it to you. "This is the best I can do. Use it wisely." Then she vanishes, as quickly as she appeared.

>pour vial on me
The vial isn't open.

>open vial
You open the vial.

>pour vial on me
Ew.

>empty vial onto me
Ew.

* * *

>xyzzy
POOF! Your fairy godmother appears. "Tsk," she says. "Poor girl. I'm not sure I can help you with this one." She pauses and rummages around in her pockets, pulling out a vial. She hands it to you. "This is the best I can do. Use it wisely." Then she vanishes, as quickly as she appeared.

>pour vial
What do you want to pour the vial on?

>open vial
You open the vial.

>pour vial on vial
There isn't very much in the bottle. You shouldn't waste it.

>restart
Are you sure you want to restart?

* * *

>y
This is the day you've always dreamed of. You are finally marrying the love of your life, Prince Roland.

Castle Garden
You are standing in the garden behind your family's castle. On this lovely fall evening, it is doing double duty as a wedding chapel.

Your betrothed, Roland, stands before you.

You can also see Father Alfred here.

>test me
(Testing.)

>[1] test wedding
(Testing.)

>[2] z
You beam happily at Roland.

Father Alfred begins the ceremony, "We are gathered here today to witness the joining of two hearts." Roland smiles shyly at you.

>[3] z
You beam happily at Roland.

"If anyone has a reason why these two should not be wed, speak now or forever hold your peace." You hold your breath for a second, wondering whether anyone will speak up. Fortunately, nobody does and you relax.

>[4] z
You beam happily at Roland.

"Who gives this woman--" You glare icily at the minister. You are nobody's property. "Ahem. Moving on," says the minister, visibly flustered. Roland looks at you questioningly, but says nothing.

>[5] z
You beam happily at Roland.

"Love is a wonderful thing." And so on. You're too excited to pay attention to every word.

>[6] z
You beam happily at Roland.

"Elizabeth, do you take Roland to be your husband?"

>[7] yes
Of course you do!

The minister smiles at you and turns to Roland. "And, Roland, do you take Elizabeth to be your wife?"

Roland grins at you and exclaims, "I do!"

"I now pronounce you man and... dragon?!?" The minister's eyes go wide, seconds before he is incinerated by a burst of flame.

A large dragon flies overhead. The wedding guests scatter in every direction. You cower against Roland, but he pushes you towards the dragon and runs towards the road.

The dragon eats all the guests it can catch, and when it has had its fill, it smashes your castle to smithereens with its heavy tail and sets the remains on fire. You are nearly caught in a blaze of flame as you duck behind what used to be the stone wall of the garden. You are unhurt, but your fine gown snags on a rose bush and tears.

As the dragon finally turns to go, it catches sight of Roland, running down the road towards the river. It swoops down and smashes the bridge just as Roland is about to cross it and catches him up in its claws. The dragon flies away with your beloved prince.

Please press SPACE to continue.

* * *

>ask about flight
(addressing the dragon)
"Wait!" you exclaim.

Surprised, the dragon steps entirely out of the cave, nudging the door shut with his tail.

You say, "Dragon, is it true that you can fly around the world in just ten seconds?"

"Why, yes," says the dragon, and he jumps up and flies around the world in just ten seconds. He seems very tired when he returns.

Were you impressed by that display?

>y
>yes
"Fantastic!" you exclaim. "Do it again!"

The dragon jumps up and flies around the whole world in just twenty seconds. When he returns, he flops down on the ground.

>ask about fire
"Is it true," you say, "that you can burn up ten forests with your fiery breath?"

"Oh, yes", says the dragon, and he takes a huge, deep breath and breathes out so much fire that he burns up fifty forests.

Wasn't that amazing?

>y
>yes
"Magnificent!" you shout. "Do it again!"

The dragon takes another huge breath and breathes out so much fire that he burns up one hundred forests.

Were you impressed by that display?

>y
>yes
"Fantastic!" you exclaim. "Do it again!"

The dragon takes another huge breath. But this time, nothing comes out.

The dragon is so tired that he falls fast asleep.

>e
(first opening the cave door)
You step over the dragon and open the door to the cave.

The Dragon's Cave
This is where the dragon lives. Piles of treasure fill the room, reflecting light in every direction.

Your betrothed, Roland, stands before you.

Roland looks at you and says, "Elizabeth, you are a mess! You smell like ashes, your hair is all tangled, and you are wearing a dirty paper bag. Come back when you are dressed like a real princess."

>shove roland
That's not a verb I recognize.

* * *

This is the day you've always dreamed of. You are finally marrying the love of your life, Prince Roland.

Castle Garden
You are standing in the garden behind your family's castle. On this lovely fall evening, it is doing double duty as a wedding chapel.

Your betrothed, Roland, stands before you.

You can also see Father Alfred here.

>pronouns
At the moment, "it" is unset, "him" means Roland, "her" is unset, and "them" is unset.

* * *

This is the day you've always dreamed of. You are finally marrying the love of your life, Prince Roland.

Castle Garden
You are standing in the garden behind your family's castle. On this lovely fall evening, it is doing double duty as a wedding chapel.

Your betrothed, Roland, stands before you.

You can also see Father Alfred here.

>x minister
Father Alfred has been your family's minister for as long as you can remember.

Father Alfred begins the ceremony, "We are gathered here today to witness the joining of two hearts." Roland smiles shyly at you.

>x him
Father Alfred has been your family's minister for as long as you can remember.

"If anyone has a reason why these two should not be wed, speak now or forever hold your peace." You hold your breath for a second, wondering whether anyone will speak up. Fortunately, nobody does and you relax.

* * *

This is the day you've always dreamed of. You are finally marrying the love of your life, Prince Roland.

Castle Garden
You are standing in the garden behind your family's castle. On this lovely fall evening, it is doing double duty as a wedding chapel.

Your betrothed, Roland, stands before you.

You can also see Father Alfred here.

>z.z.z.z.z.yes
You beam happily at Roland.

Father Alfred begins the ceremony, "We are gathered here today to witness the joining of two hearts." Roland smiles shyly at you.

You beam happily at Roland.

"If anyone has a reason why these two should not be wed, speak now or forever hold your peace." You hold your breath for a second, wondering whether anyone will speak up. Fortunately, nobody does and you relax.

You beam happily at Roland.

"Who gives this woman--" You glare icily at the minister. You are nobody's property. "Ahem. Moving on," says the minister, visibly flustered. Roland looks at you questioningly, but says nothing.

You beam happily at Roland.

"Love is a wonderful thing." And so on. You're too excited to pay attention to every word.

You beam happily at Roland.

"Elizabeth, do you take Roland to be your husband?"

Of course you do!

The minister smiles at you and turns to Roland. "And, Roland, do you take Elizabeth to be your wife?"

Roland grins at you and exclaims, "I do!".

"I now pronounce you man and... dragon?!?" The minister's eyes go wide, seconds before he is incinerated by a burst of flame.

A large dragon flies overhead. The wedding guests scatter in every direction. You cower against Roland, but he pushes you towards the dragon and runs towards the road.

The dragon eats all the guests it can catch, and when it has had its fill, it smashes your castle to smithereens with its heavy tail and sets the remains on fire. You are nearly caught in a blaze of flame as you duck behind what used to be the stone wall of the garden. You are unhurt, but your fine gown snags on a rose bush and tears.

As the dragon finally turns to go, it catches sight of Roland, running down the road towards the river. It swoops down and smashes the bridge just as Roland is about to cross it and catches him up in its claws. The dragon flies away with your beloved prince.

Please press SPACE to continue.

* * *

This is the day you've always dreamed of. You are finally marrying the love of your life, Prince Roland.

Castle Garden
You are standing in the garden behind your family's castle. On this lovely fall evening, it is doing double duty as a wedding chapel.

Your betrothed, Roland, stands before you.

You can also see Father Alfred here.

>heteronormativity off
Ok!

>x her
Rolande is the most attractive woman you have ever laid eyes on.

Father Alfred begins the ceremony, "We are gathered here today to witness the joining of two hearts." Rolande smiles shyly at you.

* * *

This is the day you've always dreamed of. You are finally marrying the love of your life, Prince Roland.

Castle Garden
You are standing in the garden behind your family's castle. On this lovely fall evening, it is doing double duty as a wedding chapel.

Your betrothed, Roland, stands before you.

You can also see Father Alfred here.

>up
You can't leave yet! The ceremony hasn't ended.

Father Alfred begins the ceremony, "We are gathered here today to witness the joining of two hearts." Roland smiles shyly at you.

>test me
(Testing.)

>[1] test wedding
(Testing.)

>[2] z
You beam happily at Roland.

"If anyone has a reason why these two should not be wed, speak now or forever hold your peace." You hold your breath for a second, wondering whether anyone will speak up. Fortunately, nobody does and you relax.

>[3] z
You beam happily at Roland.

"Who gives this woman--" You glare icily at the minister. You are nobody's property. "Ahem. Moving on," says the minister, visibly flustered. Roland looks at you questioningly, but says nothing.

>[4] z
You beam happily at Roland.

"Love is a wonderful thing." And so on. You're too excited to pay attention to every word.

>[5] z
You beam happily at Roland.

"Elizabeth, do you take Roland to be your husband?"

>[6] z
The minister is waiting for your answer. Please say "yes" or "no".

>[7] yes
Of course you do!

The minister smiles at you and turns to Roland. "And, Roland, do you take Elizabeth to be your wife?"

Roland grins at you and exclaims, "I do!".

"I now pronounce you man and... dragon?!?" The minister's eyes go wide, seconds before he is incinerated by a burst of flame.

A large dragon flies overhead. The wedding guests scatter in every direction. You cower against Roland, but he pushes you towards the dragon and runs towards the road.

The dragon eats all the guests it can catch, and when it has had its fill, it smashes your castle to smithereens with its heavy tail and sets the remains on fire. You are nearly caught in a blaze of flame as you duck behind what used to be the stone wall of the garden. You are unhurt, but your fine gown snags on a rose bush and tears.

As the dragon finally turns to go, it catches sight of Roland, running down the road towards the river. It swoops down and smashes the bridge just as Roland is about to cross it and catches him up in its claws. The dragon flies away with your beloved prince.

Please press SPACE to continue.

The Paper Bag Princess
An interactive fairy tale by Adri
Release 1 / Serial number 130928 / Inform 7 build 6G60 (I6/v6.32 lib 6/12N) SD

Castle Ruins
This used to be your home. Now it is nothing more than a smoking pile of rubble. The smoke obscures your view of the stars, and the primary source of light is the burning remains of your furniture.

The only road away from the castle now ends abruptly at the river bank. The forest surrounds you thickly on all sides, except for an area to the north where the trees have been broken and scorched.

>[8] test ruins
(Testing.)

>[9] search rubble
You dig through the piles of rubble until you find a paper bag.

>[10] take bag
Taken.

>[11] wear bag
You quickly fashion a dress out of the gift bag. It's not as fancy as you're used to, but it'll get the job done.

You strip off the remains of your wedding gown.

You slip the makeshift dress over your head and pull it down past your hips.

>[12] n

Burnt Forest
There's a trail of burned trees and what appear to be teeth leading to the northeast. One tree in particular catches your eye.

>[13] test burnt
(Testing.)

>[14] x trail
The trail disappears into the woods.

You find a large branch lying on the trail.

>[15] take branch
Taken.

>[16] x tree
You examine the tree more closely. Someone has carved "PLUGH" into the trunk.

>[17] plugh
POOF! Your fairy godmother appears. "Tsk," she says. "Poor girl. I'm not sure I can help you with this one." She pauses and rummages around in her pockets, pulling out a vial. She hands it to you. "This is the best I can do. Use it wisely." Then she vanishes, as quickly as she appeared.

>test torch
(Testing.)

>[1] make torch
You fashion a torch from the branch and the remains of your wedding gown.

>[2] open vial
You open the vial, revealing an oily black liquid.

>[3] pour oil on torch
You pour the oily black liquid onto the torch and discard the empty vial.

>[4] s

Castle Ruins
This used to be your home. Now it is nothing more than a smoking pile of rubble. The smoke obscures your view of the stars, and the primary source of light is the burning remains of your furniture.

The only road away from the castle now ends abruptly at the river bank. The forest surrounds you thickly on all sides, except for an area to the north where the trees have been broken and scorched.

>[5] light torch
You light the torch with the flames.

>n.ne.n
Burnt Forest
There's a trail of burned trees and what appear to be teeth leading to the northeast. One tree in particular catches your eye.

Dimly Lit Forest
You feel as if you are in a maze of twisty giant trees.

Dimly Lit Forest
You feel as if you are in a twisty giant maze of trees.

>upx trees.x maze.x forest
That's not a verb I recognize.

>x trees.x maze.x forest
You can't see any such thing.

* * *

This is the day you've always dreamed of. You are finally marrying the love of your life, Prince Roland.

Castle Garden
You are standing in the garden behind your family's castle. On this lovely fall evening, it is doing double duty as a wedding chapel.

Your betrothed, Roland, stands before you.

You can also see Father Alfred here.

>x man
You can't see any such thing.

>x woman
You can't see any such thing.

* * *

This is the day you've always dreamed of. You are finally marrying the love of your life, Prince Roland.

Castle Garden
You are standing in the garden behind your family's castle. On this lovely fall evening, it is doing double duty as a wedding chapel.

Your betrothed, Roland, stands before you.

You can also see Father Alfred here.

>forward
That's not a verb I recognize.

>test me
(Testing.)

>[1] test wedding
(Testing.)

>[2] z
You beam happily at Roland.

Father Alfred begins the ceremony, "We are gathered here today to witness the joining of two hearts." Roland smiles shyly at you.

>[3] z
You beam happily at Roland.

"If anyone has a reason why these two should not be wed, speak now or forever hold your peace." You hold your breath for a second, wondering whether anyone will speak up. Fortunately, nobody does and you relax.

>[4] z
You beam happily at Roland.

"Who gives this woman--" You glare icily at the minister. You are nobody's property. "Ahem. Moving on," says the minister, visibly flustered. Roland looks at you questioningly, but says nothing.

>[5] z
You beam happily at Roland.

"Love is a wonderful thing." And so on. You're too excited to pay attention to every word.

>[6] z
You beam happily at Roland.

"Elizabeth, do you take Roland to be your husband?"

>[7] yes
Of course you do!

The minister smiles at you and turns to Roland. "And, Roland, do you take Elizabeth to be your wife?"

Roland grins at you and exclaims, "I do!".

"I now pronounce you man and... dragon?!?" The minister's eyes go wide, seconds before he is incinerated by a burst of flame.

A large dragon flies overhead. The wedding guests scatter in every direction. You cower against Roland, but he pushes you towards the dragon and runs towards the road.

The dragon eats all the guests it can catch, and when it has had its fill, it smashes your castle to smithereens with its heavy tail and sets the remains on fire. You are nearly caught in a blaze of flame as you duck behind what used to be the stone wall of the garden. You are unhurt, but your fine gown snags on a rose bush and tears.

As the dragon finally turns to go, it catches sight of Roland, running down the road towards the river. It swoops down and smashes the bridge just as Roland is about to cross it and catches him up in its claws. The dragon flies away with your beloved prince.

Please press SPACE to continue.

* * *

>dragon, go to sleep
"Wait!" you exclaim.

The dragon rolls his eyes and steps entirely out of the cave, nudging the door shut with his tail.

The dragon says, "I'm afraid I don't know anything about that."

>e
The only escape is back into the forest. You came to rescue Roland, and you are not leaving without him!

>enter cave
The only escape is back into the forest. You came to rescue Roland, and you are not leaving without him!

>s
The door into the cave leads east.

* * *

This is the day you've always dreamed of. You are finally marrying the love of your life, Prince Roland.

Castle Garden
You are standing in the garden behind your family's castle. On this lovely fall evening, it is doing double duty as a wedding chapel.

Your betrothed, Roland, stands before you.

You can also see Father Alfred here.

>x garden.x roses
Your grandmother planted these rose bushes. They bloom in every color you could imagine, plus some you don't even have names for.

Father Alfred begins the ceremony, "We are gathered here today to witness the joining of two hearts." Roland smiles shyly at you.

Your grandmother planted these rose bushes. They bloom in every color you could imagine, plus some you don't even have names for.

"If anyone has a reason why these two should not be wed, speak now or forever hold your peace." You hold your breath for a second, wondering whether anyone will speak up. Fortunately, nobody does and you relax.

>smell
You smell nothing unexpected.

"Who gives this woman--" You glare icily at the minister. You are nobody's property. "Ahem. Moving on," says the minister, visibly flustered. Roland looks at you questioningly, but says nothing.

>smell flowers
You smell nothing unexpected.

"Love is a wonderful thing." And so on. You're too excited to pay attention to every word.

* * *

This is the day you've always dreamed of. You are finally marrying the love of your life, Prince Roland.

Castle Garden
You are standing in the garden behind your family's castle. On this lovely fall evening, it is doing double duty as a wedding chapel.

Your betrothed, Roland, stands before you.

You can also see Father Alfred here.

>hug roland
You'll have your chance soon enough!

Father Alfred begins the ceremony, "We are gathered here today to witness the joining of two hearts." Roland smiles shyly at you.

* * *

This is the day you've always dreamed of. You are finally marrying the love of your life, Prince Roland.

Castle Garden
You are standing in the garden behind your family's castle. On this lovely fall evening, it is doing double duty as a wedding chapel.

Your betrothed, Roland, stands before you.

You can also see Father Alfred here.

>swim
There is nothing here for you to swim in.

Father Alfred begins the ceremony, "We are gathered here today to witness the joining of two hearts." Roland smiles shyly at you.

>z.z.z.z.z
You beam happily at Roland.

"If anyone has a reason why these two should not be wed, speak now or forever hold your peace." You hold your breath for a second, wondering whether anyone will speak up. Fortunately, nobody does and you relax.

You beam happily at Roland.

"Who gives this woman--" You glare icily at the minister. You are nobody's property. "Ahem. Moving on," says the minister, visibly flustered. Roland looks at you questioningly, but says nothing.

You beam happily at Roland.

"Love is a wonderful thing." And so on. You're too excited to pay attention to every word.

You beam happily at Roland.

"Elizabeth, do you take Roland to be your husband?"

The minister is waiting for your answer. Please say "yes" or "no".

>yes
Of course you do!

The minister smiles at you and turns to Roland. "And, Roland, do you take Elizabeth to be your wife?"

Roland grins at you and exclaims, "I do!".

"I now pronounce you man and... dragon?!?" The minister's eyes go wide, seconds before he is incinerated by a burst of flame.

A large dragon flies overhead. The wedding guests scatter in every direction. You cower against Roland, but he pushes you towards the dragon and runs towards the road.

The dragon eats all the guests it can catch, and when it has had its fill, it smashes your castle to smithereens with its heavy tail and sets the remains on fire. You are nearly caught in a blaze of flame as you duck behind what used to be the stone wall of the garden. You are unhurt, but your fine gown snags on a rose bush and tears.

As the dragon finally turns to go, it catches sight of Roland, running down the road towards the river. It swoops down and smashes the bridge just as Roland is about to cross it and catches him up in its claws. The dragon flies away with your beloved prince.

Please press SPACE to continue.

* * *

The Paper Bag Princess
An interactive fairy tale by Adri
Release 1 / Serial number 130928 / Inform 7 build 6G60 (I6/v6.32 lib 6/12N) SD

Castle Ruins
This used to be your home. Now it is nothing more than a smoking pile of rubble. The smoke obscures your view of the stars, and the primary source of light is the burning remains of your furniture.

The only road away from the castle now ends abruptly at the river bank. The forest surrounds you thickly on all sides, except for an area to the north where the trees have been broken and scorched.

>swim
You are a powerful swimmer, but you would freeze to death before you could reach the other side.

>restart
Are you sure you want to restart?

* * *

>y
This is the day you've always dreamed of. You are finally marrying the love of your life, Prince Roland.

Castle Garden
You are standing in the garden behind your family's castle. On this lovely fall evening, it is doing double duty as a wedding chapel.

Your betrothed, Roland, stands before you.

You can also see Father Alfred here.

>xyzzy
POOF! Your fairy godmother appears. She smiles at you and places a necklace around your neck.

Father Alfred begins the ceremony, "We are gathered here today to witness the joining of two hearts." Roland smiles shyly at you.

>z.z.z
You beam happily at Roland.

"If anyone has a reason why these two should not be wed, speak now or forever hold your peace." You hold your breath for a second, wondering whether anyone will speak up. Fortunately, nobody does and you relax.

You beam happily at Roland.

"Who gives this woman--" You glare icily at the minister. You are nobody's property. "Ahem. Moving on," says the minister, visibly flustered. Roland looks at you questioningly, but says nothing.

You beam happily at Roland.

"Love is a wonderful thing." And so on. You're too excited to pay attention to every word.

>z
You beam happily at Roland.

"Elizabeth, do you take Roland to be your husband?"

* * *

This is the day you've always dreamed of. You are finally marrying the love of your life, Prince Roland.

Castle Garden
You are standing in the garden behind your family's castle. On this lovely fall evening, it is doing double duty as a wedding chapel.

Your betrothed, Roland, stands before you.

You can also see Father Alfred here.

>test wedding.test ruins.test burnt
(Testing.)

(Testing.)

(Testing.)

>[1] x trail
You can't see any such thing.

>[2] take branch
You can't see any such thing.

>[3] x tree
You can't see any such thing.

>[4] plugh
POOF! Your fairy godmother appears. She smiles at you and places a necklace around your neck. Then she fades out of view.

Father Alfred begins the ceremony, "We are gathered here today to witness the joining of two hearts." Roland smiles shyly at you.

>[5] search rubble
You can't see any such thing.

>[6] take bag
You can't see any such thing.

>[7] wear bag
You can't see any such thing.

>[8] n
You can't leave yet! The ceremony hasn't ended.

"If anyone has a reason why these two should not be wed, speak now or forever hold your peace." You hold your breath for a second, wondering whether anyone will speak up. Fortunately, nobody does and you relax.

>[9] z
You beam happily at Roland.

"Who gives this woman--" You glare icily at the minister. You are nobody's property. "Ahem. Moving on," says the minister, visibly flustered. Roland looks at you questioningly, but says nothing.

>[10] z
You beam happily at Roland.

"Love is a wonderful thing." And so on. You're too excited to pay attention to every word.

>[11] z
You beam happily at Roland.

"Elizabeth, do you take Roland to be your husband?"

>[12] z
The minister is waiting for your answer. Please say "yes" or "no".

>[13] z
The minister is waiting for your answer. Please say "yes" or "no".

>[14] yes
Of course you do!

The minister smiles at you and turns to Roland. "And, Roland, do you take Elizabeth to be your wife?"

Roland grins at you and exclaims, "I do!"

"I now pronounce you man and... dragon?!?" The minister's eyes go wide, seconds before he is incinerated by a burst of flame.

A large dragon flies overhead. The wedding guests scatter in every direction. You cower against Roland, but he pushes you towards the dragon and runs towards the road.

The dragon eats all the guests it can catch, and when it has had its fill, it smashes your castle to smithereens with its heavy tail and sets the remains on fire. You are nearly caught in a blaze of flame as you duck behind what used to be the stone wall of the garden. You are unhurt, but your fine gown snags on a rose bush and tears.

As the dragon finally turns to go, it catches sight of Roland, running down the road towards the river. It swoops down and smashes the bridge just as Roland is about to cross it and catches him up in its claws. The dragon flies away with your beloved prince.

Please press SPACE to continue.

The Paper Bag Princess
An interactive fairy tale by Adri
Release 1 / Serial number 130928 / Inform 7 build 6G60 (I6/v6.32 lib 6/12N) SD

Castle Ruins
This used to be your home. Now it is nothing more than a smoking pile of rubble. The smoke obscures your view of the stars, and the primary source of light is the burning remains of your furniture.

The only road away from the castle now ends abruptly at the river bank. The forest surrounds you thickly on all sides, except for an area to the north where the trees have been broken and scorched.

>test ruins
(Testing.)

>[1] search rubble
You dig through the piles of rubble until you find a paper bag.

>[2] take bag
You take the paper bag.

>[3] wear bag
You quickly fashion a dress out of the gift bag. It's not as fancy as you're used to, but it'll get the job done.

You strip off the remains of your wedding gown and discard them in a pile of rubble.

You slip the makeshift dress over your head and pull it down past your hips.

>[4] n

Burnt Forest
There's a trail of burned trees and what appear to be teeth leading to the northeast. One tree in particular catches your eye.

>test burnt
(Testing.)

>[1] x trail
The trail disappears into the woods.

You notice a large branch lying on the trail.

>[2] take branch
You take the branch.

>[3] x tree
You examine the tree more closely. Someone has carved "PLUGH" into the trunk.

>[4] plugh
The necklace suddenly begins to glow.

>pour oil on me
You can't see any such thing.

>put rags on branch
You can't see any such thing.

* * *

This is the day you've always dreamed of. You are finally marrying the love of your life, Prince Roland.

Castle Garden
You are standing in the garden behind your family's castle. On this lovely fall evening, it is doing double duty as a wedding chapel.

Your betrothed, Roland, stands before you.

You can also see Father Alfred here.

>put
What do you want to put on?

* * *

This is the day you've always dreamed of. You are finally marrying the love of your life, Prince Roland.

Castle Garden
You are standing in the garden behind your family's castle. On this lovely fall evening, it is doing double duty as a wedding chapel.

Your betrothed, Roland, stands before you.

You can also see Father Alfred here.

>burn roland
You have nothing to burn them with.

Father Alfred begins the ceremony, "We are gathered here today to witness the joining of two hearts." Roland smiles shyly at you.

* * *

This is the day you've always dreamed of. You are finally marrying the love of your life, Prince Roland.

Castle Garden
You are standing in the garden behind your family's castle. On this lovely fall evening, it is doing double duty as a wedding chapel.

Your betrothed, Roland, stands before you.

You can also see Father Alfred here.

>test
>--> The following tests are available:
'test wedding'
'test ruins'
'test burnt'
'test torch'
'test maze'
'test dragon'
'test me'

>test wedding
(Testing.)

>[1] z
You beam happily at Roland.

Father Alfred begins the ceremony, "We are gathered here today to witness the joining of two hearts." Roland smiles shyly at you.

>[2] z
You beam happily at Roland.

"If anyone has a reason why these two should not be wed, speak now or forever hold your peace." You hold your breath for a second, wondering whether anyone will speak up. Fortunately, nobody does and you relax.

>[3] z
You beam happily at Roland.

"Who gives this woman--" You glare icily at the minister. You are nobody's property. "Ahem. Moving on," says the minister, visibly flustered. Roland looks at you questioningly, but says nothing.

>[4] z
You beam happily at Roland.

"Love is a wonderful thing." And so on. You're too excited to pay attention to every word.

>[5] z
You beam happily at Roland.

"Elizabeth, do you take Roland to be your husband?"

>[6] yes
Of course you do!

The minister smiles at you and turns to Roland. "And, Roland, do you take Elizabeth to be your wife?"

Roland grins at you and exclaims, "I do!"

"I now pronounce you man and... dragon?!?" The minister's eyes go wide, seconds before he is incinerated by a burst of flame.

A large dragon flies overhead. The wedding guests scatter in every direction. You cower against Roland, but he pushes you towards the dragon and runs towards the road.

The dragon eats all the guests it can catch, and when it has had its fill, it smashes your castle to smithereens with its heavy tail and sets the remains on fire. You are nearly caught in a blaze of flame as you duck behind what used to be the stone wall of the garden. You are unhurt, but your fine gown snags on a rose bush and tears.

As the dragon finally turns to go, it catches sight of Roland, running down the road towards the river. It swoops down and smashes the bridge just as Roland is about to cross it and catches him up in its claws. The dragon flies away with your beloved prince.

Please press SPACE to continue.

The Paper Bag Princess
An interactive fairy tale by Adri
Release 1 / Serial number 131021 / Inform 7 build 6G60 (I6/v6.32 lib 6/12N) SD

Castle Ruins
This used to be your home. Now it is nothing more than a smoking pile of rubble. The smoke obscures your view of the stars, and the primary source of light is the burning remains of your furniture.

The only road away from the castle now ends abruptly at the river bank. The forest surrounds you thickly on all sides, except for an area to the north where the trees have been broken and scorched.

* * *

This is the day you've always dreamed of. You are finally marrying the love of your life, Prince Roland.

Castle Garden
You are standing in the garden behind your family's castle. On this lovely fall evening, it is doing double duty as a wedding chapel.

Your betrothed, Roland, stands before you.

You can also see Father Alfred here.

>test alternate
(Testing.)

>[1] xyzzy
POOF! Your fairy godmother appears. She smiles at you and places a necklace around your neck. Then she fades out of view.

Father Alfred begins the ceremony, "We are gathered here today to witness the joining of two hearts." Roland smiles shyly at you.

>[2] xyzzy
The necklace suddenly begins to glow.

"If anyone has a reason why these two should not be wed, speak now or forever hold your peace." You hold your breath for a second, wondering whether anyone will speak up. Fortunately, nobody does and you relax.

>[3] z
You beam happily at Roland.

"Who gives this woman--" You glare icily at the minister. You are nobody's property. "Ahem. Moving on," says the minister, visibly flustered. Roland looks at you questioningly, but says nothing.

>[4] z
You beam happily at Roland.

"Love is a wonderful thing." And so on. You're too excited to pay attention to every word.

>[5] z
You beam happily at Roland.

"Elizabeth, do you take Roland to be your husband?"

>[6] yes
Of course you do!

The minister smiles at you and turns to Roland. "And, Roland, do you take Elizabeth to be your wife?"

Roland grins at you and exclaims, "I do!"

"I now pronounce you man and... dragon?!?" The minister's eyes go wide, seconds before he is incinerated by a burst of flame.

A large dragon flies overhead. The wedding guests scatter in every direction. You cower against Roland, but he pushes you towards the dragon and runs towards the road.

The dragon eats all the guests it can catch, and when it has had its fill, it smashes your castle to smithereens with its heavy tail and sets the remains on fire. You are nearly caught in a blaze of flame as you duck behind what used to be the stone wall of the garden. You are unhurt, but your fine gown snags on a rose bush and tears.

As the dragon finally turns to go, it catches sight of Roland, running down the road towards the river. It swoops down and smashes the bridge just as Roland is about to cross it and catches him up in its claws. The dragon flies away with your beloved prince.

Please press SPACE to continue.

The Paper Bag Princess
An interactive fairy tale by Adri
Release 1 / Serial number 131021 / Inform 7 build 6G60 (I6/v6.32 lib 6/12N) SD

Castle Ruins
This used to be your home. Now it is nothing more than a smoking pile of rubble. The smoke obscures your view of the stars, and the primary source of light is the burning remains of your furniture.

The only road away from the castle now ends abruptly at the river bank. The forest surrounds you thickly on all sides, except for an area to the north where the trees have been broken and scorched.

>[7] test ruins
(Testing.)

>[8] search rubble
You dig through the piles of rubble until you find a paper bag.

>[9] take bag
You take the paper bag.

>[10] make dress
You quickly fashion a dress out of the gift bag. It's not as fancy as you're used to, but it'll get the job done.

You strip off the remains of your wedding gown and discard them in a pile of rubble.

You slip the makeshift dress over your head and pull it down past your hips.

>[11] n

Burnt Forest
There's a trail of burned trees and what appear to be teeth leading to the northeast. One tree in particular catches your eye.

>[12] ne

Dimly Lit Forest
You feel as if you are in a giant maze of twisting trees.

>n
Dimly Lit Forest
You feel as if you are in a twisting giant maze of trees.

>ne
The woods seem pretty dark. Maybe you should find a light source.

* * *

>n
Dimly Lit Forest
You feel as if you are in a twisting giant maze of trees.

>n
Dimly Lit Forest
You feel as if you are in a twisty maze of giant trees.

>n
Dimly Lit Forest
You feel as if you are in a twisting maze of giant trees.

>n.n.n.n.n.n.n.n.n.n.n.n.n.n.n.n.n
Dimly Lit Forest
You feel as if you are in a giant maze of twisting trees.

Dimly Lit Forest
You feel as if you are in a twisty giant maze of trees.

Dimly Lit Forest
You feel as if you are in a giant twisty maze of trees.

Dimly Lit Forest
You feel as if you are in a twisting giant maze of trees.

Dimly Lit Forest
You feel as if you are in a giant maze of twisty trees.

Dimly Lit Forest
You feel as if you are in a maze of twisting giant trees.

Dimly Lit Forest
You feel as if you are in a maze of twisty giant trees.

Dimly Lit Forest
You feel as if you are in a maze of giant twisty trees.

Dimly Lit Forest
You feel as if you are in a twisty maze of giant trees.

Dimly Lit Forest
You feel as if you are in a giant maze of twisty trees.

Dimly Lit Forest
You feel as if you are in a maze of giant twisting trees.

Dimly Lit Forest
You feel as if you are in a maze of twisty giant trees.

Dimly Lit Forest
You feel as if you are in a twisty maze of giant trees.

Dimly Lit Forest
You feel as if you are in a maze of twisting giant trees.

Dimly Lit Forest
You feel as if you are in a twisting giant maze of trees.

Dimly Lit Forest
You feel as if you are in a giant maze of twisting trees.

Dimly Lit Forest
You feel as if you are in a twisty maze of giant trees.