The talent show is tonight, and you promised to emcee. But first you need to find your hat.

The Legend of the Missing Hat
A tiny adventure by Adri
Release 1 / Serial number 140106 / Inform 7 build 6G60 (I6/v6.32 lib 6/12N) SD

Under the Bed
This is where you live. The rest of the room is south, and there's a particularly dusty looking corner to the east.

>hint
That's not a verb I recognize.

>about
The "about" blurb and credits will go here!

* * *

>n
Bed Room
This is the studio apartment you and your ninja friends live in.

>quitr
[ The game has finished ]

* * *

The talent show is tonight, and you promised to emcee. But first you need to find your hat.

The Legend of the Missing Hat
A tiny adventure by Adri
Release 1 / Serial number 140106 / Inform 7 build 6G60 (I6/v6.32 lib 6/12N) SD

Under the Bed
This is where you live. The rest of the room is south, and there's a particularly dusty looking corner to the east.

>s
Bedroom
This is the dormitory room you share with your three closest friends. There is a bed to the north, a wardrobe to the east, a bookshelf to the south, a food storage area to the west and a desk in the northwest corner.

>ne
Far Corner of the Bed
This corner doesn't seem to get cleaned often. There is a rather large spider web stretched between the foot of the bed and the wall. Thankfully its inhabitant is nowhere to be found. The rest of the room is southwest.

>x web
It's a spider web. There's something glinting on it.

>take glint
It's stuck.

>take pearl
You can't see any such thing.

>damage web
You don't want to touch that with your bare hands.

>throw shuriken at web
You don't want to touch that with your bare hands.

* * *

>ne
Far Corner of the Bed
This corner doesn't seem to get cleaned often. There is a rather large spider web stretched between the foot of the bed and the wall. Thankfully its inhabitant is nowhere to be found. The rest of the room is southwest.

>sw
Center Room
This is the dormitory room you share with your three closest friends. There is a bed to the north, a wardrobe to the east, a bookshelf to the south, a food storage area to the west and a desk to the northwest. The door to the hallway is southwest.

>nw
You scurry across the room, keeping close to the walls.

Below the Desk
This is the desk area.

>tie shuriken to yarn
You tie the yarn to the shuriken, creating a grappling hook.

>throw hook at ledge
You throw the grappling hook at the desk. It catches in the wood.

You can't reach that. Maybe there's another way.

>l
Below the Desk
This is the desk area.

* * *

>ne
Far Corner of the Bed
This corner doesn't seem to get cleaned often. There is a rather large spider web stretched between the foot of the bed and the wall. Thankfully its inhabitant is nowhere to be found. The rest of the room is southwest.

>w
Under the Bed
This is where you live. The rest of the room is south, and there's a particularly dusty looking corner to the east.

>s
Bedroom
This is the dormitory room you share with your three closest friends. There is a bed to the north, a wardrobe to the east, a bookshelf to the south, a food storage area to the west and a desk to the northwest. The door to the hallway is southwest.

>nw
Below the Desk
You can see sunlight above you. The rest of the room is southeast.

>x sunlight
There's a window somewhere over the desk.

>x window
There's a window somewhere over the desk.

* * *

>s
Bedroom
This is the dormitory room you share with your three closest friends. There is a bed to the north, a wardrobe to the east, a bookshelf to the south, a food storage area to the west and a desk in the northwest corner.

>e
You knock on the door of the wardrobe, and the blue ninja peeks his head out. 

Outside the Wardrobe
The rest of the room is west.

The tiny blue ninja stands in the doorway. He doesn't seem eager to invite you inside.

>enter warddrobe
Center Room
This is the dormitory room you share with your three closest friends. There is a bed to the north, a wardrobe to the east, a bookshelf to the south, a food storage area to the west and a desk to the northwest. The door to the hallway is southwest.

>enter warddrobe
You scurry across the room, keeping close to the walls.

You knock on the wardrobe. The blue ninja peeks his head out. He does not invite you inside.

Outside the Wardrobe
This is the blue ninja's home. You are standing outside the wardrobe.The rest of the room is west.

The blue ninja is here. He looks sad.

>enter wardrobe
Center Room
This is the dormitory room you share with your three closest friends. There is a bed to the north, a wardrobe to the east, a bookshelf to the south, a food storage area to the west and a desk to the northwest. The door to the hallway is southwest.

* * *

>e
You knock on the door of the wardrobe, and the blue ninja peeks his head out. 

Outside the Wardrobe
The rest of the room is west.

The tiny blue ninja stands in the doorway. He doesn't seem eager to invite you inside.

>enter wardrobe
You can't go that way.

>g
You can't go that way.

>g
You can't go that way.

>w
Center Room
This is the dormitory room you share with your three closest friends. There is a bed to the north, a wardrobe to the east, a bookshelf to the south, a food storage area to the west and a desk to the northwest. The door to the hallway is southwest.

>enter wardrobe
You scurry across the room, keeping close to the walls.

You knock on the wardrobe. The blue ninja peeks his head out. He does not invite you inside.

Outside the Wardrobe
This is the blue ninja's home. You are standing outside the wardrobe.The rest of the room is west.

The blue ninja is here. He looks sad.

>exit warddrobe
I only understood you as far as wanting to exit.

* * *

>e
You knock on the door of the wardrobe, and the blue ninja peeks his head out. 

Outside the Wardrobe
The rest of the room is west.

The tiny blue ninja stands in the doorway. He doesn't seem eager to invite you inside.

>e
You can't go that way.

>e
You can't go that way.

>w
Center Room
This is the dormitory room you share with your three closest friends. There is a bed to the north, a wardrobe to the east, a bookshelf to the south, a food storage area to the west and a desk to the northwest. The door to the hallway is southwest.

>w
You scurry across the room, keeping close to the walls.

Behind the Mini Fridge
This is the red ninja's home. The rest of the room is east.

The red ninja is here. He looks angry.

>e
Center Room
This is the dormitory room you share with your three closest friends. There is a bed to the north, a wardrobe to the east, a bookshelf to the south, a food storage area to the west and a desk to the northwest. The door to the hallway is southwest.

>w
You scurry across the room, keeping close to the walls.

Behind the Mini Fridge
This is the red ninja's home. The rest of the room is east.

The red ninja is here. He looks angry.

* * *

>e
Center Room
This is the dormitory room you share with your three closest friends. There is a bed to the north, a wardrobe to the east, a bookshelf to the south, a food storage area to the west and a desk to the northwest. The door to the hallway is southwest.

>enter fridge
You can't go that way.

>open fridge
You're unable to get the door open without help.

* * *

>e
You knock on the door of the wardrobe, and the blue ninja peeks his head out. 

Outside the Wardrobe
The rest of the room is west.

The tiny blue ninja stands in the doorway. He doesn't seem eager to invite you inside.

>exit wardrobe
I only understood you as far as wanting to exit.

* * *

>e
You knock on the door of the wardrobe, and the blue ninja peeks his head out. 

Outside the Wardrobe
The rest of the room is west.

The tiny blue ninja stands in the doorway. He doesn't seem eager to invite you inside.

>give bouquet to ninja
You can't see any such thing.

>i
You are carrying:
  your shuriken

* * *

>give bouquet to ninja
The blue ninja stares at you for a moment. Finally he accepts the bouquet, and smells the flowers, inhaling deeply. He looks at you, smiling. "Thank you. That is very sweet of you. Let me go find your hat. Would you like to come in?" He invites you inside the wardrobe while he digs around in piles of stuff. "Here is your hat. And would you like this bow tie as well?" He hands both items to you.

[Your score has just gone up by twenty-five points.]

>wear bow tie
You wear the bow tie!

>wear hat
You wear the hat!

End game. Yay!

    *** You are jaunty and stylish! ***

In that game you scored 50 out of a possible 100, in 7 turns.

Would you like to RESTART, RESTORE a saved game, QUIT, or UNDO the last command?

* * *

>e
You knock on the door of the wardrobe, and the blue ninja peeks his head out. 

Outside the Wardrobe
The rest of the room is west.

The tiny blue ninja stands in the doorway. He doesn't seem eager to invite you inside.

>w
Bedroom
This is the dormitory room you share with your three closest friends. There is a bed to the north, a wardrobe to the east, a bookshelf to the south, a food storage area to the west and a desk to the northwest. The door to the hallway is southwest.

>se
You scurry across the room, keeping close to the walls.

Inside the Mousehole
This appears to be the home of a mouse. The rest of the room is back to the northwest.

There is a mouse here, lazing around in its nest.

* * *

>w
Bedroom
This is the dormitory room you share with your three closest friends. There is a bed to the north, a wardrobe to the east, a bookshelf to the south, a food storage area to the west and a desk to the northwest. The door to the hallway is southwest.

>w
You scurry across the room, keeping close to the walls.

Behind the Mini Fridge
This is the red ninja's home. The rest of the room is east.

The red ninja is here, nibbling anxiously on a cookie. He seems angry.

>talk to red
You say hello to the red ninja.

* * *

>e
You knock on the door of the wardrobe, and the blue ninja peeks his head out. 

Outside the Wardrobe
The rest of the room is west.

The tiny blue ninja stands in the doorway. He doesn't seem eager to invite you inside.

>ask ninja about hat
The blue ninja frowns. "I think it's somewhere in this mess. I don't feel like looking for it right now."

>w
Bedroom
This is the dormitory room you share with your three closest friends. There is a bed to the north, a wardrobe to the east, a bookshelf to the south, a food storage area to the west and a desk to the northwest. The door to the hallway is southwest.

>s
On the Bookshelf
The rest of the room is north.

The green ninja is pacing back and forth.

>ask ninja about hat
The green ninja thinks for a moment. He says, "I think the blue ninja borrowed it for his Halloween costume."

>n
Bedroom
This is the dormitory room you share with your three closest friends. There is a bed to the north, a wardrobe to the east, a bookshelf to the south, a food storage area to the west and a desk to the northwest. The door to the hallway is southwest.

>w
Behind the Mini Fridge
The rest of the room is east.

The red ninja is here, nibbling anxiously on a cookie. He seems angry.

>ask ninja about hat
The red ninja shrugs. "I haven't seen it. Maybe you lent it to someone?"

* * *

>e
You knock on the door of the wardrobe, and the blue ninja peeks his head out. 

Outside the Wardrobe
The rest of the room is west.

The tiny blue ninja stands in the doorway. He doesn't seem eager to invite you inside.

>show hat to ninja
You can't see any such thing.

>tell ninja about hat
The blue ninja frowns. "I think it's somewhere in this mess. I don't feel like looking for it right now."

* * *

>i
You are carrying:
  a hat
  your shuriken

>tell ninja about hat
The blue ninja frowns. "I think it's somewhere in this mess. I don't feel like looking for it right now."

* * *

>show shuriken to ninja
The blue ninja just looks at you blankly and makes no move to take the shuriken from you.

* * *

>e
You knock on the door of the wardrobe, and the blue ninja peeks his head out. 

Outside the Wardrobe
The rest of the room is west.

The tiny blue ninja stands in the doorway. He doesn't seem eager to invite you inside.

>kiss ninja
No.

>w
Bedroom
This is the dormitory room you share with your three closest friends. There is a bed to the north, a wardrobe to the east, a bookshelf to the south, a food storage area to the west and a desk to the northwest. The door to the hallway is southwest.

>ne
Far Corner of the Bed
This corner doesn't seem to get cleaned often. There is a rather large spider web stretched between the foot of the bed and the wall. Thankfully its inhabitant is nowhere to be found. The rest of the room is southwest.

>x glint
It's a pearl earring in a silver setting. It's about the size of your head.

>throw shuriken at glint
You throw the shuriken at the web, slicing easily through the sticky material. The pearl drops to the ground.

>take pearl
As you stoop to pick up the pearl, the spider sneaks in and fixes her web. Taken.

>sw
You pause to retrieve your shuriken. Taken.

Bedroom
This is the dormitory room you share with your three closest friends. There is a bed to the north, a wardrobe to the east, a bookshelf to the south, a food storage area to the west and a desk to the northwest. The door to the hallway is southwest.

>s
On the Bookshelf
The rest of the room is north.

The tiny green ninja is pacing back and forth.

>hug ninja
No.

>give pearl to ninja
The green ninja oohs and ahhs over the pearl. He gives you a notebook.  "Here. I don't need this anymore. It's just cheap junk."

[Your score has just gone up by twenty-five points.]

>hug ninja
Yes.

* * *

>e
You knock on the door of the wardrobe, and the blue ninja peeks his head out. 

Outside the Wardrobe
The rest of the room is west.

The tiny blue ninja stands in the doorway. He doesn't seem eager to invite you inside.

>hug ninja
You try to hug the blue ninja, but he pushes you away.

>kiss ninja
Keep your mind on the game.

* * *

>e
You knock on the door of the wardrobe, and the blue ninja peeks his head out. 

Outside the Wardrobe
The rest of the room is west.

The tiny blue ninja stands in the doorway. He doesn't seem eager to invite you inside.

>ask ninja about sadness
The blue ninja shrugs.

* * *

>s
Bedroom
This is the dormitory room you share with your three closest friends. There is a bed to the north, a wardrobe to the east, a bookshelf to the south, a food storage area to the west and a desk in the northwest corner.

>sw
The door is closed.

>open door
There's no way you can open that door. And you need to find your hat before you can go anywhere.

>w
You scurry across the room, keeping close to the walls.

Behind the Mini Fridge
This is the red ninja's home. The rest of the room is east.

The red ninja is here. He looks angry.

* * *

>e
Center Room
This is the dormitory room you share with your three closest friends. There is a bed to the north, a wardrobe to the east, a bookshelf to the south, a food storage area to the west and a desk to the northwest. The door to the hallway is southwest.

>open fridge
You're unable to get the door open without help.

>enter fridge
The door is closed.

>enter sw
You must name something more substantial.

>e
You scurry across the room, keeping close to the walls.

You knock on the wardrobe. The blue ninja peeks his head out. He does not invite you inside.

Outside the Wardrobe
This is the blue ninja's home. You are standing outside the wardrobe.The rest of the room is west.

The blue ninja is here. He looks sad.

>enter sw
You must name something more substantial.

>enter hallway
You can't see any such thing.

>enter shuriken
That's not something you can enter.

>e
You can't go that way.

>nw
You can't go that way.

>e
You can't go that way.

* * *

>w
Center Room
This is the dormitory room you share with your three closest friends. There is a bed to the north, a wardrobe to the east, a bookshelf to the south, a food storage area to the west and a desk to the northwest. The door to the hallway is southwest.

>nw
You scurry across the room, keeping close to the walls.

Below the Desk
This is the desk area.

>enter desk
Center Room
This is the dormitory room you share with your three closest friends. There is a bed to the north, a wardrobe to the east, a bookshelf to the south, a food storage area to the west and a desk to the northwest. The door to the hallway is southwest.

* * *

>sw
The door is closed.

>se
You scurry across the room, keeping close to the walls.

Inside the Mousehole
This is where the creature lives. The rest of the room is back to the northwest.

A mouse is here!

>x mouse
The mouse looks unfriendly.

>x nest
You see nothing special about the nest.

* * *

>sw
The door is closed.

>x door
There is a door here, leading out to the hallway.

>se
Inside the Mousehole
The rest of the room is back to the northwest.

There is a mouse here, lazing around in its nest.

>x nest
This is the mouse's nest. It is full of various treasures.

>x treasures
It's a collection of things the mouse has found. Maybe you could try searching?

* * *

>s
Bedroom
This is the dormitory room you share with your three closest friends. There is a bed to the north, a wardrobe to the east, a bookshelf to the south, a food storage area to the west and a desk in the northwest corner.

>nw
You scurry across the room, keeping close to the walls.

Below the Desk
This is the desk area.

>enter desk
That's not something you can enter.

>climb desk
I don't think much is to be achieved by that.

>exit desk
I only understood you as far as wanting to exit.

>e
You can't go that way.

* * *

>nw
You scurry across the room, keeping close to the walls.

Below the Desk
This is the desk area.

>climb desk
Nope!

>enter ledge
That's not something you can enter.

* * *

>nw
You scurry across the room, keeping close to the walls.

Below the Desk
This is the desk area.

>throw shuriken at desk
You won't be able to retrieve that. Maybe if you tied something to it?

>throw shuriken at wall
You can't see any such thing.

>throw shuriken at ledge
Not quite.

>e
You can't go that way.

>se
Center Room
This is the dormitory room you share with your three closest friends. There is a bed to the north, a wardrobe to the east, a bookshelf to the south, a food storage area to the west and a desk to the northwest. The door to the hallway is southwest.

>ne
You scurry across the room, keeping close to the walls.

Far Corner of the Bed
This corner doesn't seem to get cleaned often. There is a rather large spider web stretched between the foot of the bed and the wall. Thankfully its inhabitant is nowhere to be found.

>throw shuriken at glint
It's not nice to throw things.

>throw shuriken at pearl
You can't see any such thing.

I beg your pardon?

>throw shuriken at web
You throw the shuriken at the web, slicing easily through the sticky material. The pearl drops to the ground.

>x pearl
It's a pearl earring in a silver setting.

>take pearl
As you stoop to pick up the pearl, the spider sneaks in and fixes her web. Taken.

>take pearl
You already have that.

>x glint
It's a pearl earring in a silver setting.

>throw shuriken at web
(first taking the shuriken)
You throw the shuriken at the web, slicing easily through the sticky material. The pearl drops to the ground.

* * *

>throw shuriken at desk
You won't be able to retrieve that. Maybe if you tied something to it?

>l
Below the Desk
This is the desk area.

>tie shuriken to yarn
You tie the yarn to the shuriken, creating a grappling hook.

>throw hook at ledge
You throw the grappling hook at the     desk. It catches in the wood.

You climb up the length of yarn.

On the Desk
This is the windowsill. There is a pot here containing tiny purple flowers.

You can see a grappling hook here.

* * *

>nw
You scurry across the room, keeping close to the walls.

Below the Desk
This is the desk area.

>throw shuriken at ledge
You won't be able to retrieve that. Maybe if you tied something to it?

>tie yarn to shuriken
You tie the yarn to the shuriken, creating a grappling hook.

>throw shuriken at ledge
You throw the grappling hook at the desk. It catches in the wood.

>l
Below the Desk
This is the desk area.

* * *

>nw
You scurry across the room, keeping close to the walls.

Below the Desk
This is the desk area.

>tie yarn to shuriken
You tie the yarn to the shuriken, creating a grappling hook.

>throw shuriken at ledge
You throw the grappling hook at the desk. It catches in the wood.

You climb up the length of yarn.

On the Desk
This is the windowsill. There is a pot here containing tiny purple flowers.

You can see a grappling hook here.

>down
You slide down the length of yarn. You give the yarn a good yank and the grappling hook returns to you.

Below the Desk
This is the desk area.

>l
Below the Desk
This is the desk area.

* * *

>tie shuriken to yarn
You tie the yarn to the shuriken, creating a grappling hook.

>throw shuriken at ledge
You throw the grappling hook at the desk. It catches in the wood.

* * *

>l
Below the Desk
This is the desk area.

>up
You climb up the length of yarn.

On the Desk
This is the windowsill. There is a pot here containing tiny purple flowers.

You can see a grappling hook here.

>down
You slide down the length of yarn. You give the yarn a good yank and the grappling hook returns to you.

Below the Desk
This is the desk area.

* * *

>nw
You scurry across the room, keeping close to the walls.

Below the Desk
This is the desk area.

>make grappling hook
That isn't available.

* * *

>s
Bedroom
This is the dormitory room you share with your three closest friends. There is a bed to the north, a wardrobe to the east, a bookshelf to the south, a food storage area to the west and a desk in the northwest corner.

>climb desk
I don't think much is to be achieved by that.

>nw
You scurry across the room, keeping close to the walls.

Below the Desk
This is the desk area.

>climb desk
I don't think much is to be achieved by that.

>up
Nope!

* * *

>s
Bedroom
This is the dormitory room you share with your three closest friends. There is a bed to the north, a wardrobe to the east, a bookshelf to the south, a food storage area to the west and a desk in the northwest corner.

>se
Inside the Mouse Hole
The rest of the room is back to the northwest.

There is a mouse here, lazing around in its nest.

>search
(the shuriken)
You find nothing of interest.

* * *

>se
Inside the Mouse Hole
The rest of the room is back to the northwest.

There is a mouse here, lazing around in its nest.

>x mouse
It's a common brown mouse. It's about twice as tall as you are.

>x nest
This is the mouse's nest. It is full of various treasures.

>search nest
You find a length of yarn. Taken.

* * *

>x mouse
It's a common brown mouse. It's about twice as tall as you are.

>x mouse
The mouse seems harmless enough.

>pet mouse
I only understood you as far as wanting to pet.

>touch mouse
You give the mouse a friendly pat. It bruxes softly.

* * *

>x mouse
It's a common brown mouse. It's about twice as tall as you are.

>i
You are carrying:
  a cookie
  your shuriken

>give cookie to mouse
The mouse snaps at you.

* * *

>i
You are carrying:
  a cookie
  your shuriken

>eat cookie
You eat the cookie. Not bad.

* * *

>x mouse
It's a common brown mouse. It's about twice as tall as you are.

>give shuriken to mouse
The mouse snaps at you.

>give cookie to mouse
The mouse snaps at you.

* * *

>give shuriken to mouse
The mouse snaps at you.

>touch mouse
The mouse snaps at you.

* * *

>give shuriken to mouse
The mouse snaps at you.

>attack mouse
Violence isn't the answer to this one.

>talk to mouse
You are already talking to the mouse.

>ask mouse about cookie
The mouse squeaks at you.

* * *

>give shuriken to mouse
The mouse snaps at you.

>x nest
This is the mouse's nest. It is full of various treasures.

* * *

>x mouse
It's a common brown mouse. It's about twice as tall as you are.

>talk to mouse
The mouse snaps at you.

>hit mouse
The mouse snaps at you.

* * *

>x mouse
It's a common brown mouse. It's about twice as tall as you are.

>show shuriken to mouse
The mouse snaps at you.

>give shuriken to mouse
The mouse snaps at you.

* * *

>x mouse
It's a common brown mouse. It's about twice as tall as you are.

>pet mouse
The mouse snaps at you.

>give shuriken to mouse
The mouse snaps at you.

* * *

>pet mouse
The mouse snaps at you.

>show shuriken to mouse
The mouse snaps at you.

* * *

>give cookie to mouse
You give the cookie to the mouse. It nibbles happily.

>l
Inside the Mousehole
The rest of the room is back to the northwest.

There is a mouse here, lazing around in its nest.The mouse nibbles loudly on a cookie.

* * *

>se
Inside the Mouse Hole
The rest of the room is back to the northwest.

There is a mouse here, lazing around in its nest.

>search nest
The mouse hisses at you. Maybe you can distract it somehow?

>search nest
The mouse hisses at you. Maybe you can distract it somehow?

>take nest
There's no way you could lift that. Nor do you have any reason to.

>take mouse
I don't suppose the mouse would care for that.

>hug mouse
Keep your mind on the game.

>hit mouse
Violence isn't the answer to this one.

>kiss mouse
Keep your mind on the game.

* * *

>se
Inside the Mouse Hole
The rest of the room is back to the northwest.

There is a mouse here, lazing around in its nest.

>talk to mouse
The mouse snaps at you.

>x mouse
The mouse does not seem friendly.

>take mouse
The mouse snaps at you.

>search nest
The mouse hisses at you. Maybe you can distract it somehow?

* * *

>x mouse
The mouse does not seem friendly.

>talk to mouse
You say hello to the mouse.

>ask mouse about life
The mouse squeaks at you.

* * *

>talk to mouse
The mouse snaps at you.

>ask mouse about life
The mouse snaps at you.

* * *

>se
Inside the Mouse Hole
The rest of the room is back to the northwest.

There is a mouse here, lazing around in its nest.

>pet mouse
The mouse snaps at you.

>x mouse
The mouse does not seem friendly.

>pet mouse
You give the mouse a friendly pat. It bruxes softly.

* * *

>se
Inside the Mouse Hole
The rest of the room is back to the northwest.

There is a mouse here, lazing around in its nest.

>i
You are carrying:
  your shuriken

>give shuriken to mouse
The mouse snaps at you.

>x mouse
The mouse does not seem friendly.

>give shuriken to mouse
The mouse snaps at you.

>give cookie to mouse
You can't see any such thing.

>i
You are carrying:
  your shuriken

* * *

>se
Inside the Mouse Hole
The rest of the room is back to the northwest.

There is a mouse here, lazing around in its nest.

>give shuriken to mouse
The mouse sniffs curiously at the shuriken, but doesn't seem to want it.

>give mouse
(the shuriken)
The mouse sniffs curiously at shuriken, but doesn't seem to want it.

>take mouse
I don't suppose the mouse would care for that.

* * *

>give shuriken to mouse
The mouse sniffs curiously at the shuriken, but doesn't seem to want it.

>x mouse
The mouse does not seem friendly.

* * *

>take mouse
The mouse snaps at you.

>talk to mouse
The mouse snaps at you.

* * *

>give shuriken to mouse
The mouse sniffs curiously at the shuriken, but doesn't seem to want it.

>show shuriken to mouse
The mouse sniffs curiously at shuriken, but doesn't seem to want it.

>ne
You can't go that way.

>s
You can't go that way.

>nw
Center Room
This is the dormitory room you share with your three closest friends. There is a bed to the north, a wardrobe to the east, a bookshelf to the south, a food storage area to the west and a desk to the northwest. The door to the hallway is southwest.

>s
You scurry across the room, keeping close to the walls.

On the Bookshelf
This is the green ninja's home. The rest of the room  is north.

The green ninja is pacing back and forth.

>give shuriken
(to the green ninja)
The green ninja turns the shuriken over in his hands. He hands it back to you, shaking his head.

>show shuriken
(to the green ninja)
The green ninja doesn't seem interested in that.

* * *

>se
Inside the Mouse Hole
The rest of the room is back to the northwest.

There is a mouse here, lazing around in its nest.

>x creature
The mouse does not seem friendly.

>give shuriken to creature
The mouse snaps at you.

* * *

>se
Inside the Mouse Hole
The rest of the room is back to the northwest.

There is a mouse here, lazing around in its nest.

>show shuriken to mouse
The mouse snaps at you.

>x mouse
The mouse snaps at you.

* * *

>show shuriken to mouse
The mouse snaps at you.

>i
You are carrying:
  your shuriken

>x shuriken
It's a four-pointed throwing star.

>x mouse
It's a common brown mouse.

>pet mouse
The mouse snaps at you.

* * *

>se
Inside the Mouse Hole
The rest of the room is back to the northwest.

There is a mouse here, lazing around in its nest.

>take mouse
I don't suppose the mouse would care for that.

* * *

>se
Inside the Mouse Hole
The rest of the room is back to the northwest.

There is a mouse here, lazing around in its nest.

>x nest
This is the mouse's nest. It is full of various treasures.

* * *

>x treasures
It's a collection of things the mouse has found. Maybe you could try searching?

>search treasures
You find nothing of interest.

* * *

>x treasures
It's a collection of things the mouse has found. Maybe you could try searching?

>search nest
The mouse hisses at you. Maybe you can distract it somehow?

* * *

>se
Inside the Mouse Hole
The rest of the room is back to the northwest.

There is a mouse here, lazing around in its nest.

>search treasures
The mouse hisses at you. Maybe you can distract it somehow?

* * *

>se
Inside the Mouse Hole
The rest of the room is back to the northwest.

There is a mouse here, lazing around in its nest.

>give cookie to mouse
You can't see any such thing.

* * *

>give cookie to mouse
You give the cookie to the mouse. It nibbles happily.

>l
Inside the Mousehole
The rest of the room is back to the northwest.

There is a mouse here, lazing around in its nest. The mouse nibbles loudly on a cookie.

* * *

>give cookie to mouse
You give the cookie to the mouse. It nibbles happily.

>l
Inside the Mousehole
The rest of the room is back to the northwest.

There is a mouse here, nibbling on a cookie. Its nest is a short distance away, no longer guarded.

* * *

>se
Inside the Mouse Hole
The rest of the room is back to the northwest.

There is a mouse here, lazing around in its nest.

>cheat. give cookie to mouse.l
You give the cookie to the mouse. It nibbles happily.

Inside the Mousehole
The rest of the room is back to the northwest.

There is a nest here. Its owner is a short distance away, distracted by a cookie.

* * *

>se
Inside the Mouse Hole
The rest of the room is back to the northwest.

There is a mouse here, lazing around in its nest.

>nw
Bedroom
This is the dormitory room you share with your three closest friends. There is a bed to the north, a wardrobe to the east, a bookshelf to the south, a food storage area to the west and a desk in the northwest corner. There is a mouse hole in the southeast corner of the room, next to the bookshelf.

>sw
The door is closed.

>open door
There's no way you can open that door by yourself. And you need to find your hat before you can go anywhere.

* * *

>open door
You should get dressed before you go anywhere.

>wear hat
You put on the hat.

>open door
You should get dressed before you go anywhere.

>remove hat.wear tie.open door
You take off the hat.

You wear the bowtie. It's just a clip-on, but maybe no one will notice.

You should get dressed before you go anywhere.

>wear hat
You put on the hat.

You've found your hat and you have an awesome new bow tie. You are ready to go to the talent show.

    *** You are jaunty and stylish! ***

In that game you scored 25 out of a possible 100, in 13 turns.

Would you like to RESTART, RESTORE a saved game, QUIT, or UNDO the last command?

Please give one of the answers above.

Would you like to RESTART, RESTORE a saved game, QUIT, or UNDO the last command?

>restrat
Please give one of the answers above.

Would you like to RESTART, RESTORE a saved game, QUIT, or UNDO the last command?

>restart
The talent show is tonight, and you promised to emcee. But first you need to find your hat.

Ninjas!
A tiny adventure by Adri
Release 1 / Serial number 120606 / Inform 7 build 6G60 (I6/v6.32 lib 6/12N) SD

Under the Bed
This is where you live. The rest of the room is south, and there's a particularly dusty looking corner to the east.

>sing.jump.wave
Your singing is abominable.

You jump on the spot, fruitlessly.

You wave, feeling foolish.

* * *

>s
Bedroom
This is the dormitory room you share with your three closest friends. There is a bed to the north, a wardrobe to the east, a bookshelf to the south, a food storage area to the west and a desk in the northwest corner.

>s
As you approach the bookshelf, you notice a mouse hole to the left of it, in the southeast corner of the room.

On the Bookshelf
The rest of the room is north.

The tiny green ninja is pacing back and forth.

>n
Center Room
This is the dormitory room you share with your three closest friends. There is a bed to the north, a wardrobe to the east, a bookshelf to the south, a food storage area to the west and a desk to the northwest. The door to the hallway is southwest.

>e
You scurry across the room, keeping close to the walls.

You knock on the wardrobe. The blue ninja peeks his head out. He does not invite you inside.

Outside the Wardrobe
This is the blue ninja's home. You are standing outside the wardrobe.The rest of the room is west.

The blue ninja stands in the doorway. He doesn't seem eager to invite you inside.

* * *

>talk to ninja
The green ninja quietly sulks.

>ask ninja about pearl
The green ninja quietly sulks.

* * *

>s
As you approach the bookshelf, you notice a mouse hole to the left of it, in the southeast corner of the room.

On the Bookshelf
The rest of the room is north.

The tiny green ninja is pacing back and forth.

>talk to ninja
The green ninja sulks. "My friend just got this really sparkly rock. It's so pretty. I don't have anything that nice. The prettiest thing I have is this stupid notebook."

>talk to ninja
You are already talking to the green ninja.

>hello ninja
I only understood you as far as wanting to hello.

* * *

>talk to ninja
The green ninja sulks. "My friend just got this really sparkly rock. It's so pretty. I don't have anything that nice. The prettiest thing I have is this stupid notebook."

>ask ninja about himself
Try asking the green ninja about himself.

>ask ninja about life
Try asking the green ninja about himself.

* * *

>talk to ninja
The green ninja sulks. "My friend just got this really sparkly rock. It's so pretty. I don't have anything that nice. The prettiest thing I have is this stupid notebook."

>ask ninja about ninja
The green ninja quietly sulks.

>give pearl to ninja
You can't see any such thing.

* * *

>give pearl to ninja
The green ninja oohs and ahhs over the pearl. He gives you a notebook.  "Here. I don't need this anymore."

[Your score has just gone up by twenty-five points.]

>ask ninja about ninja
The green ninja says, "Thanks again!"

>ninja, hello
You are already talking to the green ninja.

>ask ninja about shuriken
The green ninja shakes his head.

>show shuriken to ninja
The green ninja doesn't seem interested in that.

* * *

>talk to ninja
The green ninja sulks. "My friend just got this really sparkly rock. It's so pretty. I don't have anything that nice. The prettiest thing I have is this stupid notebook."

>ask ninja about notebook
The green ninja glares at you. "It's the prettiest thing I own. I'm not giving it away."

>ask ninja about necklace
The green ninja pouts. "It's so pretty. I wish I had one."

* * *

>talk to ninja
The green ninja sulks. "My friend just got this really sparkly rock. It's so pretty. I don't have anything that nice. The prettiest thing I have is this stupid notebook."

>x notebook
It's a matchbook-sized notebook. The cover is studded with colorful rhinestones. It's blank inside.

>read notebook
It's a matchbook-sized notebook. The cover is studded with colorful rhinestones. It's blank inside.

>x rhinestones
It's a matchbook-sized notebook. The cover is studded with colorful rhinestones. It's blank inside.

* * *

>s
As you approach the bookshelf, you notice a mouse hole to the left of it, in the southeast corner of the room.

On the Bookshelf
The rest of the room is north.

The tiny green ninja is pacing back and forth.

>talk to green
*** Run-time problem P7: Too many rulebooks in simultaneous use.

* * *

>s
As you approach the bookshelf, you notice a mouse hole to the left of it, in the southeast corner of the room.

On the Bookshelf
The rest of the room is north.

The tiny green ninja is pacing back and forth.

>ask ninja
(for the hat)
The green ninja thinks for a moment. He says, "I think the blue ninja borrowed it for his Halloween costume."

>tell ninja
(about the hat)
The green ninja thinks for a moment. He says, "I think the blue ninja borrowed it for his Halloween costume."

* * *

>s
As you approach the bookshelf, you notice a mouse hole to the left of it, in the southeast corner of the room.

On the Bookshelf
The rest of the room is north.

The tiny green ninja is pacing back and forth.

>ask ninja about mood
The green ninja sulks. "My friend just got this really sparkly rock. It's so pretty. I don't have anything that nice. The prettiest thing I have is this stupid notebook."

>talk to ninja
The green ninja sulks. "My friend just got this really sparkly rock. It's so pretty. I don't have anything that nice. The prettiest thing I have is this stupid notebook."

* * *

>ask ninja about mood
The green ninja sulks. "My friend just got this really sparkly rock. It's so pretty. I don't have anything that nice. The prettiest thing I have is this stupid notebook."

>n
Bedroom
This is the dormitory room you share with your three closest friends. There is a bed to the north, a wardrobe to the east, a bookshelf to the south, a food storage area to the west and a desk in the northwest corner

>n
Under the Bed
This is where you live. The rest of the room is south, and there's a particularly dusty looking corner to the east.

I beg your pardon?

>e
Far Corner of the Bed
This corner doesn't seem to get cleaned often. There is a rather large spider web stretched between the foot of the bed and the wall. Thankfully its inhabitant is nowhere to be found. The rest of the room is southwest.

>throw star
Maybe you should try throwing it at something.

* * *

>s
As you approach the bookshelf, you notice a mouse hole to the left of it, in the southeast corner of the room.

On the Bookshelf
The rest of the room is north.

The tiny green ninja is pacing back and forth.

>x mouse hole
The mouse hole is next to to bookshelf. You can't see it from here.

>n
Bedroom
This is the dormitory room you share with your three closest friends. There is a bed to the north, a wardrobe to the east, a bookshelf to the south, a food storage area to the west and a desk in the northwest corner

>x book shelf
The bookshelf is piled high with books and knicknacks. The green ninja lives on the bottom shelf, behind a row of textbooks. You can see a mouse hole to the left of the bookshelf.

>x mouse hole
There is a mouse hole in the southeast corner of the room. You can't see inside from here.

>se
Inside the Mouse Hole
The rest of the room is back to the northwest.

There is a mouse here, lazing around in its nest.

* * *

>s
As you approach the bookshelf, you notice a mouse hole to the left of it, in the southeast corner of the room.

On the Bookshelf
The rest of the room is north.

The tiny green ninja is pacing back and forth.

>d
You can't go that way.

>up
You can't go that way.

>out
But you aren't in anything at the moment.

>look w
You see nothing unexpected in that direction.

* * *

>s
Bedroom
This is the dormitory room you share with your three closest friends. There is a bed to the north, a wardrobe to the east, a bookshelf to the south, a food storage area to the west and a desk in the northwest corner.

>w
Behind the Mini Fridge
The rest of the room is east.

The tiny red ninja is here, nibbling anxiously on a cookie. He seems angry.

>talk to ninja
The red ninja grumbles. He says, "Leave me alone. I hate everyone."

>ask ninja about cookie
I don't know about that.

* * *

>talk to ninja
The red ninja grumbles. He says, "Leave me alone. I hate everyone."

>talk
(to the red ninja)
The red ninja grumbles. He says, "Leave me alone. I hate everyone."

>ninja, hello
You are already talking to the red ninja.

>e
Bedroom
This is the dormitory room you share with your three closest friends. There is a bed to the north, a wardrobe to the east, a bookshelf to the south, a food storage area to the west and a desk to the northwest. The door to the hallway is southwest.

>talk
(to yourself)
You does not respond.

* * *

>w
Behind the Mini Fridge
The rest of the room is east.

The tiny red ninja is here, nibbling anxiously on a cookie. He seems angry.

>talk to red ninja
*** Run-time problem P7: Too many rulebooks in simultaneous use.

>ask red ninja about himself
*** Run-time problem P7: Too many rulebooks in simultaneous use.

>ask red ninja about himself
*** Run-time problem P7: Too many rulebooks in simultaneous use.

>ask red ninja about red ninja
*** Run-time problem P7: Too many rulebooks in simultaneous use.

* * *

>w
Behind the Mini Fridge
The rest of the room is east.

The tiny red ninja is here, nibbling anxiously on a cookie. He seems angry.

>ask ninja about himslf
The red ninja shakes his head.

>ask ninja about himself
The red ninja grumbles. He says, "Leave me alone. I hate everyone."

>talk to ninja
You are already talking to the red ninja.

>ask ninja about hat
The red ninja shakes his head.

* * *

>w
Behind the Mini Fridge
The rest of the room is east.

The tiny red ninja is here, nibbling anxiously on a cookie. He seems angry.

>ask ninja about hat
The red ninja shrugs. "I haven't seen it. Maybe someone borrowed it?"

>ask ninja about cookie
The red ninja growls at you. He says, "It's mine. You can't have it."

* * *

>ask ninja about hat
The red ninja shrugs. "I haven't seen it. Maybe someone borrowed it?"

>tell ninja about hat
The red ninja shrugs. "I haven't seen it. Maybe someone borrowed it?"

* * *

>w
Behind the Mini Fridge
The rest of the room is east.

The tiny red ninja is here, nibbling anxiously on a cookie. He seems angry.

>ask red ninja about himself
The red ninja grumbles. He says, "Leave me alone. I hate everyone."

>ask ninja about hat
The red ninja shrugs. "I haven't seen it. Maybe you lent it to someone?"

* * *

>w
Behind the Mini Fridge
The rest of the room is east.

The tiny red ninja is here, nibbling anxiously on a cookie. He seems angry.

>ask ninja about mouse
The red ninja shakes his head.

* * *

>w
Behind the Mini Fridge
The rest of the room is east.

The tiny red ninja is here, nibbling anxiously on a cookie. He seems angry.

>ask ninja about creature
The red ninja shakes his head.

>ask ninja about mouse
The red ninja shakes his head.

* * *

>w
Behind the Mini Fridge
The rest of the room is east.

The tiny red ninja is here, nibbling anxiously on a cookie. He seems angry.

>x fridge
It's the back of the fridge.

>x food
It's the back of the fridge.

* * *

>w
Behind the Mini Fridge
The rest of the room is east.

The tiny red ninja is here, nibbling anxiously on a cookie. He seems angry.

>e
Bedroom
This is the dormitory room you share with your three closest friends. There is a bed to the north, a wardrobe to the east, a bookshelf to the south, a food storage area to the west and a desk to the northwest. The door to the hallway is southwest.

>x food
There's a mini fridge and a set of shelves piled high with packets of ramen. The red ninja lives over there.

>x ramen
Ah, ramen.

>eat ramen
(first taking the ramen)
There's no way you could lift that. Nor do you have any reason to.

* * *

>show hat to ninja
The red ninja shrugs. "I haven't seen it. Maybe someone borrowed it?"

* * *

>w
Behind the Mini Fridge
The rest of the room is east.

The tiny red ninja is here, nibbling anxiously on a cookie. He seems angry.

>ask ninja about anger
The red ninja grumbles. He says, "Leave me alone. I hate everyone."

* * *

>s
Bedroom
This is the dormitory room you share with your three closest friends. There is a bed to the north, a wardrobe to the east, a bookshelf to the south, a food storage area to the west and a desk in the northwest corner.

>talk to red
You can't see any such thing.

>e
You scurry across the room, keeping close to the walls.

You knock on the wardrobe. The blue ninja peeks his head out. 

Outside the Wardrobe
This is the blue ninja's home. You are standing outside the wardrobe.The rest of the room is west.

The blue ninja stands in the doorway. He doesn't seem eager to invite you inside.

>talk to blue
You say hello to the blue ninja.

* * *

>s
Bedroom
This is the dormitory room you share with your three closest friends. There is a bed to the north, a wardrobe to the east, a bookshelf to the south, a food storage area to the west and a desk in the northwest corner.

I beg your pardon?

>w
You scurry across the room, keeping close to the walls.

Behind the Mini Fridge
This is the red ninja's home. The rest of the room is east.

The red ninja is here, nibbling anxiously on a cookie. He seems angry.

* * *

>talk to red
You say hello to the red ninja.

>talk to red
You are already talking to the red ninja.

>ninja, hello
You are already talking to the red ninja.

* * *

>w
You scurry across the room, keeping close to the walls.

Behind the Mini Fridge
This is the red ninja's home. The rest of the room is east.

The red ninja is here, nibbling anxiously on a cookie. He seems angry.

>talk to ninja
The red ninja grumbles. He seems angry and stressed out.

>ninja, hello
The red ninja grumbles. He seems angry and stressed out.

>talk to ninja
The red ninja grumbles. He seems angry and stressed out.

* * *

I beg your pardon?

>s
You scurry across the room, keeping close to the walls.

On the Bookshelf
This is the green ninja's home. The rest of the room  is north.

The green ninja is pacing back and forth.

>lk to ninja
That's not a verb I recognize.

>talk to ninja
You say hello to the green ninja.

* * *

>i
You are carrying:
  a bow tie
  a hat
  your shuriken

>wear hat
You put on the hat. You are jaunty.

>undo
Bedroom
[Previous turn undone.]

>wear hat
You put on the hat. You are jaunty.

>wear bow tie
You wear the bowtie. It's just a clip-on, but maybe no one will notice. 

End game. Yay!

    *** You are jaunty and stylish! ***

In that game you scored 25 out of a possible 100, in 5 turns.

Would you like to RESTART, RESTORE a saved game, QUIT, or UNDO the last command?

* * *

>s
Bedroom
This is the dormitory room you share with your three closest friends. There is a bed to the north, a wardrobe to the east, a bookshelf to the south, a food storage area to the west and a desk in the northwest corner.

>x food
It is a fridge and a set of shelves full of boxes and canned goods. The red ninja lives over there.

>x storage
It is a fridge and a set of shelves full of boxes and canned goods. The red ninja lives over there.

>x boxes
You can't see any such thing.

I beg your pardon?

>w
Behind the Mini Fridge
The rest of the room is east.

The tiny red ninja is here, nibbling anxiously on a cookie. He seems angry.

* * *

>x food
It is a fridge and a set of shelves full of boxes and canned goods. The red ninja lives over there.

>x boxes
It is a fridge and a set of shelves full of boxes and canned goods. The red ninja lives over there.

>x bed
The bed is unmade, as always. You live underneath it.

* * *

>s
Bedroom
This is the dormitory room you share with your three closest friends. There is a bed to the north, a wardrobe to the east, a bookshelf to the south, a food storage area to the west and a desk in the northwest corner.

>take ramen
You have more important things to do.

>eat ramen
(first taking the ramen)
You have more important things to do.

>eat shuriken
That's plainly inedible.

* * *

>s
Bedroom
This is the dormitory room you share with your three closest friends. There is a bed to the north, a wardrobe to the east, a bookshelf to the south, a food storage area to the west and a desk in the northwest corner.

>x ramen
Ah, ramen.

>eat ramen
(first taking the ramen)
"That's plainly inedible."

* * *

>s
Bedroom
This is the dormitory room you share with your three closest friends. There is a bed to the north, a wardrobe to the east, a bookshelf to the south, a food storage area to the west and a desk in the northwest corner.

>x fridge
There's a mini fridge and a set of shelves piled high with packets of ramen. The red ninja lives over there.

>open fridge
You're unable to get the door open without help.

* * *

>enter fridge
The door is closed.

>w
Behind the Mini Fridge
The rest of the room is east.

The tiny red ninja is here, nibbling anxiously on a cookie. He seems angry.

>enter fridge
The door is on the other side.

>open fridge
You can't reach the door from here.

>x fridge
It's the back of the fridge.

>talk
(to the shuriken)
The shuriken does not respond.

* * *

>s
Bedroom
This is the dormitory room you share with your three closest friends. There is a bed to the north, a wardrobe to the east, a bookshelf to the south, a food storage area to the west and a desk in the northwest corner.

>ninja, hello
You seem to want to talk to someone, but I can't see whom.

>s
On the Bookshelf
The rest of the room is north.

The tiny green ninja is pacing back and forth.

>s
You can't go that way.

>ninja, hello
The green ninja sulks. "My friend just got this really sparkly rock. It's so pretty. I don't have anything that nice. The prettiest thing I have is this stupid notebook."

>talk to ninja
That's not a verb I recognize.

>talk
That's not a verb I recognize.

* * *

>s
Bedroom
This is the dormitory room you share with your three closest friends. There is a bed to the north, a wardrobe to the east, a bookshelf to the south, a food storage area to the west and a desk in the northwest corner.

>x bookshelf
The bookshelf is piled high with books and knicknacks. The green ninja lives on the bottom shelf, behind a row of textbooks. You can see a mouse hole to the left of the bookshelf, in the southeast corner of the room.

>sw
The door is closed.

>x mouse hole
There is a mousehole in the southwest corner of the room. You can't see inside from here.

>sw
The door is closed.

* * *

>x bookshelf
The bookshelf is piled high with books and knicknacks. The green ninja lives on the bottom shelf, behind a row of textbooks. You can see a mouse hole to the left of the bookshelf, in the southeast corner of the room.

>x mouse hole
There is a mouse hole in the southeast corner of the room. You can't see inside from here.

* * *

>x bookshelf
The bookshelf is piled high with books and knicknacks. The green ninja lives on the bottom shelf, behind a row of textbooks. You can see a mouse hole to the left of the bookshelf, in the southeast corner of the room.

>s
As you approach the bookshelf, you notice a mouse hole to the left of it, the southeast corner of the room.

On the Bookshelf
The rest of the room is north.

The tiny green ninja is pacing back and forth.

>n
Bedroom
This is the dormitory room you share with your three closest friends. There is a bed to the north, a wardrobe to the east, a bookshelf to the south, a food storage area to the west and a desk in the northwest corner

>se
Inside the Mouse Hole
The rest of the room is back to the northwest.

There is a mouse here, lazing around in its nest.

>nw
Bedroom
This is the dormitory room you share with your three closest friends. There is a bed to the north, a wardrobe to the east, a bookshelf to the south, a food storage area to the west and a desk in the northwest corner

>s
As you approach the bookshelf, you notice a mouse hole to the left of it, the southeast corner of the room.

On the Bookshelf
The rest of the room is north.

The tiny green ninja is pacing back and forth.

>x mouse hole
The mouse hole is next to to bookshelf. You can't see it from here.

* * *

>s
Bedroom
This is the dormitory room you share with your three closest friends. There is a bed to the north, a wardrobe to the east, a bookshelf to the south, a food storage area to the west and a desk in the northwest corner.

>x bookcase
You can't see any such thing.

* * *

>s
Bedroom
This is the dormitory room you share with your three closest friends. There is a bed to the north, a wardrobe to the east, a bookshelf to the south, a food storage area to the west and a desk in the northwest corner.

>x shelf
The bookshelf is piled high with books and knicknacks. The green ninja lives on the bottom shelf, behind a row of textbooks. You can see a mousehole to the left of the bookshelf.

>x shelves
There's a mini fridge and a set of shelves piled high with packets of ramen. The red ninja lives over there.

>x mousehole
There is a mousehole in the southeast corner of the room. You can't see inside from here.

>x desk
There is a desk in the corner, underneath the window.

>ne
Far Corner of the Bed
This corner doesn't seem to get cleaned often. There is a rather large spider web stretched between the foot of the bed and the wall. Thankfully its inhabitant is nowhere to be found. The rest of the room is southwest.

>sw
Bedroom
This is the dormitory room you share with your three closest friends. There is a bed to the north, a wardrobe to the east, a bookshelf to the south, a food storage area to the west and a desk in the northwest corner

>nw
Below the Desk
You can see sunlight above you. The rest of the room is southeast.

>x desk
There is a window above the desk.

>x sunlight
There's a window somewhere over the desk.

>e
You can't go that way.

* * *

>s
Bedroom
This is the dormitory room you share with your three closest friends. There is a bed to the north, a wardrobe to the east, a bookshelf to the south, a food storage area to the west and a desk in the northwest corner.

>x bed
*** Run-time problem P47 (at paragraph 43 in the source text): Phrase applied to an incompatible kind of value.

You can't see anything in that direction.

* * *

>s
Bedroom
This is the dormitory room you share with your three closest friends. There is a bed to the north, a wardrobe to the east, a bookshelf to the south, a food storage area to the west and a desk in the northwest corner.

>x milk
You seem to be thinking of a different game.

>take milk
You seem to be thinking of a different game.

* * *

>x milk
You seem to be thinking of a different game.

>please pass the milk please
Ninjas are lactose intolerant. [Citation needed[

* * *

The talent show is tonight, and you promised to emcee. But first you need to find your hat.

The Legend of the Missing Hat
A tiny adventure by Adri
Release 1 / Serial number 140106 / Inform 7 build 6G60 (I6/v6.32 lib 6/12N) SD

Under the Bed
This is where you live. The rest of the room is south, and there's a particularly dusty looking corner to the east.

>e
Far Corner of the Bed
This corner doesn't seem to get cleaned often. There is a rather large spider web stretched between the foot of the bed and the wall. Thankfully its inhabitant is nowhere to be found. The rest of the room is southwest.

>throw shuriken at web
There's no need to be so destructive. Why don't you look more closely at the web first?

>l
Far Corner of the Bed
This corner doesn't seem to get cleaned often. There is a rather large spider web stretched between the foot of the bed and the wall. Thankfully its inhabitant is nowhere to be found.

You can see a pearl and your shuriken here.

>x glint
It's a pearl earring in a silver setting.

>x pearl
It's a pearl earring in a silver setting.

>x glint
It's a pearl earring in a silver setting.

>x glint
It's a pearl earring in a silver setting.

>restart
Are you sure you want to restart?

>y
You're performing tonight at the Ninja Karoke Bar. But where is your favorite hat? You think you lent it to someone.

Ninjas!
TODO by Adri
Release 1 / Serial number 120523 / Inform 7 build 6G60 (I6/v6.32 lib 6/12N) SD

Under the Bed
This is where you live. The rest of the room is south, and there's a particularly dusty looking corner to the east.

>e
Far Corner of the Bed
This corner doesn't seem to get cleaned often. There is a rather large spider web stretched between the foot of the bed and the wall. Thankfully its inhabitant is nowhere to be found.

>x glint
It's a pearl earring in a silver setting.

* * *

>x pearl
It's a pearl earring in a silver setting.

>i
You are carrying:
  your shuriken

>l
Far Corner of the Bed
This corner doesn't seem to get cleaned often. There is a rather large spider web stretched between the foot of the bed and the wall. Thankfully its inhabitant is nowhere to be found.

On the web is a pearl.

>throw shuriken at pearl
You throw the shuriken at the web, slicing easily through the sticky material. The pearl drops to the ground.

>x glint
You can't see any such thing.

>x pearl
It's a pearl earring in a silver setting.

* * *

>throw shuriken at web
There's no need to be so destructive. Why don't you look more closely at the web first?

>x glint
It's a pearl earring in a silver setting.

>throw shuriken at web
You throw the shuriken at the web, slicing easily through the sticky material. The pearl drops to the ground.

>take pearl
As you stoop to pick up the pearl, the spider sneaks in and fixes her web. Taken.

>throw pearl at web
Haven't you caused enough damage?

>throw pearl at spider
It's not nice to throw things.

>throw pearl
Dropped.

>take pearl
Taken.

>throw pearl at shuriken
It's not nice to throw things.

>take shuriken
Taken.

>throw pearl at shuriken
It would be difficult to throw at something you are yourself holding.

* * *

>e
Far Corner of the Bed
This corner doesn't seem to get cleaned often. There is a rather large spider web stretched between the foot of the bed and the wall. Thankfully its inhabitant is nowhere to be found. The rest of the room is southwest.

>x glint
It's a pearl earring in a silver setting. It's about the size of your head.

>throw shuriken at web
You throw the shuriken at the web, slicing easily through the sticky material. The pearl drops to the ground.

>take all
pearl: As you stoop to pick up the pearl, the spider sneaks in and fixes her web. Taken.
shuriken: Taken.

>throw shuriken at pearl
You tap the pearl with the shuriken. Nothing happens.

>throw pearl at shuriken
You tap the shuriken with the pearl. Nothing happens.

>tie shuriken to pearl
You would achieve nothing by this.

>sw
Center Room
This is the dormitory room you share with your three closest friends. There is a bed to the north, a wardrobe to the east, a bookshelf to the south, a food storage area to the west and a desk to the northwest. The door to the hallway is southwest.

>e
You scurry across the room, keeping close to the walls.

You knock on the wardrobe. The blue ninja peeks his head out. He does not invite you inside.

Outside the Wardrobe
This is the blue ninja's home. You are standing outside the wardrobe.The rest of the room is west.

The blue ninja is here. He looks sad.

>throw shuriken at ninja
That might be construed as an attack.

>throw shuriken at wardrobe
You shouldn't throw that around unless you need to.

>throw pearl at wardrboe
You can't see any such thing.

>throw pearl at wardrobe
It's not nice to throw things.

* * *

>x glint
It's a pearl earring in a silver setting. It's about the size of your head.

>x spider
The spider seems to have vanished again.

>cut web
(with the shuriken)
You throw the shuriken at the web, slicing easily through the sticky material. The pearl drops to the ground.

>x spider
The spider seems to have vanished again.

>take pearl
As you stoop to pick up the pearl, the spider sneaks in and fixes her web. Taken.

>x spider
The spider seems to have vanished again.

* * *

>x glint
It's a pearl earring in a silver setting. It's about the size of your head.

>cut web
(with the shuriken)
You throw the shuriken at the web, slicing easily through the sticky material. The pearl drops to the ground.

>take pearl
As you stoop to pick up the pearl, the spider sneaks in and fixes her web. Taken.

>x web
The spider has woven the word "CRETIN" into her web.

>x spider
You can't see that here. Thankfully.

>cut web
(with the shuriken)
As you stoop to pick up the pearl, the spider sneaks in and fixes her web.

I beg your pardon?

* * *

>e
Far Corner of the Bed
This corner doesn't seem to get cleaned often. There is a rather large spider web stretched between the foot of the bed and the wall. Thankfully its inhabitant is nowhere to be found. The rest of the room is southwest.

>sw
Center Room
This is the dormitory room you share with your three closest friends. There is a bed to the north, a wardrobe to the east, a bookshelf to the south, a food storage area to the west and a desk to the northwest. The door to the hallway is southwest.

* * *

>throw shuriken at desk
You won't be able to retrieve that. Maybe if you tied something to it?

>up
You can't reach that. Maybe there's another way.

>tie shuriken to yarn
You tie the yarn to the shuriken, creating a grappling hook.

>throw shuriken at desk
You throw the grappling hook at the desk. It catches in the wood.

You climb up the length of yarn.

On the Desk
This is the windowsill. There is a pot here containing tiny purple flowers.

You can see a grappling hook here.

>take hook
You untie the yarn from the shuriken.

* * *

>e
Far Corner of the Bed
This corner doesn't seem to get cleaned often. There is a rather large spider web stretched between the foot of the bed and the wall. Thankfully its inhabitant is nowhere to be found. The rest of the room is southwest.

>s
You can't go that way.

>w
Stuff is here.

Under the Bed
This is where you live. The rest of the room is south, and there's a particularly dusty looking corner to the east.

>e
Far Corner of the Bed
This corner doesn't seem to get cleaned often. There is a rather large spider web stretched between the foot of the bed and the wall. Thankfully its inhabitant is nowhere to be found.

>x glint.throw shuriken at glint.take all
It's a pearl earring in a silver setting.

You throw the shuriken at the web, slicing easily through the sticky material. The pearl drops to the ground.

pearl: As you stoop to pick up the pearl, the spider sneaks in and fixes her web. Taken.
shuriken: Taken.

>w
Stuff is here.

Under the Bed
This is where you live. The rest of the room is south, and there's a particularly dusty looking corner to the east.

* * *

>e
Far Corner of the Bed
This corner doesn't seem to get cleaned often. There is a rather large spider web stretched between the foot of the bed and the wall. Thankfully its inhabitant is nowhere to be found.

>l
Far Corner of the Bed
This corner doesn't seem to get cleaned often. There is a rather large spider web stretched between the foot of the bed and the wall. Thankfully its inhabitant is nowhere to be found.

>take all
There are none at all available!

* * *

>e
Far Corner of the Bed
This corner doesn't seem to get cleaned often. There is a rather large spider web stretched between the foot of the bed and the wall. Thankfully its inhabitant is nowhere to be found. The rest of the room is southwest.

>x glint;throw shuriken at web
You can't see any such thing.

>x glint
It's a pearl earring in a silver setting.

* * *

>take all
pearl: As you stoop to pick up the pearl, the spider sneaks in and fixes her web. Taken.
shuriken: Taken.

>s
You can't go that way.

>s
You can't go that way.

>sw
Center Room
This is the dormitory room you share with your three closest friends. There is a bed to the north, a wardrobe to the east, a bookshelf to the south, a food storage area to the west and a desk to the northwest. The door to the hallway is southwest.

>s
You scurry across the room, keeping close to the walls.

On the Bookshelf
This is the green ninja's home. The rest of the room  is north.

The green ninja is here. He looks anxious.

>give pearl to ninja
The green ninja doesn't seem interested.

* * *

>e
Far Corner of the Bed
This corner doesn't seem to get cleaned often. There is a rather large spider web stretched between the foot of the bed and the wall. Thankfully its inhabitant is nowhere to be found. The rest of the room is southwest.

>x glint;throw shuriken at web;take pearl;sw;s
You can't see any such thing.

>e
You can't go that way.

>x glint
It's a pearl earring in a silver setting. It's about the size of your head.

>throw shuriken at web.take pearl.sw.s
You throw the shuriken at the web, slicing easily through the sticky material. The pearl drops to the ground.

As you stoop to pick up the pearl, the spider sneaks in and fixes her web. Taken.

You pause to retrieve your shuriken. Taken.

Bedroom
This is the dormitory room you share with your three closest friends. There is a bed to the north, a wardrobe to the east, a bookshelf to the south, a food storage area to the west and a desk to the northwest. The door to the hallway is southwest.

On the Bookshelf
The rest of the room is north.

The tiny green ninja is pacing back and forth.

>hug ninja
You try to hug the green ninja, but he pushes you away.

>give pearl to ninja
The green ninja oohs and ahhs over the pearl. He gives you a notebook.  "Here. I don't need this anymore. It's just cheap junk."

[Your score has just gone up by twenty-five points.]

>hug ninja
Keep your mind on the game.

* * *

>e
Far Corner of the Bed
This corner doesn't seem to get cleaned often. There is a rather large spider web stretched between the foot of the bed and the wall. Thankfully its inhabitant is nowhere to be found. The rest of the room is southwest.

>x web
There's something glinting on the web.

>x spider
You can't see that here. Thankfully.

>damacut web
That's not a verb I recognize.

>cut web
(with the shuriken)
Why don't you look more closely at the web first?

>x spider
You can't see that here. Thankfully.

>x glint
It's a pearl earring in a silver setting. It's about the size of your head.

* * *

>cut web
(with the shuriken)
You throw the shuriken at the web, slicing easily through the sticky material. The pearl drops to the ground.

>x web
The web has been torn up.

>x spider
The spider seems to have vanished again.

* * *

>x web
There's something glinting on the web.

>x glint
It's a pearl earring in a silver setting. It's about the size of your head.

>cub web
That's not a verb I recognize.

>cut we
You can't see any such thing.

>cut web
(with the shuriken)
You throw the shuriken at the web, slicing easily through the sticky material. The pearl drops to the ground.

* * *

>take pearl
As you stoop to pick up the pearl, the spider sneaks in and fixes her web. Taken.

>x web
The web has been torn up.

>cut web
(with the shuriken)
The spider comes out, shakes several fists at you, and repairs her web. She slips off again.

>x web
The web has been torn up.

>cut web
(with the shuriken)
Not really. But knock it off.

Far Corner of the Bed
This corner doesn't seem to get cleaned often. There is a rather large spider web stretched between the foot of the bed and the wall. Thankfully its inhabitant is nowhere to be found. The rest of the room is southwest.

You can see your shuriken here.

* * *

>x web
There's something glinting on the web.

>cut web
(with the shuriken)
Why don't you look more closely at the web first?

>look closely
(at the web)
You peer more closely at the web. The glint appears to be a pearl earring.

>x web
On the web is a pearl.

>cut web
(with the shuriken)
You throw the shuriken at the web, slicing easily through the sticky material.
The pearl drops to the ground.

>l
Far Corner of the Bed
This corner doesn't seem to get cleaned often. There is a rather large spider web stretched between the foot of the bed and the wall. Thankfully its inhabitant is nowhere to be found. The rest of the room is southwest.

You can see a pearl and your shuriken here.

>x web
The web has been torn up.

>cut web
(with the shuriken)
You throw the shuriken at the web, slicing easily through the sticky material.

As you stoop to pick up the pearl, the spider sneaks in and fixes her web.

* * *

>x web
There's something glinting on the web.

>damage me
That's an odd thing to do.

>damage shuriken with shuriken
Violence isn't the answer to this one.

>damage shuriken
Violence isn't the answer to this one.

* * *

>e
Far Corner of the Bed
This corner doesn't seem to get cleaned often. There is a rather large spider web stretched between the foot of the bed and the wall. Thankfully its inhabitant is nowhere to be found. The rest of the room is southwest.

>x spider
You can't see that here. Thankfully.

* * *

>cut web
(with the shuriken)
You throw the shuriken at the web, slicing easily through the sticky material. The pearl drops to the ground.

>x spider
You can't see that here. Thankfully.

>take pearl
As you stoop to pick up the pearl, the spider sneaks in and fixes her web. Taken.

* * *

>x spider
The spider seems to have vanished again.

>take spider
The spider seems to have vanished again.

* * *

>x spider
The spider seems to have vanished again.

>x spider
You can't see that here. Thankfully.

>x spider
You can't see that here. Thankfully.

>take pearl
You can't see any such thing.

* * *

>e
Far Corner of the Bed
This corner doesn't seem to get cleaned often. There is a rather large spider web stretched between the foot of the bed and the wall. Thankfully its inhabitant is nowhere to be found. The rest of the room is southwest.

>attack web with shuriken
Why don't you look more closely at the web first?

>cut web with shuriken
Why don't you look more closely at the web first?

* * *

>e
Far Corner of the Bed
This corner doesn't seem to get cleaned often. There is a rather large spider web stretched between the foot of the bed and the wall. Thankfully its inhabitant is nowhere to be found. The rest of the room is southwest.

>cut web
(with the shuriken)
Why don't you look more closely at the web before you destroy it?

>drop shuriken
Maybe you should try throwing it at something.

>i
You are carrying:
  your shuriken

>x glint
It's a pearl earring in a silver setting. It's about the size of your head.

* * *

>x web
The web has been torn up.

>cut web
(with the shuriken)
Haven't you done enough damage?

>take pearl
As you stoop to pick up the pearl, the spider sneaks in and fixes her web. Taken.

>x pearl
It's a pearl earring in a silver setting. It's about the size of your head.

>x web.x spider.cut web
The spider has woven the word "CRETIN" into her web.

You can't see that here. Thankfully.

(with the shuriken)
You throw the shuriken at the web, slicing easily through the sticky material.

The spider comes out, shakes several fists at you, and repairs her web. She slips off again.

>x spider
The spider seems to have vanished again.

>x web
The spider has woven the word "CRETIN" into her web.

* * *

>x spider
You can't see that here. Thankfully.

>cut web
(with the shuriken)
You throw the shuriken at the web, slicing easily through the sticky material.

*** The spider bites you. You die. ***Not really. But knock it off.

>cut web
(with the shuriken)
You throw the shuriken at the web, slicing easily through the sticky material.

* * *

>cut web
(with the shuriken)
Why don't you look more closely at the web before you destroy it?

>x web
There's something glinting on the web.

* * *

>x glint
It's a pearl earring in a silver setting. It's about the size of your head.

>x web
There's something glinting on the web.

>search web
You peer more closely at the web. There is a pearl earring stuck to the web.

>cut web
(with the shuriken)
You throw the shuriken at the web, slicing easily through the sticky material. The pearl drops to the ground.

>search web
There is nothing on the web.

>x web
The web has been torn up.

>take pearl
As you stoop to pick up the pearl, the spider sneaks in and fixes its web. Taken.

>x web.x spider.x spider
The spider has woven the word "CRETIN" into its web.

The spider seems to have vanished again.

You can't see that here. Thankfully.

>x pearl
It's a pearl earring in a silver setting. It's about the size of your head.

>i
You are carrying:
  a pearl

>x glint
You can't see any such thing.

* * *

>e
Far Corner of the Bed
This corner doesn't seem to get cleaned often. There is a rather large spider web stretched between the foot of the bed and the wall. Thankfully its inhabitant is nowhere to be found. The rest of the room is southwest.

>in
You can't go that way.

>sw.e
Bedroom
This is the dormitory room you share with your three closest friends. There is a bed to the north, a wardrobe to the east, a bookshelf to the south, a food storage area to the west and a desk in the northwest corner.

You knock on the door of the wardrobe, and the blue ninja peeks his head out. 

Outside the Wardrobe
The rest of the room is west.

The tiny blue ninja stands in the doorway. He doesn't seem eager to invite you inside.

>in
You can't go that way.

* * *

>e
Far Corner of the Bed
This corner doesn't seem to get cleaned often. There is a rather large spider web stretched between the foot of the bed and the wall. Thankfully its inhabitant is nowhere to be found. The rest of the room is southwest.

>attack web
You don't want to touch that with your bare hands.

>x glint.attack web.attack web with star
It's a pearl earring in a silver setting. It's about the size of your head.

You don't want to touch that with your bare hands.

You throw the shuriken at the web, slicing easily through the sticky material. The pearl drops to the ground.

>attack web.attack spider.attack pearl
You don't want to touch that with your bare hands.

You can't see that here. Thankfully.

Violence isn't the answer to this one.

>take pearl.attack web with star.attack web with star.attack spider
As you stoop to pick up the pearl, the spider sneaks in and fixes its web.

You throw the shuriken at the web, slicing easily through the sticky material.

The spider comes out, shakes several tiny fists at you, and repairs the web. It slips off again.

You throw the shuriken at the web, slicing easily through the sticky material.

*** The spider bites you. You die. ***

Not really. But knock it off.

The spider bares its fangs at you. You decide to leave it alone.

>attack me
Violence isn't the answer to this one.

>sw
You pause to retrieve your shuriken.

Bedroom
This is the dormitory room you share with your three closest friends. There is a bed to the north, a wardrobe to the east, a bookshelf to the south, a food storage area to the west and a desk in the northwest corner.

>attack wardrobe.attack desk.attack bed
There's no need to be so destructive.

There's no need to be so destructive.

There's no need to be so destructive.

>e.attack ninja.w.se.attack mouse
You knock on the door of the wardrobe, and the blue ninja peeks his head out. 

Outside the Wardrobe
The rest of the room is west.

The tiny blue ninja stands in the doorway. He doesn't seem eager to invite you inside.

Violence isn't the answer to this one.

Bedroom
This is the dormitory room you share with your three closest friends. There is a bed to the north, a wardrobe to the east, a bookshelf to the south, a food storage area to the west and a desk in the northwest corner.

Inside the Mouse Hole
The rest of the room is back to the northwest.

There is a mouse here, lazing around in its nest.

Surely there's a better way to resolve this.

* * *

The talent show is tonight, and you promised to emcee. But first you need to find your hat.

The Legend of the Missing Hat
A tiny adventure by Adri
Release 1 / Serial number 140106 / Inform 7 build 6G60 (I6/v6.32 lib 6/12N) SD

Under the Bed
This is where you live. The rest of the room is south, and there's a particularly dusty looking corner to the east.

>i
You are carrying:
  your shuriken

>l
Under the Bed
This is where you live. The rest of the room is south, and there's a particularly dusty looking corner to the east.

>x hat
You can't see any such thing.

* * *

>l
Under the Bed
This is where you live. The rest of the room is south, and there's a particularly dusty looking corner to the east.

>x me
You are the black ninja.

* * *

>i
You are carrying:
  your shuriken

>wear hat
You wear the hat!

>z
Time passes.

>z
Time passes.

>wear bow tie
You wear the bow tie!

End game. Yay!

    *** You are jaunty and stylish! ***

Would you like to RESTART, RESTORE a saved game, QUIT, or UNDO the last command?

>restart
You're performing tonight at the Ninja Karoke Bar. But where is your favorite hat? You think you lent it to someone.

Ninjas!
TODO by Adri
Release 1 / Serial number 120523 / Inform 7 build 6G60 (I6/v6.32 lib 6/12N) SD

Under the Bed
This is where you live. The rest of the room is south, and there's a particularly dusty looking corner to the east.

>wear bow tie
You wear the bow tie!

>wear hat
You wear the hat!

End game. Yay!

    *** You are jaunty and stylish! ***

Would you like to RESTART, RESTORE a saved game, QUIT, or UNDO the last command?

* * *

>i
You are carrying:
  your shuriken

>s
Center Room
This is the dormitory room you share with your three closest friends. There is a bed to the north, a wardrobe to the east, a bookshelf to the south, a food storage area to the west and a desk to the northwest. The door to the hallway is southwest.

>se
You scurry across the room, keeping close to the walls.

Inside the Mousehole
This appears to be the home of a mouse. The rest of the room is back to the northwest.

There is a mouse here, lazing around in its nest.

>x mouse
The mouse does not seem friendly.

>i
You are carrying:
  a cookie
  your shuriken

>give cookie to mouse
You give the cookie to the mouse. It nibbles happily.

>x mouse
The mouse seems harmless enough.

* * *

>i
You are carrying:
  your shuriken

>cheat
That's not a verb I recognize.

>e
Far Corner of the Bed
This corner doesn't seem to get cleaned often. There is a rather large spider web stretched between the foot of the bed and the wall. Thankfully its inhabitant is nowhere to be found.

>throw shuriken at web
There's no need to be so destructive. Why don't you look more closely at the web first?

>throw shuriken at web
There's no need to be so destructive. Why don't you look more closely at the web first?

>x web
It's a spider web. There's something glinting on it.

>x glint
It's a pearl earring in a silver setting.

* * *

>take all
pearl: As you stoop to pick up the pearl, the spider sneaks in and fixes her web. Taken.
shuriken: Taken.

>sw
Bedroom
This is the dormitory room you share with your three closest friends. There is a bed to the north, a wardrobe to the east, a bookshelf to the south, a food storage area to the west and a desk to the northwest. The door to the hallway is southwest.

>e
You scurry across the room, keeping close to the walls.

You knock on the wardrobe. The blue ninja peeks his head out. 

Outside the Wardrobe
This is the blue ninja's home. You are standing outside the wardrobe.The rest of the room is west.

The blue ninja stands in the doorway. He doesn't seem eager to invite you inside.

>w
Bedroom
This is the dormitory room you share with your three closest friends. There is a bed to the north, a wardrobe to the east, a bookshelf to the south, a food storage area to the west and a desk to the northwest. The door to the hallway is southwest.

>s
You scurry across the room, keeping close to the walls.

On the Bookshelf
This is the green ninja's home. The rest of the room  is north.

The green ninja is pacing back and forth.

>givetalk to ninja
That's not a verb I recognize.

>talk to ninja
The green ninja quietly sulks.

>show shuriken to ninja
The green ninja quietly sulks.

>show pearl to ninja
The green ninja quietly sulks.

>ask ninja about pearl
The green ninja quietly sulks.

* * *

>i
You are carrying:
  your shuriken

>juggle
You toss the shuriken into the air. You panic as the shuriken comes back down and duck out of the way.

* * *

>juggle
You toss the hat, the bow tie, and the shuriken into the air. You miss everything.

* * *

>juggle
You toss the shuriken into the air. You panic as the shuriken comes back down and duck out of the way.

>l
Under the Bed
This is where you live. The rest of the room is south, and there's a particularly dusty looking corner to the east.

You can see your shuriken here.

>take shuriken.cheat
Taken.

>juggle
You toss the hat, the bow tie, and the shuriken into the air. You panic as the shuriken comes back down and duck out of the way.

>take hat and tie.
hat: Taken.
bow tie: Taken.

>juggle
You toss the bow tie and the hat into the air. You panic as the bow tie comes back down and duck out of the way.

>l
Under the Bed
This is where you live. The rest of the room is south, and there's a particularly dusty looking corner to the east.

You can see a hat, a bow tie, and your shuriken here.

>juggle
You toss nothing into the air. You panic as the nothing comes back down and duck out of the way.

>i
You are carrying nothing.

* * *

The talent show is tonight, and you promised to emcee. But first you need to find your hat.

The Legend of the Missing Hat
A tiny adventure by Adri
Release 1 / Serial number 140106 / Inform 7 build 6G60 (I6/v6.32 lib 6/12N) SD

Under the Bed
This is where you live. The rest of the room is south, and there's a particularly dusty looking corner to the east.

>enter foo
You can't see any such thing.

>up
You can't go that way.

>s
Center Room
This is the dormitory room you share with your three closest friends. There is a bed to the north, a wardrobe to the east, a bookshelf to the south, a food storage area to the west and a desk to the northwest. The door to the hallway is southwest.

>e
You scurry across the room, keeping close to the walls.

You knock on the wardrobe. The blue ninja peeks his head out. He does not invite you inside.

Outside the Wardrobe
This is the blue ninja's home. You are standing outside the wardrobe.The rest of the room is west.

The blue ninja is here. He looks sad.

>e
You can't go that way.

>enter warddrobe
Center Room
This is the dormitory room you share with your three closest friends. There is a bed to the north, a wardrobe to the east, a bookshelf to the south, a food storage area to the west and a desk to the northwest. The door to the hallway is southwest.

* * *

The talent show is tonight, and you promised to emcee. But first you need to find your hat.

The Legend of the Missing Hat
A tiny adventure by Adri
Release 1 / Serial number 140106 / Inform 7 build 6G60 (I6/v6.32 lib 6/12N) SD

Under the Bed
This is where you live. The rest of the room is south, and there's a particularly dusty looking corner to the east.

>sw
You can't go that way.

>s
Center Room
This is the dormitory room you share with your three closest friends. There is a bed to the north, a wardrobe to the east, a bookshelf to the south, a food storage area to the west and a desk to the northwest. The door to the hallway is southwest.

>sw
(first opening the Hallway Door)
There's no way you can open that door. And you need to find your hat before you can go anywhere.

* * *

The talent show is tonight, and you promised to emcee. But first you need to find your hat.

The Legend of the Missing Hat
A tiny adventure by Adri
Release 1 / Serial number 140106 / Inform 7 build 6G60 (I6/v6.32 lib 6/12N) SD

Under the Bed
This is where you live. The rest of the room is south, and there's a particularly dusty looking corner to the east.

>ne
You can't go that way.

>e
Far Corner of the Bed
This corner doesn't seem to get cleaned often. There is a rather large spider web stretched between the foot of the bed and the wall. Thankfully its inhabitant is nowhere to be found.

* * *

>x web
It's a spider web. There's something glinting on it.

>throw shuriken at web
There's no need to be so destructive. Why don't you look more closely at the web first?

* * *

>x glint
It's a pearl earring in a silver setting.

>l
Far Corner of the Bed
This corner doesn't seem to get cleaned often. There is a rather large spider web stretched between the foot of the bed and the wall. Thankfully its inhabitant is nowhere to be found.

On the web is a pearl.

>x pearl
It's a pearl earring in a silver setting.

>x web
It's a spider web. 
On the web is a pearl.

>throw shuriken at web
You throw the shuriken at the web, slicing easily through the sticky material. The pearl drops to the ground.

>throw shuriken at web
(first taking the shuriken)
Haven't you caused enough damage?

>take pearl
As you stoop to pick up the pearl, the spider sneaks in and fixes her web. Taken.

>throw shuriken at web
Haven't you caused enough damage?

>throw shuriken
Dropped.

>take shuriken
Taken.

>throw pearl at web
Haven't you caused enough damage?

>restart
Are you sure you want to restart?

* * *

>e
Far Corner of the Bed
This corner doesn't seem to get cleaned often. There is a rather large spider web stretched between the foot of the bed and the wall. Thankfully its inhabitant is nowhere to be found.

>throw shuriken at glint
It's not nice to throw things.

>w
Under the Bed
This is where you live. The rest of the room is south, and there's a particularly dusty looking corner to the east.

>s
Center Room
This is the dormitory room you share with your three closest friends. There is a bed to the north, a wardrobe to the east, a bookshelf to the south, a food storage area to the west and a desk to the northwest. The door to the hallway is southwest.

>nw
You scurry across the room, keeping close to the walls.

Below the Desk
This is the desk area.

>throw shuriken at desk
Not quite.

>se
Center Room
This is the dormitory room you share with your three closest friends. There is a bed to the north, a wardrobe to the east, a bookshelf to the south, a food storage area to the west and a desk to the northwest. The door to the hallway is southwest.

>throw shuriken at desk
Not quite.

>throw shuriken at bed
It's not nice to throw things.

* * *

The talent show is tonight, and you promised to emcee. But first you need to find your hat.

The Legend of the Missing Hat
A tiny adventure by Adri
Release 1 / Serial number 140106 / Inform 7 build 6G60 (I6/v6.32 lib 6/12N) SD

Under the Bed
This is where you live. The rest of the room is south, and there's a particularly dusty looking corner to the east.

>throw shuriken at bed
You should be more careful with that.

>e
Far Corner of the Bed
This corner doesn't seem to get cleaned often. There is a rather large spider web stretched between the foot of the bed and the wall. Thankfully its inhabitant is nowhere to be found.

* * *

>throw shuriken at web
There's no need to be so destructive. Why don't you look more closely at the web first?

>throw shuriken at glint
There's no need to be so destructive. Why don't you look more closely at the web first?

>x glint
It's a pearl earring in a silver setting.

>throw shuriken at glint
You throw the shuriken at the web, slicing easily through the sticky material. The pearl drops to the ground.

>throw shuriken at glint
You can't see any such thing.

>throw shuriken at web
(first taking the shuriken)
Haven't you caused enough damage?

>throw shuriken at pearl
You should be more careful with that.

* * *

The talent show is tonight, and you promised to emcee. But first you need to find your hat.

The Legend of the Missing Hat
A tiny adventure by Adri
Release 1 / Serial number 140106 / Inform 7 build 6G60 (I6/v6.32 lib 6/12N) SD

Under the Bed
This is where you live. The rest of the room is south, and there's a particularly dusty looking corner to the east.

>throw shuriken
Dropped.

* * *

>take shuriken
Taken.

>e
Far Corner of the Bed
This corner doesn't seem to get cleaned often. There is a rather large spider web stretched between the foot of the bed and the wall. Thankfully its inhabitant is nowhere to be found. The rest of the room is southwest.

>throw shuriken
Maybe you should try throwing it at something.

>i
You are carrying:
  your shuriken

>w
Under the Bed
This is where you live. The rest of the room is south, and there's a particularly dusty looking corner to the east.

* * *

>nw
Below the Desk
You can see sunlight above you. The rest of the room is southeast.

>throw shuriken
What would you like to throw that at?

>se
Bedroom
This is the dormitory room you share with your three closest friends. There is a bed to the north, a wardrobe to the east, a bookshelf to the south, a food storage area to the west and a desk to the northwest. The door to the hallway is southwest.

>throw shuriken
Dropped.

* * *

>throw shuriken
Maybe you should try throwing it at something.

>s
You can't go that way.

>sw
Bedroom
This is the dormitory room you share with your three closest friends. There is a bed to the north, a wardrobe to the east, a bookshelf to the south, a food storage area to the west and a desk to the northwest. The door to the hallway is southwest.

I beg your pardon?

>s
On the Bookshelf
The rest of the room is north.

The tiny green ninja is pacing back and forth.

>x bookshelf
You see a bunch of textbooks. None of it is particularly interesting.

>n
Bedroom
This is the dormitory room you share with your three closest friends. There is a bed to the north, a wardrobe to the east, a bookshelf to the south, a food storage area to the west and a desk to the northwest. The door to the hallway is southwest.

>x bookshelf
The bookshelf is piled high with books and knicknacks. The green ninja lives on the bottom shelf, behind a row of textbooks. You can see a mousehole to the left of the bookshelf.

* * *

The talent show is tonight, and you promised to emcee. But first you need to find your hat.

The Legend of the Missing Hat
A tiny adventure by Adri
Release 1 / Serial number 140106 / Inform 7 build 6G60 (I6/v6.32 lib 6/12N) SD

Under the Bed
This is where you live. The rest of the room is south, and there's a particularly dusty looking corner to the east.

>tie rope to shuriken
You tie the yarn to the shuriken, creating a grappling hook.

>i
You are carrying:
  a grappling hook

>x hook
It's a crude grappling hook, created by tying a piece of yarn around your shuriken.

>s
Center Room
This is the dormitory room you share with your three closest friends. There is a bed to the north, a wardrobe to the east, a bookshelf to the south, a food storage area to the west and a desk to the northwest. The door to the hallway is southwest.

>ne
You scurry across the room, keeping close to the walls.

Far Corner of the Bed
This corner doesn't seem to get cleaned often. There is a rather large spider web stretched between the foot of the bed and the wall. Thankfully its inhabitant is nowhere to be found.

>throw hook at ledge
You can't see any such thing.

>sw
Center Room
This is the dormitory room you share with your three closest friends. There is a bed to the north, a wardrobe to the east, a bookshelf to the south, a food storage area to the west and a desk to the northwest. The door to the hallway is southwest.

* * *

>nw
You scurry across the room, keeping close to the walls.

Below the Desk
This is the desk area.

>throw hook at ledge
Yay!

On the Desk
This is the windowsill. There is a pot here containing tiny purple flowers.

You can see a grappling hook here.

* * *

The talent show is tonight, and you promised to emcee. But first you need to find your hat.

The Legend of the Missing Hat
A tiny adventure by Adri
Release 1 / Serial number 140106 / Inform 7 build 6G60 (I6/v6.32 lib 6/12N) SD

Under the Bed
This is where you live. The rest of the room is south, and there's a particularly dusty looking corner to the east.

>tie shuriken to yarn
You tie the yarn to the shuriken, creating a grappling hook.

>take hook
You already have that.

>drop hook
Dropped.

>take hook
Taken.

>s
Center Room
This is the dormitory room you share with your three closest friends. There is a bed to the north, a wardrobe to the east, a bookshelf to the south, a food storage area to the west and a desk to the northwest. The door to the hallway is southwest.

* * *

>nw
You scurry across the room, keeping close to the walls.

Below the Desk
This is the desk area.

>throw shuriken at desk
You throw the grappling hook at the desk. It catches in the wood.

You climb up the length of yarn.

On the Desk
This is the windowsill. There is a pot here containing tiny purple flowers.

You can see a grappling hook here.

>take hook
Taken.

>down
It's a far way down. Maybe there's another way.

>drop hook
Dropped.

>down
You slide down the length of yarn. You give the yarn a good yank and the grappling hook returns to you.

Below the Desk
This is the desk area.

>i
You are carrying:
  a grappling hook

* * *

The talent show is tonight, and you promised to emcee. But first you need to find your hat.

The Legend of the Missing Hat
A tiny adventure by Adri
Release 1 / Serial number 140106 / Inform 7 build 6G60 (I6/v6.32 lib 6/12N) SD

Under the Bed
This is where you live. The rest of the room is south, and there's a particularly dusty looking corner to the east.

>tie yarn to shuriken.s.nw.
You tie the yarn to the shuriken, creating a grappling hook.

Center Room
This is the dormitory room you share with your three closest friends. There is a bed to the north, a wardrobe to the east, a bookshelf to the south, a food storage area to the west and a desk to the northwest. The door to the hallway is southwest.

You scurry across the room, keeping close to the walls.

Below the Desk
This is the desk area.

>throw shuriken at desk
You throw the grappling hook at the desk. It catches in the wood.

>l
Below the Desk
This is the desk area.

* * *

The talent show is tonight, and you promised to emcee. But first you need to find your hat.

The Legend of the Missing Hat
A tiny adventure by Adri
Release 1 / Serial number 140106 / Inform 7 build 6G60 (I6/v6.32 lib 6/12N) SD

Under the Bed
This is where you live. The rest of the room is south, and there's a particularly dusty looking corner to the east.

>tie yarn to shuriken
You tie the yarn to the shuriken, creating a grappling hook.

>create
That's not a verb I recognize.

* * *

The talent show is tonight, and you promised to emcee. But first you need to find your hat.

The Legend of the Missing Hat
A tiny adventure by Adri
Release 1 / Serial number 140106 / Inform 7 build 6G60 (I6/v6.32 lib 6/12N) SD

Under the Bed
This is where you live. The rest of the room is south, and there's a particularly dusty looking corner to the east.

>make grappling hook
You tie the yarn to the shuriken, creating a grappling hook.

>i
You are carrying:
  a grappling hook

>s
Center Room
This is the dormitory room you share with your three closest friends. There is a bed to the north, a wardrobe to the east, a bookshelf to the south, a food storage area to the west and a desk to the northwest. The door to the hallway is southwest.

>sw
The door is closed.

>nw
You scurry across the room, keeping close to the walls.

Below the Desk
This is the desk area.

>throw shuriken at desk
You throw the grappling hook at the desk. It catches in the wood.

* * *

>make grappling hook
You tie the yarn to the shuriken, creating a grappling hook.

>s
Center Room
This is the dormitory room you share with your three closest friends. There is a bed to the north, a wardrobe to the east, a bookshelf to the south, a food storage area to the west and a desk to the northwest. The door to the hallway is southwest.

* * *

>nw
You scurry across the room, keeping close to the walls.

Below the Desk
This is the desk area.

>throw shuriken at ledge
You throw the grappling hook at the desk. It catches in the wood.

* * *

>l
Below the Desk
This is the desk area.

>x hook
It's a crude grappling hook, created by tying a piece of yarn around your shuriken.

>take hook
You can't reach into On the Desk.

>take flowers
You can't see any such thing.

* * *

>nw
You scurry across the room, keeping close to the walls.

Below the Desk
This is the desk area.

>throw shuriken at desk
You throw the grappling hook at the desk. It catches in the wood. You scramble up the length of yarn.

On the Desk
This is the windowsill. There is a pot here containing tiny purple flowers.

You can see a grappling hook here.

>take hook
You should leave that where it is for now.

>take flowers
You pick a handful of flowers. Taken.

* * *

>nw
You scurry across the room, keeping close to the walls.

Below the Desk
This is the desk area.

>throw hook at desk
You throw the grappling hook at the desk. It catches in the wood. You climb up the length of yarn.

On the Desk
This is the windowsill. There is a pot here containing tiny purple flowers.

You can see a grappling hook here.

>down
You slide down the length of yarn. You give the yarn a good yank and the grappling hook returns to you.

Below the Desk
This is the desk area.

* * *

The talent show is tonight, and you promised to emcee. But first you need to find your hat.

The Legend of the Missing Hat
A tiny adventure by Adri
Release 1 / Serial number 140106 / Inform 7 build 6G60 (I6/v6.32 lib 6/12N) SD

Under the Bed
This is where you live. The rest of the room is south, and there's a particularly dusty looking corner to the east.

>enter bed
You are already under the bed.

>under
That's not a verb I recognize.

>go under
You can't see any such thing.

>climb under
You can't see any such thing.

>s
Center Room
This is the dormitory room you share with your three closest friends. There is a bed to the north, a wardrobe to the east, a bookshelf to the south, a food storage area to the west and a desk to the northwest. The door to the hallway is southwest.

>n
You scurry across the room, keeping close to the walls.

Under the Bed
This is where you live. The rest of the room is south, and there's a particularly dusty looking corner to the east.

>x bed
You see the bed.

* * *

The talent show is tonight, and you promised to emcee. But first you need to find your hat.

The Legend of the Missing Hat
A tiny adventure by Adri
Release 1 / Serial number 140106 / Inform 7 build 6G60 (I6/v6.32 lib 6/12N) SD

Under the Bed
This is where you live. The rest of the room is south, and there's a particularly dusty looking corner to the east.

>s.se
Bedroom
This is the dormitory room you share with your three closest friends. There is a bed to the north, a wardrobe to the east, a bookshelf to the south, a food storage area to the west and a desk in the northwest corner.

Inside the Mouse Hole
The rest of the room is back to the northwest.

There is a mouse here, lazing around in its nest.

>x mouse
The mouse does not seem friendly.

>touch mouse
The mouse snaps at you.

>search nest
The mouse hisses at you. Maybe you can distract it somehow?

>hit mouse
The mouse snaps at you.

>attack mouse
The mouse snaps at you.

>attack mouse
The mouse snaps at you.

* * *

>x mouse
The mouse does not seem friendly.

>x nest
This is the mouse's nest. It is full of various treasures.

>search nest
The mouse hisses at you. Maybe you can distract it somehow?

>touch mouse
The mouse snaps at you.

* * *

>search nest
You find a length of yarn. Taken.

>search nest
There is nothing else there to interest you.

>x mouse
The mouse looks friendly.

* * *

>x mouse
The mouse does not seem friendly.

>eat cookie
You take a quick nibble on the cookie. It's very good, but you think you should save it.

>i
You are carrying:
  a cookie
  your shuriken

>feed
What do you want to feed the mouse?

>cookie
The mouse snaps at you.

>feed cookie to mouse
The mouse snaps at you.

* * *

>x mouse
The mouse does not seem friendly.

>feed cookie to mouse
You give the cookie to the mouse. It nibbles happily.

>x mouse
The mouse seems harmless enough.

>give shuriken to mouse
The mouse sniffs curiously at shuriken, but doesn't seem to want it.

>take mouse
I don't suppose the mouse would care for that.

>pet mouse
You give the mouse a friendly pat. It bruxes softly.

>love mouse
That's not a verb I recognize.

>hit mouse
Violence isn't the answer to this one.

* * *

>s.se
Bedroom
This is the dormitory room you share with your three closest friends. There is a bed to the north, a wardrobe to the east, a bookshelf to the south, a food storage area to the west and a desk in the northwest corner.

Inside the Mouse Hole
The rest of the room is back to the northwest.

There is a mouse here, lazing around in its nest.

>search nest
The mouse hisses at you. Maybe you can distract it somehow?

* * *

>s.se
Bedroom
This is the dormitory room you share with your three closest friends. There is a bed to the north, a wardrobe to the east, a bookshelf to the south, a food storage area to the west and a desk in the northwest corner.

Inside the Mouse Hole
The rest of the room is back to the northwest.

There is a mouse here, lazing around in its nest.

>out
Bedroom
This is the dormitory room you share with your three closest friends. There is a bed to the north, a wardrobe to the east, a bookshelf to the south, a food storage area to the west and a desk in the northwest corner. There is a mouse hole in the southeast corner of the room, next to the bookshelf.

>go out
You can't go that way.

>exit
But you aren't in anything at the moment.

* * *

>out
Bedroom
This is the dormitory room you share with your three closest friends. There is a bed to the north, a wardrobe to the east, a bookshelf to the south, a food storage area to the west and a desk in the northwest corner. There is a mouse hole in the southeast corner of the room, next to the bookshelf.

>e
You knock on the door of the wardrobe, and the blue ninja peeks his head out. 

Outside the Wardrobe
The rest of the room is west.

The tiny blue ninja stands in the doorway. He doesn't seem eager to invite you inside.

>in
You can't go that way.

* * *

The talent show is tonight, and you promised to emcee. But first you need to find your hat.

The Legend of the Missing Hat
A tiny adventure by Adri
Release 1 / Serial number 140106 / Inform 7 build 6G60 (I6/v6.32 lib 6/12N) SD

Under the Bed
This is where you live. The rest of the room is south, and there's a particularly dusty looking corner to the east.

>take
(the shuriken)
You already have that.

* * *

The talent show is tonight, and you promised to emcee. But first you need to find your hat.

The Legend of the Missing Hat
A tiny adventure by Adri
Release 1 / Serial number 140106 / Inform 7 build 6G60 (I6/v6.32 lib 6/12N) SD

Under the Bed
This is where you live. The rest of the room is south, and there's a particularly dusty looking corner to the east.

>xyzzy
Real ninjas do not use such language.

>listen
Beep beep boop beep.

>dance
There's no time for that!

>sing
Your singing is abominable.

* * *

>xyzzy
Real ninjas do not use such language.

>plugh
Real ninjas do not use such language.

>plover
Real ninjas do not use such language.

>fuck
Real adventurers do not use such language.

>curses
Quite.

>listen
You hear the distant strains of chiptune music. You have no idea where it comes from, but it follows you everywhere.

>listen to music
Bleep bleep bloop bleep.

>cut me
(with the shuriken)
That's an odd thing to do.

* * *

The talent show is tonight, and you promised to emcee. But first you need to find your hat.

The Legend of the Missing Hat
A tiny adventure by Adri
Release 1 / Serial number 140106 / Inform 7 build 6G60 (I6/v6.32 lib 6/12N) SD

Under the Bed
This is where you live. The rest of the room is south, and there's a particularly dusty looking corner to the east.

>e.x glint.throw shuriken at pearl.take all.sw.s
Far Corner of the Bed
This corner doesn't seem to get cleaned often. There is a rather large spider web stretched between the foot of the bed and the wall. Thankfully its inhabitant is nowhere to be found.

It's a pearl earring in a silver setting.

You throw the shuriken at the web, slicing easily through the sticky material. The pearl drops to the ground.

pearl: As you stoop to pick up the pearl, the spider sneaks in and fixes her web. Taken.
shuriken: Taken.

Center Room
This is the dormitory room you share with your three closest friends. There is a bed to the north, a wardrobe to the east, a bookshelf to the south, a food storage area to the west and a desk to the northwest. The door to the hallway is southwest.

You scurry across the room, keeping close to the walls.

On the Bookshelf
This is the green ninja's home. The rest of the room  is north.

The green ninja is here. He looks anxious.

>give pearl to ninja
The green ninja gives you a notebook.

[** Programming error: tried to "move" notebook to nothing **]

* * *

The talent show is tonight, and you promised to emcee. But first you need to find your hat.

The Legend of the Missing Hat
A tiny adventure by Adri
Release 1 / Serial number 140106 / Inform 7 build 6G60 (I6/v6.32 lib 6/12N) SD

Under the Bed
This is where you live. The rest of the room is south, and there's a particularly dusty looking corner to the east.

>e.x glint.throw shuriken at web.take all.sw.s
Far Corner of the Bed
This corner doesn't seem to get cleaned often. There is a rather large spider web stretched between the foot of the bed and the wall. Thankfully its inhabitant is nowhere to be found.

It's a pearl earring in a silver setting.

You throw the shuriken at the web, slicing easily through the sticky material. The pearl drops to the ground.

pearl: As you stoop to pick up the pearl, the spider sneaks in and fixes her web. Taken.
shuriken: Taken.

Center Room
This is the dormitory room you share with your three closest friends. There is a bed to the north, a wardrobe to the east, a bookshelf to the south, a food storage area to the west and a desk to the northwest. The door to the hallway is southwest.

You scurry across the room, keeping close to the walls.

On the Bookshelf
This is the green ninja's home. The rest of the room  is north.

The green ninja is here. He looks anxious.

>give notebook to ninja
(first taking the notebook)
That seems to belong to the green ninja.

>x notebook
It's a matchbook-sized notebook. The cover is studded with colorful rhinestones.

>give pearl to ninja
The green ninja gives you a notebook.

>i
You are carrying:
  a notebook
  your shuriken

>x ninja
The formerly green ninja is smiling.

>n.w
Center Room
This is the dormitory room you share with your three closest friends. There is a bed to the north, a wardrobe to the east, a bookshelf to the south, a food storage area to the west and a desk to the northwest. The door to the hallway is southwest.

You scurry across the room, keeping close to the walls.

Behind the Mini Fridge
This is the red ninja's home. The rest of the room is east.

The red ninja is here. He looks angry.

>x cookie
It's half of a chocolate chip cookie.

>x pen
You can't see any such thing.

>write
(in the notebook)
You have nothing to write with.

>write in notebook
You have nothing to write with.

>x pen
You can't see any such thing.

>give notebook to red
The red ninja doesn't seem interested.

* * *

>give pearl to ninja
The green ninja gives you a notebook.

>n.w
Center Room
This is the dormitory room you share with your three closest friends. There is a bed to the north, a wardrobe to the east, a bookshelf to the south, a food storage area to the west and a desk to the northwest. The door to the hallway is southwest.

You scurry across the room, keeping close to the walls.

Behind the Mini Fridge
This is the red ninja's home. The rest of the room is east.

The red ninja is here. He looks angry.

>give notebook to ninja
The red ninja gives you his cookie.

>x pen
It's a tiny pencil.

>x cookie
It's half of a chocolate chip cookie.

>i
You are carrying:
  a cookie
  your shuriken

* * *

The talent show is tonight, and you promised to emcee. But first you need to find your hat.

The Legend of the Missing Hat
A tiny adventure by Adri
Release 1 / Serial number 140106 / Inform 7 build 6G60 (I6/v6.32 lib 6/12N) SD

Under the Bed
This is where you live. The rest of the room is south, and there's a particularly dusty looking corner to the east.

>e.x glint.throw shuriken at web.take all.sw.s.give pearl to green
Far Corner of the Bed
This corner doesn't seem to get cleaned often. There is a rather large spider web stretched between the foot of the bed and the wall. Thankfully its inhabitant is nowhere to be found.

It's a pearl earring in a silver setting.

You throw the shuriken at the web, slicing easily through the sticky material. The pearl drops to the ground.

pearl: As you stoop to pick up the pearl, the spider sneaks in and fixes her web. Taken.
shuriken: Taken.

Center Room
This is the dormitory room you share with your three closest friends. There is a bed to the north, a wardrobe to the east, a bookshelf to the south, a food storage area to the west and a desk to the northwest. The door to the hallway is southwest.

You scurry across the room, keeping close to the walls.

On the Bookshelf
This is the green ninja's home. The rest of the room  is north.

The green ninja is here. He looks anxious.

The green ninja gives you a notebook.

>n.w.give notebook to red.e.se
Center Room
This is the dormitory room you share with your three closest friends. There is a bed to the north, a wardrobe to the east, a bookshelf to the south, a food storage area to the west and a desk to the northwest. The door to the hallway is southwest.

You scurry across the room, keeping close to the walls.

Behind the Mini Fridge
This is the red ninja's home. The rest of the room is east.

The red ninja is here. He looks angry.

The red ninja gives you his cookie.

Center Room
This is the dormitory room you share with your three closest friends. There is a bed to the north, a wardrobe to the east, a bookshelf to the south, a food storage area to the west and a desk to the northwest. The door to the hallway is southwest.

You scurry across the room, keeping close to the walls.

Inside the Mousehole
This appears to be the home of a mouse. The rest of the room is back to the northwest.

There is a mouse here, lazing around in its nest.

>give cookie to mouse
You give the cookie to the mouse. It nibbles happily.

>search nest
You find a length of yarn. Taken.

>search nest
You don't find anything else of any importance.

>pet mouse
That's not a verb I recognize.

>touch mouse
Keep your hands to yourself!

>nw.nw
Center Room
This is the dormitory room you share with your three closest friends. There is a bed to the north, a wardrobe to the east, a bookshelf to the south, a food storage area to the west and a desk to the northwest. The door to the hallway is southwest.

You scurry across the room, keeping close to the walls.

Below the Desk
This is the desk area.

>up
You can't reach that. Maybe there's another way.

>make grappling hook
You tie the yarn to the shuriken, creating a grappling hook.

>throw hook at desk
You throw the grappling hook at the desk. It catches in the wood. You scramble up the length of yarn.

On the Desk
This is the windowsill. There is a pot here containing tiny purple flowers.

You can see a grappling hook here.

>take flowers
You pick a handful of flowers. Taken.

>down
You slide down the length of yarn. You give the yarn a good yank and the grappling hook returns to you. Taken.

Below the Desk
This is the desk area.

>up
You can't reach that. Maybe there's another way.

>sw.e
You can't go that way.

You can't go that way.

>sw
You can't go that way.

>l
Below the Desk
This is the desk area.

>e
You can't go that way.

>w
You can't go that way.

>n
You can't go that way.

>s
You can't go that way.

>sw
You can't go that way.

>se
Center Room
This is the dormitory room you share with your three closest friends. There is a bed to the north, a wardrobe to the east, a bookshelf to the south, a food storage area to the west and a desk to the northwest. The door to the hallway is southwest.

>e
You scurry across the room, keeping close to the walls.

You knock on the wardrobe. The blue ninja peeks his head out. He does not invite you inside.

Outside the Wardrobe
This is the blue ninja's home. You are standing outside the wardrobe.The rest of the room is west.

The blue ninja is here. He looks sad.

>give flowers to ninja
The blue ninja doesn't seem interested.

>i
You are carrying:
  a grappling hook
  a bouquet of flowers

* * *

>i
You are carrying:
  a cookie
  your shuriken

>e
Far Corner of the Bed
This corner doesn't seem to get cleaned often. There is a rather large spider web stretched between the foot of the bed and the wall. Thankfully its inhabitant is nowhere to be found.

>sw
Center Room
This is the dormitory room you share with your three closest friends. There is a bed to the north, a wardrobe to the east, a bookshelf to the south, a food storage area to the west and a desk to the northwest. The door to the hallway is southwest.

* * *

>e
You scurry across the room, keeping close to the walls.

You knock on the wardrobe. The blue ninja peeks his head out. He does not invite you inside.

Outside the Wardrobe
This is the blue ninja's home. You are standing outside the wardrobe.The rest of the room is west.

The blue ninja is here. He looks sad.

>give flowers to ninja
The red ninja gives you back your hat. And a bow tie.

>l
Inside the Wardrobe
This is the blue ninja's home.  You are inside the wardrobe. The rest of the room is west.

The blue ninja is here. He looks happy.

>e
You can't go that way.

* * *

>w
Center Room
This is the dormitory room you share with your three closest friends. There is a bed to the north, a wardrobe to the east, a bookshelf to the south, a food storage area to the west and a desk to the northwest. The door to the hallway is southwest.

>e
You scurry across the room, keeping close to the walls.

You knock on the wardrobe. The blue ninja peeks his head out. He invites you inside.

Inside the Wardrobe
This is the blue ninja's home.  You are inside the wardrobe. The rest of the room is west.

The blue ninja is here. He looks happy.

>i
You are carrying:
  a bow tie
  a hat
  your shuriken

>wear hat
You wear the hat!

>wear bowtie
You can't see any such thing.

>wear bow tie
You wear the bow tie!

End game. Yay!

    *** You are jaunty and stylish! ***

Would you like to RESTART, RESTORE a saved game, QUIT, or UNDO the last command?

* * *

>i
You are carrying:
  a cookie
  your shuriken

>x me
You are a tiny black ninja.

>wear hat
You put on the hat.

>x me
You are a tiny black ninja. You are wearing a jaunty hat.

>remove hat
You take off the hat.

>wear bow tie
You wear the bowtie. It's just a clip-on, but maybe no one will notice.

>x me
You are a tiny black ninja. You are wearing a stylish bow tie.

>wear hat
You put on the hat.

You've found your hat and you have an awesome new bow tie. You are ready to go to the talent show.

    *** You are jaunty and stylish! ***

In that game you scored 25 out of a possible 100, in 9 turns.

Would you like to RESTART, RESTORE a saved game, QUIT, or UNDO the last command?

Please give one of the answers above.

Would you like to RESTART, RESTORE a saved game, QUIT, or UNDO the last command?

* * *

>i
You are carrying:
  a cookie
  your shuriken

>s.se
Bedroom
This is the dormitory room you share with your three closest friends. There is a bed to the north, a wardrobe to the east, a bookshelf to the south, a food storage area to the west and a desk in the northwest corner.

Inside the Mouse Hole
The rest of the room is back to the northwest.

There is a mouse here, lazing around in its nest.

>n
You can't go that way.

>nw
Bedroom
This is the dormitory room you share with your three closest friends. There is a bed to the north, a wardrobe to the east, a bookshelf to the south, a food storage area to the west and a desk in the northwest corner. There is a mouse hole in the southeast corner of the room, next to the bookshelf.

>se
Inside the Mouse Hole
The rest of the room is back to the northwest.

There is a mouse here, lazing around in its nest.

>give a mouse a cookie
You give the cookie to the mouse. It grabs it out of your hands and retreats to the corner with it.

>n
You can't go that way.

>nw
You scurry off before the mouse can ask for a glass of milk.

Bedroom
This is the dormitory room you share with your three closest friends. There is a bed to the north, a wardrobe to the east, a bookshelf to the south, a food storage area to the west and a desk in the northwest corner. There is a mouse hole in the southeast corner of the room, next to the bookshelf.

* * *

>wear hat
You put on the hat. You are jaunty!

>wear bow tie
You wear the bowtie. It's just a clip-on, but maybe no one will notice. You are also stylish!

You've found your hat and you have an awesome bow tie to match. You are ready to go to the talent show.

    *** You are jaunty and stylish! ***

In that game you scored 25 out of a possible 100, in 3 turns.

Would you like to RESTART, RESTORE a saved game, QUIT, or UNDO the last command?

* * *

>s
Bedroom
This is the dormitory room you share with your three closest friends. There is a bed to the north, a wardrobe to the east, a bookshelf to the south, a food storage area to the west and a desk in the northwest corner.

>nw
Below the Desk
You can see sunlight above you. The rest of the room is southeast.

>make grappling hook
You tie the yarn to the shuriken, creating a grappling hook.

>throw hook at desk
You throw the grappling hook at the desk. It catches in the wood. You scramble up the length of yarn.

On the Desk
Sunshine streams in through the window. There is a pot here containing tiny purple flowers.

You can see a grappling hook here.

>eat flowers
(first taking the flowers)
You pick a handful of flowers.

>take flowers
(the bouquet of flowers)
You pick a handful of flowers. You already have that.

>eat flowers
(the bouquet of flowers)
They're probably poisonous.

* * *

>make grappling hook
You tie the yarn to the shuriken, creating a grappling hook.

>throw hook up
I only understood you as far as wanting to throw the grappling hook.

* * *

>e
You knock on the door of the wardrobe, and the blue ninja peeks his head out. 

Outside the Wardrobe
The rest of the room is west.

The tiny blue ninja stands in the doorway. He doesn't seem eager to invite you inside.

>show hat to ninja
The blue ninja frowns. "I think it's somewhere in this mess. I don't feel like looking for it right now."

* * *

>s
Bedroom
This is the dormitory room you share with your three closest friends. There is a bed to the north, a wardrobe to the east, a bookshelf to the south, a food storage area to the west and a desk in the northwest corner.

>throw shuriken at ninja.throw shuriken at wardrobe.throw yarn at ninja
You can't see any such thing.

>throw shuriken at wardrobe
It's not nice to throw things.

* * *

>s
Bedroom
This is the dormitory room you share with your three closest friends. There is a bed to the north, a wardrobe to the east, a bookshelf to the south, a food storage area to the west and a desk in the northwest corner.

>make grappling hook
You tie the yarn to the shuriken, creating a grappling hook.

>throw hook at fridge
Nice try, but no.

>untie hook
You untie the yarn from the shuriken.

>nw
Below the Desk
You can see sunlight above you. The rest of the room is southeast.

>star at sunlight
That's not a verb I recognize.

>throw star at sunlight
You won't be able to retrieve that. Maybe if you tied something to it?

>make grappling hook
You tie the yarn to the shuriken, creating a grappling hook.

>throw rope at desk
You throw the grappling hook at the desk. It catches in the wood. You scramble up the length of yarn.

On the Desk
Sunlight streams in through the window. There is a pot here containing tiny purple flowers.

You can see a grappling hook here.

It's not nice to throw things.

* * *

>put shuriken on rope
You tie the yarn to the shuriken, creating a grappling hook.

>i
You are carrying:
  a grappling hook

>cut hook
(with the grappling hook)
Cutting that up would achieve little.

>take rope
You untie the yarn from the shuriken.

>cut rope
(with the shuriken)
That's a terrible idea.

>make grappling hook
You tie the yarn to the shuriken, creating a grappling hook.

>s.nw.throw hook at window
Bedroom
This is the dormitory room you share with your three closest friends. There is a bed to the north, a wardrobe to the east, a bookshelf to the south, a food storage area to the west and a desk in the northwest corner.

Below the Desk
You can see sunlight above you. The rest of the room is southeast.

You shouldn't throw that around unless you need to.

>x window
There's a window somewhere over the desk.

* * *

>s.e
Bedroom
This is the dormitory room you share with your three closest friends. There is a bed to the north, a wardrobe to the east, a bookshelf to the south, a food storage area to the west and a desk in the northwest corner.

You knock on the door of the wardrobe, and the blue ninja peeks his head out. 

Outside the Wardrobe
The rest of the room is west.

The tiny blue ninja stands in the doorway. He doesn't seem eager to invite you inside.

>throw shruiekn at ninja.throw shuriken at wardrobe
You can't see any such thing.

>throw star at ninja
It's very sharp. You really shouldn't throw it around like that.

>throw star at closet
It's very sharp. You really shouldn't throw it around like that.

* * *

>e
Far Corner of the Bed
This corner doesn't seem to get cleaned often. There is a rather large spider web stretched between the foot of the bed and the wall. Thankfully its inhabitant is nowhere to be found. The rest of the room is southwest.

>throw star at me.throw star at rope.throw star at web
Your juggling act needs some work.

That's an awkward thing to do.

Why don't you look more closely at the web before you destroy it?

>throw yarn at me.throw yarn at star.throw yarn at web
Your juggling act needs some work.

That's an awkward thing to do.

It might get stuck. Maybe you have something else you can use?

>look closely
(at the web)
You peer more closely at the web. There is a pearl earring stuck in the web.

>throw star at web
You throw the shuriken at the web, slicing easily through the sticky material. The pearl drops to the ground.

>take all
pearl: As you stoop to pick up the pearl, the spider sneaks in and fixes its web. Taken.
shuriken: Taken.

>sw.e
Bedroom
This is the dormitory room you share with your three closest friends. There is a bed to the north, a wardrobe to the east, a bookshelf to the south, a food storage area to the west and a desk in the northwest corner.

You knock on the door of the wardrobe, and the blue ninja peeks his head out. 

Outside the Wardrobe
The rest of the room is west.

The tiny blue ninja stands in the doorway. He doesn't seem eager to invite you inside.

>throw star at ninja.throw yarn at ninja
That might be construed as an attack.

That might be construed as an attack.

>throw star at wardrobe.throw yarn at wardrobe
It's very sharp. You really shouldn't throw it around like that.

It's not nice to throw things.

>w.se
Bedroom
This is the dormitory room you share with your three closest friends. There is a bed to the north, a wardrobe to the east, a bookshelf to the south, a food storage area to the west and a desk in the northwest corner.

Inside the Mouse Hole
The rest of the room is back to the northwest.

There is a mouse here, lazing around in its nest.

>throw star at mouse.throw yarn at mouse
Surely there's a better way to resolve this.

Surely there's a better way to resolve this.

>nw.nw
Bedroom
This is the dormitory room you share with your three closest friends. There is a bed to the north, a wardrobe to the east, a bookshelf to the south, a food storage area to the west and a desk in the northwest corner. There is a mouse hole in the southeast corner of the room, next to the bookshelf.

Below the Desk
You can see sunlight above you. The rest of the room is southeast.

>throw star at desk
You won't be able to retrieve that. Maybe if you tied something to it?

It's not nice to throw things.

>drop shuriken
Maybe you should try throwing it at something.

* * *

>e
Far Corner of the Bed
This corner doesn't seem to get cleaned often. There is a rather large spider web stretched between the foot of the bed and the wall. Thankfully its inhabitant is nowhere to be found. The rest of the room is southwest.

>x glint.throw star at web.throw star at spider.throw yarn at spider
It's a pearl earring in a silver setting. It's about the size of your head.

You throw the shuriken at the web, slicing easily through the sticky material. The pearl drops to the ground.

(first taking the shuriken)
You can't see that here. Thankfully.

You can't see that here. Thankfully.

>x spider
You can't see that here. Thankfully.

>take pearl.x spider.throw yarn at spider.throw star at spider.
As you stoop to pick up the pearl, the spider sneaks in and fixes its web. Taken.

The spider seems to have vanished again.

You can't see that here. Thankfully.

You can't see that here. Thankfully.

>throw star at web.g
You throw the shuriken at the web, slicing easily through the sticky material.

The spider comes out, shakes several fists at you, and repairs the web. It slips off again.

(first taking the shuriken)
You throw the shuriken at the web, slicing easily through the sticky material.

*** The spider bites you. You die. ***

Not really. But knock it off.

>throw shuriken at spider.throw yarn at spider.cut web
(first taking the shuriken)
The spider bares its fangs at you. You decide to leave it alone.

The spider bares its fangs at you. You decide to leave it alone.

(with the shuriken)
The spider bares its fangs at you. You decide to leave it alone.

>x spider
It's a common house spider. It's not very large, but it looks like it won't hesitate to kill you if you try to destroy its web again.

>w.s.e
Under the Bed
This is where you live. The rest of the room is south, and there's a particularly dusty looking corner to the east.

Bedroom
This is the dormitory room you share with your three closest friends. There is a bed to the north, a wardrobe to the east, a bookshelf to the south, a food storage area to the west and a desk in the northwest corner.

You knock on the door of the wardrobe, and the blue ninja peeks his head out. 

Outside the Wardrobe
The rest of the room is west.

The tiny blue ninja stands in the doorway. He doesn't seem eager to invite you inside.

>throw star at ninja.throw yarn at ninja
That might be construed as an attack.

That might be construed as an attack.

>throw star at me.throw yarn at me.throw star at yarn.throw yarn at star
Your juggling act needs some work.

Your juggling act needs some work.

That's an awkward thing to do.

That's an awkward thing to do.

>throw star at wardrobe.throw yarn at closet
It's very sharp. You really shouldn't throw it around like that.

It's not nice to throw things.

>w.nw
Bedroom
This is the dormitory room you share with your three closest friends. There is a bed to the north, a wardrobe to the east, a bookshelf to the south, a food storage area to the west and a desk in the northwest corner.

Below the Desk
You can see sunlight above you. The rest of the room is southeast.

>throw star at window.throw yarn at window
You won't be able to retrieve that. Maybe if you tied something to it?

You can't seem to throw the yarn that high. Maybe if you tied it to something?

>make grappling hook
You tie the yarn to the shuriken, creating a grappling hook.

>throw yarn at desk
You throw the grappling hook at the desk. It catches in the wood. You scramble up the length of yarn.

On the Desk
Sunlight streams in through the window. There is a pot here containing tiny purple flowers.

You can see a grappling hook here.

>throw yarn
You haven't got that.

>throw yarn at window
(first taking the grappling hook)
You should leave that where it is. You'll need it to climb back down.

>down
You slide down the length of yarn. You give the yarn a good yank and the grappling hook returns to you.

Below the Desk
You can see sunlight above you. The rest of the room is southeast.

>se
Bedroom
This is the dormitory room you share with your three closest friends. There is a bed to the north, a wardrobe to the east, a bookshelf to the south, a food storage area to the west and a desk in the northwest corner.

>throw hook at fridge
Nice try, but no.

>w.throw hook at fridge
Behind the Mini Fridge
The rest of the room is east.

The tiny red ninja is here, nibbling anxiously on a cookie. He seems angry.

Nice try, but no.

* * *

>s.nw
Bedroom
This is the dormitory room you share with your three closest friends. There is a bed to the north, a wardrobe to the east, a bookshelf to the south, a food storage area to the west and a desk in the northwest corner.

Below the Desk
You can see sunlight above you. The rest of the room is southeast.

>throw star at desk
You won't be able to retrieve that. Maybe if you tied something to it?

>throw star at window.throw star at ledge
You won't be able to retrieve that. Maybe if you tied something to it?

You won't be able to retrieve that. Maybe if you tied something to it?

>throw yarn at window
You can't seem to throw the yarn that high. Maybe if you tied it to something?

It's not nice to throw things.

* * *

>s.nw.throw yarn at window
Bedroom
This is the dormitory room you share with your three closest friends. There is a bed to the north, a wardrobe to the east, a bookshelf to the south, a food storage area to the west and a desk in the northwest corner.

Below the Desk
You can see sunlight above you. The rest of the room is southeast.

You can't seem to throw the yarn that high. Maybe if you tied it to something?

>se.w
Bedroom
This is the dormitory room you share with your three closest friends. There is a bed to the north, a wardrobe to the east, a bookshelf to the south, a food storage area to the west and a desk in the northwest corner.

Behind the Mini Fridge
The rest of the room is east.

The tiny red ninja is here, nibbling anxiously on a cookie. He seems angry.

>throw yarn at ninja.throw yarn at fridge
That might be construed as an attack.

It's not nice to throw things.

>e
Bedroom
This is the dormitory room you share with your three closest friends. There is a bed to the north, a wardrobe to the east, a bookshelf to the south, a food storage area to the west and a desk in the northwest corner.

>make grappling hook
You tie the yarn to the shuriken, creating a grappling hook.

>throw hook at fridge
Nice try, but no.

It's not nice to throw things.

* * *

>throw star at me.throw star at yarn.throw star at bed
Your juggling act needs some work.

That's an awkward thing to do.

It's very sharp. You really shouldn't throw it around like that.

>throw yarn
Dropped.

>take yarn
Taken.

>s.e
Bedroom
This is the dormitory room you share with your three closest friends. There is a bed to the north, a wardrobe to the east, a bookshelf to the south, a food storage area to the west and a desk in the northwest corner.

You knock on the door of the wardrobe, and the blue ninja peeks his head out. 

Outside the Wardrobe
The rest of the room is west.

The tiny blue ninja stands in the doorway. He doesn't seem eager to invite you inside.

>throw star at ninja.throw yarn at ninja
That might be construed as an attack.

That might be construed as an attack.

>throw star at wardrobe.throw yarn at wardrobe
It's very sharp. You really shouldn't throw it around like that.

>i
You are carrying:
  a length of yarn
  your shuriken

* * *

>make grappling hook
You tie the yarn to the shuriken, creating a grappling hook.

>s.throw yarn at fridge
Bedroom
This is the dormitory room you share with your three closest friends. There is a bed to the north, a wardrobe to the east, a bookshelf to the south, a food storage area to the west and a desk in the northwest corner.

Nice try, but no.

>w.throw hook at fridge
Behind the Mini Fridge
The rest of the room is east.

The tiny red ninja is here, nibbling anxiously on a cookie. He seems angry.

It's very sharp. You really shouldn't throw it around like that.

>take yarn
You untie the yarn from the shuriken.

>throw yarn at fridge
It's not nice to throw things.

>e.ne
Bedroom
This is the dormitory room you share with your three closest friends. There is a bed to the north, a wardrobe to the east, a bookshelf to the south, a food storage area to the west and a desk in the northwest corner.

Far Corner of the Bed
This corner doesn't seem to get cleaned often. There is a rather large spider web stretched between the foot of the bed and the wall. Thankfully its inhabitant is nowhere to be found. The rest of the room is southwest.

>throw yarn at web
It might get stuck. Maybe you have something else you can use?

* * *

>xyzzy
Real ninjas do not use such language.

>s.nw
Bedroom
This is the dormitory room you share with your three closest friends. There is a bed to the north, a wardrobe to the east, a bookshelf to the south, a food storage area to the west and a desk in the northwest corner.

Below the Desk
You can see sunlight above you. The rest of the room is southeast.

>look up
You see on the desk in that direction.

>x window
There's a window somewhere over the desk.

>x desk
There is a window above the desk.

* * *

>take bouquet
You can't see any such thing.

>take flowers
You pick a handful of flowers. Taken.

>take flowers
(the bouquet of flowers)
You pick a handful of flowers. You already have that.

* * *

>take flowers
You pick a handful of flowers.

>take flowers
(the bouquet of flowers)
You already have that.

>drop bouquet
Dropped.

>take bouquet
Taken.

* * *

>x pot.x flowers.take flowers.x bouquet
You can't see any such thing.

* * *

>x flowers.x pot.take flowers.take flowers.x flowers
They're tiny purple flowers. You don't know what they're called.

It's a pot containing tiny purple flowers.

You pick a handful of flowers.

(the bouquet of flowers)
You already have that.

(the bouquet of flowers)
It's a bunch of tiny purple flowers.

>climb
What do you want to climb?

* * *

>climb down
It's a far way down. Maybe there's another way.

>climb e
You can't go that way.

>climb
What do you want to climb?

* * *

>search hat
You find a tiny rabbit. No, actually you don't. You're not a magician.

>xyzzy
Real ninjas do not use such language.

>listen
You hear the distant strains of chiptune music. You have no idea where it comes from, but it follows you everywhere.

* * *

>throw star up.throw hat up
I only understood you as far as wanting to throw the shuriken.

I only understood you as far as wanting to throw the shuriken.

>s.nw.throw hat up.throw star up
Bedroom
This is the dormitory room you share with your three closest friends. There is a bed to the north, a wardrobe to the east, a bookshelf to the south, a food storage area to the west and a desk in the northwest corner.

Below the Desk
You can see sunlight above you. The rest of the room is southeast.

I only understood you as far as wanting to throw the shuriken.

You won't be able to retrieve that. Maybe if you tied something to it?

>throw star at desk.throw star on desk
You won't be able to retrieve that. Maybe if you tied something to it?

Putting things on the desk would achieve nothing.

* * *

>throw shuriken up
I only understood you as far as wanting to throw the shuriken.

>throw rope up
I only understood you as far as wanting to throw the shuriken.

* * *

>l
Under the Bed
This is where you live. The rest of the room is south, and there's a particularly dusty looking corner to the east.

The tiny green ninja is pacing back and forth.

The tiny red ninja is here, nibbling anxiously on a cookie. He seems angry.

The tiny blue ninja stands in the doorway. He doesn't seem eager to invite you inside.

>talk to green
The green ninja sulks. "My friend just got this really sparkly rock. It's so pretty. I don't have anything that nice. The prettiest thing I have is this stupid notebook."

>talk to green sak green about hat
I only understood you as far as wanting to talk to the green ninja.

>ask green about hat
The green ninja thinks for a moment. He says, "I think the blue ninja borrowed it for his Halloween costume."

>hug me.hug green.hug red.hug blue
You give yourself a quick hug. You feel better.

You try to hug the green ninja, but he pushes you away.

You try to hug the red ninja, but he pushes you away.

You try to hug the blue ninja, but he pushes you away.

>ask
(about the shuriken)
The green ninja shakes his head.

>ask for
(the shuriken)
The green ninja does not respond.

>ask green
(for the hat)
The green ninja thinks for a moment. He says, "I think the blue ninja borrowed it for his Halloween costume."

* * *

>ask red about anger
There is no reply.

>i
You are carrying:
  your shuriken

>l
Under the Bed
This is where you live. The rest of the room is south, and there's a particularly dusty looking corner to the east.

The tiny green ninja is pacing back and forth.

The tiny red ninja is here, nibbling anxiously on a cookie. He seems angry.

The tiny blue ninja stands in the doorway. He doesn't seem eager to invite you inside.

* * *

>s.w.show hat to red.e.e.show hat to blue.w.s.show hat to green.n.se.show hat to mouse
Bedroom
This is the dormitory room you share with your three closest friends. There is a bed to the north, a wardrobe to the east, a bookshelf to the south, a food storage area to the west and a desk in the northwest corner.

Behind the Mini Fridge
The rest of the room is east.

The tiny red ninja is here, nibbling anxiously on a cookie. He seems angry.

The red ninja shrugs. "I haven't seen it. Maybe someone borrowed it?"

Bedroom
This is the dormitory room you share with your three closest friends. There is a bed to the north, a wardrobe to the east, a bookshelf to the south, a food storage area to the west and a desk in the northwest corner.

You knock on the door of the wardrobe, and the blue ninja peeks his head out. 

Outside the Wardrobe
The rest of the room is west.

The tiny blue ninja stands in the doorway. He doesn't seem eager to invite you inside.

The blue ninja frowns. "I think it's somewhere in this mess. I don't feel like looking for it right now."

Bedroom
This is the dormitory room you share with your three closest friends. There is a bed to the north, a wardrobe to the east, a bookshelf to the south, a food storage area to the west and a desk in the northwest corner.

As you approach the bookshelf, you notice a mouse hole to the left of it, in the southeast corner of the room.

On the Bookshelf
The rest of the room is north.

The tiny green ninja is pacing back and forth.

The green ninja thinks for a moment. He says, "I think the blue ninja borrowed it for his Halloween costume."

Bedroom
This is the dormitory room you share with your three closest friends. There is a bed to the north, a wardrobe to the east, a bookshelf to the south, a food storage area to the west and a desk in the northwest corner.

Inside the Mouse Hole
The rest of the room is back to the northwest.

There is a mouse here, lazing around in its nest.

The mouse seems vaguely impressed.

* * *

The talent show is tonight, and you promised to emcee. But first you need to find your hat.

The Legend of the Missing Hat
A tiny adventure by Adri
Release 1 / Serial number 140106 / Inform 7 build 6G60 (I6/v6.32 lib 6/12N) SD

Under the Bed
This is where you live. The rest of the room is south, and there's a particularly dusty looking corner to the east.

>tie
(the shuriken to the shuriken)
You would achieve nothing by this.

* * *

>s
Center Room
This is the dormitory room you share with your three closest friends. There is a bed to the north, a wardrobe to the east, a bookshelf to the south, a food storage area to the west and a desk to the northwest. The door to the hallway is southwest.

* * *

>give flowers to ninja
The red ninja gives you back your hat. And a bow tie.

>x tie
It's a polka-dotted bow tie.

>wear all
You can't use multiple objects with that verb.

* * *

The talent show is tonight, and you promised to emcee. But first you need to find your hat.

The Legend of the Missing Hat
A tiny adventure by Adri
Release 1 / Serial number 140106 / Inform 7 build 6G60 (I6/v6.32 lib 6/12N) SD

Under the Bed
This is where you live. The rest of the room is south, and there's a particularly dusty looking corner to the east.

>x me
You are a tiny black ninja.

>i
You are carrying:
  your shuriken

>x shuriken
It's a tiny, four-pointed throwing star.

* * *

The talent show is tonight, and you promised to emcee. But first you need to find your hat.

The Legend of the Missing Hat
A tiny adventure by Adri
Release 1 / Serial number 140106 / Inform 7 build 6G60 (I6/v6.32 lib 6/12N) SD

Under the Bed
This is where you live. The rest of the room is south, and there's a particularly dusty looking corner to the east.

>transcript on
Cannot open file
Attempt to begin transcript failed.

* * *

The talent show is tonight, and you promised to emcee. But first you need to find your hat.

The Legend of the Missing Hat
A tiny adventure by Adri
Release 1 / Serial number 140106 / Inform 7 build 6G60 (I6/v6.32 lib 6/12N) SD

Under the Bed
This is where you live. The rest of the room is south, and there's a particularly dusty looking corner to the east.

>about
"The Legend of the Missing Hat" was written for Cover Stories, a minicomp organized by Sam Kabo Ashwell. The cover art was supplied by Justin de Vesine, and I offer my deepest apologies if the resulting game isn't what he hoped for. Thanks so much to my beta testers: Andrew Plotkin, Andrew Schultz, Ed Blair, Felix Pleoianu, Jacques Frechet, Kevin Jackson-Mead, Marius Mller and Matthew Miller.

>xyzzy
You hear the distant strains of chiptune music. You have no idea where it comes from, but it follows you everywhere.

* * *

The talent show is tonight, and you promised to emcee. But first you need to find your hat.

The Legend of the Missing Hat
A tiny adventure by Adri
Release 1 / Serial number 140106 / Inform 7 build 6G60 (I6/v6.32 lib 6/12N) SD

Under the Bed
This is where you live. The rest of the room is south, and there's a particularly dusty looking corner to the east.

>l
Under the Bed
This is where you live. The rest of the room is south, and there's a particularly dusty looking corner to the east.

>x me
You are a tiny black ninja.

* * *

The talent show is tonight, and you promised to emcee. But first you need to find your hat.

The Legend of the Missing Hat
A tiny adventure by Adri
Release 1 / Serial number 140106 / Inform 7 build 6G60 (I6/v6.32 lib 6/12N) SD

Under the Bed
This is where you live. The rest of the room is south, and there's a particularly dusty looking corner to the east.

>talk
(to yourself)
You mumble incoherently to yourself.

>talk to me
You mumble incoherently to yourself.

>talk to myself
You mumble incoherently to yourself.

>s
Bedroom
This is the dormitory room you share with your three closest friends. There is a bed to the north, a wardrobe to the east, a bookshelf to the south, a food storage area to the west and a desk to the northwest. The door to the hallway is southwest.

>s
On the Bookshelf
The rest of the room is north.

The tiny green ninja is pacing back and forth.

>tell ninja about perl
The green ninja doesn't seem to care about that.

>s
You can't go that way.

>n
Bedroom
This is the dormitory room you share with your three closest friends. There is a bed to the north, a wardrobe to the east, a bookshelf to the south, a food storage area to the west and a desk to the northwest. The door to the hallway is southwest.

>ne
Far Corner of the Bed
This corner doesn't seem to get cleaned often. There is a rather large spider web stretched between the foot of the bed and the wall. Thankfully its inhabitant is nowhere to be found. The rest of the room is southwest.

>sw
Bedroom
This is the dormitory room you share with your three closest friends. There is a bed to the north, a wardrobe to the east, a bookshelf to the south, a food storage area to the west and a desk to the northwest. The door to the hallway is southwest.

>nw
Below the Desk
You can see sunlight above you. The rest of the room is southeast.

>x sunlight
You can't see any such thing.

>x desk
There is a window above the desk.

>x window
You can't see any such thing.

* * *

The talent show is tonight, and you promised to emcee. But first you need to find your hat.

The Legend of the Missing Hat
A tiny adventure by Adri
Release 1 / Serial number 140106 / Inform 7 build 6G60 (I6/v6.32 lib 6/12N) SD

Under the Bed
This is where you live. The rest of the room is south, and there's a particularly dusty looking corner to the east.

>n
You can't go that way.

>s
Bedroom
This is the dormitory room you share with your three closest friends. There is a bed to the north, a wardrobe to the east, a bookshelf to the south, a food storage area to the west and a desk to the northwest. The door to the hallway is southwest.

* * *

The talent show is tonight, and you promised to emcee. But first you need to find your hat.

The Legend of the Missing Hat
A tiny adventure by Adri
Release 1 / Serial number 140106 / Inform 7 build 6G60 (I6/v6.32 lib 6/12N) SD

Under the Bed
This is where you live. The rest of the room is south, and there's a particularly dusty looking corner to the east.

I beg your pardon?

I beg your pardon?

* * *

>i
You are carrying:
  a bow tie
  a hat
  your shuriken

>x me
You are a tiny black ninja.

* * *

>wear hat
You put on the hat.

>x me
You are a tiny black ninja. You are jaunty.

* * *

>cut web
(with the shuriken)
You throw the shuriken at the web, slicing easily through the sticky material. The pearl drops to the ground.

>x spider
The spider seems to have vanished again.

You can't see that here. Thankfully.

* * *

The talent show is tonight, and you promised to emcee. But first you need to find your hat.

The Legend of the Missing Hat
A tiny adventure by Adri
Release 1 / Serial number 140106 / Inform 7 build 6G60 (I6/v6.32 lib 6/12N) SD

Under the Bed
This is where you live. The rest of the room is south, and there's a particularly dusty looking corner to the east.

>e.x glint.throw shuriken at web.take pearl.sw.s.hug ninja
Far Corner of the Bed
This corner doesn't seem to get cleaned often. There is a rather large spider web stretched between the foot of the bed and the wall. Thankfully its inhabitant is nowhere to be found. The rest of the room is southwest.

It's a pearl earring in a silver setting. It's about the size of your head.

You throw the shuriken at the web, slicing easily through the sticky material. The pearl drops to the ground.

As you stoop to pick up the pearl, the spider sneaks in and fixes her web. Taken.

You pause to retrieve your shuriken. Taken.

Bedroom
This is the dormitory room you share with your three closest friends. There is a bed to the north, a wardrobe to the east, a bookshelf to the south, a food storage area to the west and a desk to the northwest. The door to the hallway is southwest.

On the Bookshelf
The rest of the room is north.

The tiny green ninja is pacing back and forth.

You try to hug the green ninja, but he pushes you away.

>give pearl to ninja.hug pearl
The green ninja oohs and ahhs over the pearl. He gives you a notebook.  "Here. I don't need this anymore. It's just cheap junk."

[Your score has just gone up by twenty-five points.]

You can only do that to something animate.

>hug me
You try to hug yourself, but he pushes you away.

* * *

The talent show is tonight, and you promised to emcee. But first you need to find your hat.

The Legend of the Missing Hat
A tiny adventure by Adri
Release 1 / Serial number 140106 / Inform 7 build 6G60 (I6/v6.32 lib 6/12N) SD

Under the Bed
This is where you live. The rest of the room is south, and there's a particularly dusty looking corner to the east.

>hug me
You give yourself a quick hug. You feel better.

* * *

The talent show is tonight, and you promised to emcee. But first you need to find your hat.

The Legend of the Missing Hat
A tiny adventure by Adri
Release 1 / Serial number 140106 / Inform 7 build 6G60 (I6/v6.32 lib 6/12N) SD

Under the Bed
This is where you live. The rest of the room is south, and there's a particularly dusty looking corner to the east.

>x bookshelf
You can't see any such thing.

>s
Bedroom
This is the dormitory room you share with your three closest friends. There is a bed to the north, a wardrobe to the east, a bookshelf to the south, a food storage area to the west and a desk in the northwest corner

>x bookshelf
The bookshelf is piled high with books and knicknacks. The green ninja lives on the bottom shelf, behind a row of textbooks. You can see a mouse hole to the left of the bookshelf.

>x mousehole
There is a mouse hole in the southeast corner of the room. You can't see inside from here.

* * *

The talent show is tonight, and you promised to emcee. But first you need to find your hat.

The Legend of the Missing Hat
A tiny adventure by Adri
Release 1 / Serial number 140106 / Inform 7 build 6G60 (I6/v6.32 lib 6/12N) SD

Under the Bed
This is where you live. The rest of the room is south, and there's a particularly dusty looking corner to the east.

>look s
The Bedroom lies in that direction.

>s
Bedroom
This is the dormitory room you share with your three closest friends. There is a bed to the north, a wardrobe to the east, a bookshelf to the south, a food storage area to the west and a desk in the northwest corner

>look s
The rest of the room is north.

>look n
This is where you live. The rest of the room is south, and there's a particularly dusty looking corner to the east.

* * *

>look s
The Bedroom lies in that direction.

>look n
You can't see anything promising that way.

>look e
The Far Corner of the Bed lies in that direction.

>x e
You see nothing unexpected in that direction.

>look me
You are a tiny black ninja.

* * *

>look s
The Bedroom lies in that direction.

>x s
Two

* * *

The talent show is tonight, and you promised to emcee. But first you need to find your hat.

The Legend of the Missing Hat
A tiny adventure by Adri
Release 1 / Serial number 140106 / Inform 7 build 6G60 (I6/v6.32 lib 6/12N) SD

Under the Bed
This is where you live. The rest of the room is south, and there's a particularly dusty looking corner to the east.

>xn
That's not a verb I recognize.

>x n
Two

>x s
Two

* * *

The talent show is tonight, and you promised to emcee. But first you need to find your hat.

The Legend of the Missing Hat
A tiny adventure by Adri
Release 1 / Serial number 140106 / Inform 7 build 6G60 (I6/v6.32 lib 6/12N) SD

Under the Bed
This is where you live. The rest of the room is south, and there's a particularly dusty looking corner to the east.

>x s
You see the bedroom in that direction.

>x n
You can't see anything in that direction.

>x e
The Far Corner of the Bed lies in that direction.

>s
Bedroom
This is the dormitory room you share with your three closest friends. There is a bed to the north, a wardrobe to the east, a bookshelf to the south, a food storage area to the west and a desk in the northwest corner

>x s
The On the Bookshelf lies in that direction.

* * *

>x n
You can't see anything in that direction.

>s
Bedroom
This is the dormitory room you share with your three closest friends. There is a bed to the north, a wardrobe to the east, a bookshelf to the south, a food storage area to the west and a desk in the northwest corner

>x n
You can see Under the Bed in that direction.

* * *

>x s
You see the bedroom in that direction.

>look s
You can see the Bedroom in that direction.

>s
Bedroom
This is the dormitory room you share with your three closest friends. There is a bed to the north, a wardrobe to the east, a bookshelf to the south, a food storage area to the west and a desk in the northwest corner

>x n
You can see the bed in that direction.

>x bed
*** Run-time problem P47 (at paragraph 42 in the source text): Phrase applied to an incompatible kind of value.

You can't see anything in that direction.

You must supply a noun.

* * *

>x s
You see the bedroom in that direction.

>look x
You can't see any such thing.

>look s
You can see the Bedroom in that direction.

>look e
You can see the Far Corner of the Bed in that direction.

>s
Bedroom
This is the dormitory room you share with your three closest friends. There is a bed to the north, a wardrobe to the east, a bookshelf to the south, a food storage area to the west and a desk in the northwest corner

>look n
North

>look e
North

* * *

>x s
You see the bedroom in that direction.

>s
Bedroom
This is the dormitory room you share with your three closest friends. There is a bed to the north, a wardrobe to the east, a bookshelf to the south, a food storage area to the west and a desk in the northwest corner

>x n
*** Run-time problem P47 (at paragraph 50 in the source text): Phrase applied to an incompatible kind of value.

You can't see anything in that direction.

* * *

>x s
You see the bedroom in that direction.

>x e
You see the far corner of the bed in that direction.

>x up
You can't see anything in that direction.

>s
Bedroom
This is the dormitory room you share with your three closest friends. There is a bed to the north, a wardrobe to the east, a bookshelf to the south, a food storage area to the west and a desk in the northwest corner

>x n
*** Run-time problem P47 (at paragraph 42 in the source text): Phrase applied to an incompatible kind of value.

You can't see anything in that direction.

* * *

>x e
You see the far corner of the bed in that direction.

>x n
You see nothing special in that direction.

>s
Bedroom
This is the dormitory room you share with your three closest friends. There is a bed to the north, a wardrobe to the east, a bookshelf to the south, a food storage area to the west and a desk in the northwest corner

>x n
You see a door in that direction, leading to Under the Bed.

>x bed
The bed is unmade, as always. You live underneath it.

>n
Under the Bed
This is where you live. The rest of the room is south, and there's a particularly dusty looking corner to the east.

>x bed
You look up at the underside of the bed. It's not very interesting.

>x s
You see a door in that direction, leading to the Bedroom.

* * *

>x e
You see the far corner of the bed in that direction.

>s
Bedroom
This is the dormitory room you share with your three closest friends. There is a bed to the north, a wardrobe to the east, a bookshelf to the south, a food storage area to the west and a desk in the northwest corner

>x n
You see under the bed in that direction.

>x bed
The bed is unmade, as always. You live underneath it.

* * *

>x s
You see the bedroom in that direction.

>x bed
You look up at the underside of the bed. It's not very interesting.

>s
Bedroom
This is the dormitory room you share with your three closest friends. There is a bed to the north, a wardrobe to the east, a bookshelf to the south, a food storage area to the west and a desk in the northwest corner

>x bed
North

>x n
You see nothing unexpected in that direction.

* * *

>x bed
North

>x north
North

* * *

The talent show is tonight, and you promised to emcee. But first you need to find your hat.

The Legend of the Missing Hat
A tiny adventure by Adri
Release 1 / Serial number 140106 / Inform 7 build 6G60 (I6/v6.32 lib 6/12N) SD

Under the Bed
This is where you live. The rest of the room is south, and there's a particularly dusty looking corner to the east.

>x bed
You look up at the underside of the bed. It's not very interesting.

* * *

The talent show is tonight, and you promised to emcee. But first you need to find your hat.

The Legend of the Missing Hat
A tiny adventure by Adri
Release 1 / Serial number 140106 / Inform 7 build 6G60 (I6/v6.32 lib 6/12N) SD

Under the Bed
This is where you live. The rest of the room is south, and there's a particularly dusty looking corner to the east.

>x north
You see nothing unexpected in that direction.

>x bed
You look up at the underside of the bed. It's not very interesting.

* * *

>s
Bedroom
This is the dormitory room you share with your three closest friends. There is a bed to the north, a wardrobe to the east, a bookshelf to the south, a food storage area to the west and a desk in the northwest corner

>x north
You see nothing unexpected in that direction.

* * *

The talent show is tonight, and you promised to emcee. But first you need to find your hat.

The Legend of the Missing Hat
A tiny adventure by Adri
Release 1 / Serial number 140106 / Inform 7 build 6G60 (I6/v6.32 lib 6/12N) SD

Under the Bed
This is where you live. The rest of the room is south, and there's a particularly dusty looking corner to the east.

>x
(the shuriken)
It's a tiny, four-pointed throwing star.

>x s
You see the bedroom in that direction.

* * *

>x e
You see the far corner of the bed in that direction.

>x bed
You look up at the underside of the bed. It's not very interesting.

* * *

>s
Bedroom
This is the dormitory room you share with your three closest friends. There is a bed to the north, a wardrobe to the east, a bookshelf to the south, a food storage area to the west and a desk in the northwest corner

>x n
The bed is unmade, as always. You live underneath it.

>x bed
The bed is unmade, as always. You live underneath it.

>x s
The bookshelf is piled high with books and knicknacks. The green ninja lives on the bottom shelf, behind a row of textbooks. You can see a mouse hole to the left of the bookshelf, in the southeast corner of the room.

>x se
There is a mouse hole in the southeast corner of the room. You can't see inside from here.

>x mouse hole
There is a mouse hole in the southeast corner of the room. You can't see inside from here.

* * *

The talent show is tonight, and you promised to emcee. But first you need to find your hat.

The Legend of the Missing Hat
A tiny adventure by Adri
Release 1 / Serial number 140106 / Inform 7 build 6G60 (I6/v6.32 lib 6/12N) SD

Under the Bed
This is where you live. The rest of the room is south, and there's a particularly dusty looking corner to the east.

>damage
(the shuriken)
Violence isn't the answer to this one.

>damage it
That's not a verb I recognize.

* * *

>damage
(the shuriken)
Violence isn't the answer to this one.

>cut
(the shuriken with the shuriken)
Cutting that up would achieve little.

* * *

>damage
(the shuriken)
Violence isn't the answer to this one.

>damage web
You can't see any such thing.

>e
Far Corner of the Bed
This corner doesn't seem to get cleaned often. There is a rather large spider web stretched between the foot of the bed and the wall. Thankfully its inhabitant is nowhere to be found. The rest of the room is southwest.

>damage web
You don't want to touch that with your bare hands.

>attack web
You don't want to touch that with your bare hands.

>attack web with shuriken
I only understood you as far as wanting to attack the web.

* * *

The talent show is tonight, and you promised to emcee. But first you need to find your hat.

The Legend of the Missing Hat
A tiny adventure by Adri
Release 1 / Serial number 140106 / Inform 7 build 6G60 (I6/v6.32 lib 6/12N) SD

Under the Bed
This is where you live. The rest of the room is south, and there's a particularly dusty looking corner to the east.

>drop shuriken.cut me
Dropped.

(with the shuriken)
That's an odd thing to do.

>e.cut me
You pause to retrieve your shuriken. Taken.

Far Corner of the Bed
This corner doesn't seem to get cleaned often. There is a rather large spider web stretched between the foot of the bed and the wall. Thankfully its inhabitant is nowhere to be found. The rest of the room is southwest.

(with the shuriken)
That's an odd thing to do.

>x glint.x web.x spider
It's a pearl earring in a silver setting. It's about the size of your head.

On the web is a pearl.

You can't see that here. Thankfully.

>x glint
It's a pearl earring in a silver setting. It's about the size of your head.

>x web
On the web is a pearl.

* * *

The talent show is tonight, and you promised to emcee. But first you need to find your hat.

The Legend of the Missing Hat
A tiny adventure by Adri
Release 1 / Serial number 140106 / Inform 7 build 6G60 (I6/v6.32 lib 6/12N) SD

Under the Bed
This is where you live. The rest of the room is south, and there's a particularly dusty looking corner to the east.

>e.x glint.x web.x spider
Far Corner of the Bed
This corner doesn't seem to get cleaned often. There is a rather large spider web stretched between the foot of the bed and the wall. Thankfully its inhabitant is nowhere to be found. The rest of the room is southwest.

It's a pearl earring in a silver setting. It's about the size of your head.

On the web is a pearl.

You can't see that here. Thankfully.

* * *

The talent show is tonight, and you promised to emcee. But first you need to find your hat.

The Legend of the Missing Hat
A tiny adventure by Adri
Release 1 / Serial number 140106 / Inform 7 build 6G60 (I6/v6.32 lib 6/12N) SD

Under the Bed
This is where you live. The rest of the room is south, and there's a particularly dusty looking corner to the east.

>e.x web.x glint.x spider
Far Corner of the Bed
This corner doesn't seem to get cleaned often. There is a rather large spider web stretched between the foot of the bed and the wall. Thankfully its inhabitant is nowhere to be found. The rest of the room is southwest.

There's something glinting on the web.

It's a pearl earring in a silver setting. It's about the size of your head.

You can't see that here. Thankfully.

>cut web.x spider.x web
I didn't understand that sentence.

>cut web
(with the shuriken)
You throw the shuriken at the web, slicing easily through the sticky material. The pearl drops to the ground.

>x spider.x web
You can't see that here. Thankfully.

The web has been torn up.

>take pearl.x spider.x web.x spider
As you stoop to pick up the pearl, the spider sneaks in and fixes her web. Taken.

The spider seems to have vanished again.

The spider has woven the word "CRETIN" into her web.

You can't see that here. Thankfully.

>cut web.x spider.x web.x spider
I didn't understand that sentence.

>cut web
(with the shuriken)
You throw the shuriken at the web, slicing easily through the sticky material.

The spider comes out, shakes several fists at you, and repairs her web. She slips off again.

>x spider.x web.x spider
You can't see that here. Thankfully.

The spider has woven the word "CRETIN" into her web.

You can't see that here. Thankfully.

* * *

>e.x web.x glint.x spider
Far Corner of the Bed
This corner doesn't seem to get cleaned often. There is a rather large spider web stretched between the foot of the bed and the wall. Thankfully its inhabitant is nowhere to be found. The rest of the room is southwest.

There's something glinting on the web.

It's a pearl earring in a silver setting. It's about the size of your head.

You can't see that here. Thankfully.

>cut web
(with the shuriken)
You throw the shuriken at the web, slicing easily through the sticky material. The pearl drops to the ground.

>x web.x spider.take pearl
The web has been torn up.

You can't see that here. Thankfully.

As you stoop to pick up the pearl, the spider sneaks in and fixes her web. Taken.

>x spider.x web.x spider
You can't see that here. Thankfully.

The spider has woven the word "CRETIN" into her web.

The spider seems to have vanished again.

>x spider
You can't see that here. Thankfully.

* * *

>cut web
(with the shuriken)
You throw the shuriken at the web, slicing easily through the sticky material. The pearl drops to the ground.

>x web.x spider.take pearl.x spider.x web
The web has been torn up.

You can't see that here. Thankfully.

As you stoop to pick up the pearl, the spider sneaks in and fixes her web. Taken.

The spider seems to have vanished again.

The spider has woven the word "CRETIN" into her web.

>x spider
You can't see that here. Thankfully.

>cut web
(with the shuriken)
You throw the shuriken at the web, slicing easily through the sticky material.

The spider comes out, shakes several fists at you, and repairs her web. She slips off again.

>x web
The spider has woven the word "CRETIN" into her web.

>cut web
(with the shuriken)
You throw the shuriken at the web, slicing easily through the sticky material.

*** The spider bites you. You die. ***
Not really. But knock it off.

>x spider
You can't see that here. Thankfully.

* * *

The talent show is tonight, and you promised to emcee. But first you need to find your hat.

The Legend of the Missing Hat
A tiny adventure by Adri
Release 1 / Serial number 140106 / Inform 7 build 6G60 (I6/v6.32 lib 6/12N) SD

Under the Bed
This is where you live. The rest of the room is south, and there's a particularly dusty looking corner to the east.

>e.x web.x spider.x glint
Far Corner of the Bed
This corner doesn't seem to get cleaned often. There is a rather large spider web stretched between the foot of the bed and the wall. Thankfully its inhabitant is nowhere to be found. The rest of the room is southwest.

There's something glinting on the web.

You can't see that here. Thankfully.

It's a pearl earring in a silver setting. It's about the size of your head.

>cut web
(with the shuriken)
You throw the shuriken at the web, slicing easily through the sticky material. The pearl drops to the ground.

>x web.x spider.take pearl.x spider.x spider
The web has been torn up.

You can't see that here. Thankfully.

As you stoop to pick up the pearl, the spider sneaks in and fixes its web. Taken.

The spider seems to have vanished again.

You can't see that here. Thankfully.

>cut web
(with the shuriken)
You throw the shuriken at the web, slicing easily through the sticky material.

The spider comes out, shakes several fists at you, and repairs the web. It slips off again.

>x spider
You can't see that here. Thankfully.

>x web
The spider has woven the words "PLEASE STOP" into its web.

>take web
You don't want to touch that with your bare hands.

>cut web
(with the shuriken)
You throw the shuriken at the web, slicing easily through the sticky material.

*** The spider bites you. You die. ***

Not really. But knock it off.

I beg your pardon?

>x web.x spider
There is a spider sitting in the center of the web.

It's a common house spider. It's not very large, but it looks like it won't hesitate to kill you if you try to destroy its web again.

>take spider
The spider bares its fangs at you. You decide to leave it alone.

* * *

The talent show is tonight, and you promised to emcee. But first you need to find your hat.

The Legend of the Missing Hat
A tiny adventure by Adri
Release 1 / Serial number 140106 / Inform 7 build 6G60 (I6/v6.32 lib 6/12N) SD

Under the Bed
This is where you live. The rest of the room is south, and there's a particularly dusty looking corner to the east.

>e.x glint.cut web
Far Corner of the Bed
This corner doesn't seem to get cleaned often. There is a rather large spider web stretched between the foot of the bed and the wall. Thankfully its inhabitant is nowhere to be found. The rest of the room is southwest.

It's a pearl earring in a silver setting. It's about the size of your head.

(with the shuriken)
You throw the shuriken at the web, slicing easily through the sticky material. The pearl drops to the ground.

>take pearl.cut web.cut web.cut web
As you stoop to pick up the pearl, the spider sneaks in and fixes its web. Taken.

I didn't understand that sentence.

>cut web
(with the shuriken)
You throw the shuriken at the web, slicing easily through the sticky material.

The spider comes out, shakes several fists at you, and repairs the web. It slips off again.

>cut web
(with the shuriken)
You throw the shuriken at the web, slicing easily through the sticky material.

*** The spider bites you. You die. ***

Not really. But knock it off.

>cut web
(with the shuriken)
The spider bares its fangs at you. You decide to leave it alone.

>cut web
(with the shuriken)
The spider bares its fangs at you. You decide to leave it alone.

* * *

The talent show is tonight, and you promised to emcee. But first you need to find your hat.

The Legend of the Missing Hat
A tiny adventure by Adri
Release 1 / Serial number 140106 / Inform 7 build 6G60 (I6/v6.32 lib 6/12N) SD

Under the Bed
This is where you live. The rest of the room is south, and there's a particularly dusty looking corner to the east.

>e.x web.x glint.x web
Far Corner of the Bed
This corner doesn't seem to get cleaned often. There is a rather large spider web stretched between the foot of the bed and the wall. Thankfully its inhabitant is nowhere to be found. The rest of the room is southwest.

There's something glinting on the web.

It's a pearl earring in a silver setting. It's about the size of your head.

On the web is a pearl.

>search web
There is a pearl earring stuck to the web.

* * *

The talent show is tonight, and you promised to emcee. But first you need to find your hat.

The Legend of the Missing Hat
A tiny adventure by Adri
Release 1 / Serial number 140106 / Inform 7 build 6G60 (I6/v6.32 lib 6/12N) SD

Under the Bed
This is where you live. The rest of the room is south, and there's a particularly dusty looking corner to the east.

>e.x web
Far Corner of the Bed
This corner doesn't seem to get cleaned often. There is a rather large spider web stretched between the foot of the bed and the wall. Thankfully its inhabitant is nowhere to be found. The rest of the room is southwest.

There's something glinting on the web.

>x glinting
It's a pearl earring in a silver setting. It's about the size of your head.

>x web
There's something glinting on the web.

* * *

>search web
You peer more closely at the web. There is a pearl earring stuck to the web.

>look closely
(at the web)
You peer more closely at the web. There is a pearl earring stuck to the web.

>cut web
(with the shuriken)
Why don't you look more closely at the web before you destroy it?

* * *

>e.x web
Far Corner of the Bed
This corner doesn't seem to get cleaned often. There is a rather large spider web stretched between the foot of the bed and the wall. Thankfully its inhabitant is nowhere to be found. The rest of the room is southwest.

There's something glinting on the web.

>search web
You peer more closely at the web. There is a pearl earring stuck to the web.

>x glint
It's a pearl earring in a silver setting. It's about the size of your head.

>x pearl
It's a pearl earring in a silver setting. It's about the size of your head.

>take pearl
It's stuck in the web. Maybe you have something you can throw at it?

>cut web
(with the shuriken)
You throw the shuriken at the web, slicing easily through the sticky material. The pearl drops to the ground.

>l
Far Corner of the Bed
This corner doesn't seem to get cleaned often. There is a rather large spider web stretched between the foot of the bed and the wall. Thankfully its inhabitant is nowhere to be found. The rest of the room is southwest.

You can see a pearl and your shuriken here.

>x web.search web.look closely
The web has been torn up.

You peer more closely at the web. There is a pearl earring stuck to the web.

(at the web)
You peer more closely at the web. There is a pearl earring stuck to the web.

* * *

The talent show is tonight, and you promised to emcee. But first you need to find your hat.

The Legend of the Missing Hat
A tiny adventure by Adri
Release 1 / Serial number 140106 / Inform 7 build 6G60 (I6/v6.32 lib 6/12N) SD

Under the Bed
This is where you live. The rest of the room is south, and there's a particularly dusty looking corner to the east.

>e.cut web
Far Corner of the Bed
This corner doesn't seem to get cleaned often. There is a rather large spider web stretched between the foot of the bed and the wall. Thankfully its inhabitant is nowhere to be found. The rest of the room is southwest.

(with the shuriken)
Why don't you look more closely at the web before you destroy it?

>search web.cut web
You peer more closely at the web. There is a pearl earring stuck in the web.

(with the shuriken)
You throw the shuriken at the web, slicing easily through the sticky material. The pearl drops to the ground.

>search web.x web
There is nothing on the web.

There's something glinting on the web.

* * *

The talent show is tonight, and you promised to emcee. But first you need to find your hat.

The Legend of the Missing Hat
A tiny adventure by Adri
Release 1 / Serial number 140106 / Inform 7 build 6G60 (I6/v6.32 lib 6/12N) SD

Under the Bed
This is where you live. The rest of the room is south, and there's a particularly dusty looking corner to the east.

>e.x web.cut web
Far Corner of the Bed
This corner doesn't seem to get cleaned often. There is a rather large spider web stretched between the foot of the bed and the wall. Thankfully its inhabitant is nowhere to be found. The rest of the room is southwest.

There's something glinting on the web.

(with the shuriken)
Why don't you look more closely at the web before you destroy it?

>look closely.x web.x glint
You can't see any such thing.

>look closely
(at the web)
You peer more closely at the web. There is a pearl earring stuck in the web.

>search web
You peer more closely at the web. There is a pearl earring stuck in the web.

>x web
There is a pearl earring stuck in the web.

>x glint
It's a pearl earring in a silver setting. It's about the size of your head.

* * *

>take pearl
It's stuck in the web. Maybe you have something you can throw at it?

>take web
You don't want to touch that with your bare hands.

>cut web
(with the shuriken)
You throw the shuriken at the web, slicing easily through the sticky material. The pearl drops to the ground.

>x web.x glint.search web
There is a pearl earring stuck in the web.

You can't see any such thing.

* * *

>e.x web.cut web
Far Corner of the Bed
This corner doesn't seem to get cleaned often. There is a rather large spider web stretched between the foot of the bed and the wall. Thankfully its inhabitant is nowhere to be found. The rest of the room is southwest.

There's something glinting on the web.

(with the shuriken)
Why don't you look more closely at the web before you destroy it?

>search web.x web.x glint
You peer more closely at the web. There is a pearl earring stuck in the web.

There is a pearl earring stuck in the web.

It's a pearl earring in a silver setting. It's about the size of your head.

>cut web
(with the shuriken)
You throw the shuriken at the web, slicing easily through the sticky material. The pearl drops to the ground.

>x web.search web
The web has been torn up.

There is nothing on the web.

>x glint.x pearl
You can't see any such thing.

>cut web
(with the shuriken)
Haven't you done enough damage?

>take pearl.x web.x glint
As you stoop to pick up the pearl, the spider sneaks in and fixes its web. Taken.

The spider has woven the word "CRETIN" into its web.

You can't see any such thing.

>x web.search web.take glint
The spider has woven the word "CRETIN" into its web.

There is nothing on the web.

You can't see any such thing.

>cut web
(with the shuriken)
You throw the shuriken at the web, slicing easily through the sticky material.

The spider comes out, shakes several fists at you, and repairs the web. It slips off again.

* * *

>cut web
(with the shuriken)
The spider bares its fangs at you. You decide to leave it alone.

>x web
There is a spider sitting in the center of the web.

>search web
There is nothing on the web.

* * *

The talent show is tonight, and you promised to emcee. But first you need to find your hat.

The Legend of the Missing Hat
A tiny adventure by Adri
Release 1 / Serial number 140106 / Inform 7 build 6G60 (I6/v6.32 lib 6/12N) SD

Under the Bed
This is where you live. The rest of the room is south, and there's a particularly dusty looking corner to the east.

>e.search web.cut web
Far Corner of the Bed
This corner doesn't seem to get cleaned often. There is a rather large spider web stretched between the foot of the bed and the wall. Thankfully its inhabitant is nowhere to be found. The rest of the room is southwest.

You peer more closely at the web. There is a pearl earring stuck in the web.

(with the shuriken)
You throw the shuriken at the web, slicing easily through the sticky material. The pearl drops to the ground.

>take pearl.cut web
As you stoop to pick up the pearl, the spider sneaks in and fixes its web. Taken.

(with the shuriken)
You throw the shuriken at the web, slicing easily through the sticky material.

The spider comes out, shakes several fists at you, and repairs the web. It slips off again.

>g
(with the shuriken)
You throw the shuriken at the web, slicing easily through the sticky material.

*** The spider bites you. You die. ***

Not really. But knock it off.

>search web
There is nothing on the web. Except for that angry-looking spider.

>take web
You don't want to touch that with your bare hands.

>sw
You pause to retrieve your shuriken. Taken.

Bedroom
This is the dormitory room you share with your three closest friends. There is a bed to the north, a wardrobe to the east, a bookshelf to the south, a food storage area to the west and a desk in the northwest corner.

>take wardrobe
There's no way you could lift that. Nor do you have any reason to.

>move wardrobe
It is fixed in place.

>pull wardrobe
It is fixed in place.

* * *

The talent show is tonight, and you promised to emcee. But first you need to find your hat.

The Legend of the Missing Hat
A tiny adventure by Adri
Release 1 / Serial number 140106 / Inform 7 build 6G60 (I6/v6.32 lib 6/12N) SD

Under the Bed
This is where you live. The rest of the room is south, and there's a particularly dusty looking corner to the east.

>push bed
You try with all your might, but it barely moves.

>pull bed
You try with all your might, but it barely moves.

>bed
That's not a verb I recognize.

>turn bed.move bed
You try with all your might, but it barely moves.

You try with all your might, but it barely moves.

>take bed
There's no way you could lift that. Nor do you have any reason to.

>z
Time passes.

* * *

The talent show is tonight, and you promised to emcee. But first you need to find your hat.

The Legend of the Missing Hat
A tiny adventure by Adri
Release 1 / Serial number 140106 / Inform 7 build 6G60 (I6/v6.32 lib 6/12N) SD

Under the Bed
This is where you live. The rest of the room is south, and there's a particularly dusty looking corner to the east.

>z
You can rest later. Right now you need to find your hat.

>z.z.z
You can rest later. Right now you need to find your hat.

You can rest later. Right now you need to find your hat.

You can rest later. Right now you need to find your hat.

>dance
There's no time for that!

* * *

The talent show is tonight, and you promised to emcee. But first you need to find your hat.

The Legend of the Missing Hat
A tiny adventure by Adri
Release 1 / Serial number 140106 / Inform 7 build 6G60 (I6/v6.32 lib 6/12N) SD

Under the Bed
This is where you live. The rest of the room is south, and there's a particularly dusty looking corner to the east.

>please pass
You can't see any such thing.

>pass
You can't see any such thing.

>s
Bedroom
This is the dormitory room you share with your three closest friends. There is a bed to the north, a wardrobe to the east, a bookshelf to the south, a food storage area to the west and a desk in the northwest corner.

>pass
(the milk)
You seem to be thinking of a different game.

>pass milk
You seem to be thinking of a different game.

* * *

The talent show is tonight, and you promised to emcee. But first you need to find your hat.

The Legend of the Missing Hat
A tiny adventure by Adri
Release 1 / Serial number 140106 / Inform 7 build 6G60 (I6/v6.32 lib 6/12N) SD

Under the Bed
This is where you live. The rest of the room is south, and there's a particularly dusty looking corner to the east.

>pass
You can't see any such thing.

* * *

>s
Bedroom
This is the dormitory room you share with your three closest friends. There is a bed to the north, a wardrobe to the east, a bookshelf to the south, a food storage area to the west and a desk in the northwest corner.

>pass milk
Ninjas are lactose intolerant. [Citation needed]

>x milk
You seem to be thinking of a different game.

* * *

The talent show is tonight, and you promised to emcee. But first you need to find your hat.

The Legend of the Missing Hat
A tiny adventure by Adri
Release 1 / Serial number 140106 / Inform 7 build 6G60 (I6/v6.32 lib 6/12N) SD

Under the Bed
This is where you live. The rest of the room is south, and there's a particularly dusty looking corner to the east.

>s.pass milk
Bedroom
This is the dormitory room you share with your three closest friends. There is a bed to the north, a wardrobe to the east, a bookshelf to the south, a food storage area to the west and a desk in the northwest corner.

Ninjas are lactose intolerant. [Citation needed]

>xyzzy
You hear the distant strains of chiptune music. You have no idea where it comes from, but it follows you everywhere.

>listen to music
Bleep bleep bloop bleep.

>dance
There's no time for that!

>s
As you approach the bookshelf, you notice a mouse hole to the left of it, in the southeast corner of the room.

On the Bookshelf
The rest of the room is north.

The tiny green ninja is pacing back and forth.

>steal notebook
That's not a verb I recognize.

>fuck
Real adventurers do not use such language.

* * *

The talent show is tonight, and you promised to emcee. But first you need to find your hat.

The Legend of the Missing Hat
A tiny adventure by Adri
Release 1 / Serial number 140106 / Inform 7 build 6G60 (I6/v6.32 lib 6/12N) SD

Under the Bed
This is where you live. The rest of the room is south, and there's a particularly dusty looking corner to the east.

>cut me
(with the shuriken)
Violence isn't the answer to this one.

>attack me
No.

>hit me
No.

>s.e
Bedroom
This is the dormitory room you share with your three closest friends. There is a bed to the north, a wardrobe to the east, a bookshelf to the south, a food storage area to the west and a desk in the northwest corner.

You knock on the door of the wardrobe, and the blue ninja peeks his head out. 

Outside the Wardrobe
The rest of the room is west.

The tiny blue ninja stands in the doorway. He doesn't seem eager to invite you inside.

>attack ninja.cut ninja
Violence isn't the answer to this one.

(with the shuriken)
Violence isn't the answer to this one.

* * *

The talent show is tonight, and you promised to emcee. But first you need to find your hat.

The Legend of the Missing Hat
A tiny adventure by Adri
Release 1 / Serial number 140106 / Inform 7 build 6G60 (I6/v6.32 lib 6/12N) SD

Under the Bed
This is where you live. The rest of the room is south, and there's a particularly dusty looking corner to the east.

>cheat.s.nw
Bedroom
This is the dormitory room you share with your three closest friends. There is a bed to the north, a wardrobe to the east, a bookshelf to the south, a food storage area to the west and a desk in the northwest corner.

Below the Desk
You can see sunlight above you. The rest of the room is southeast.

>throw hook at window
You can't see any such thing.

>create grappling hook
That's not a verb I recognize.

* * *

>cheat.s.nw
Bedroom
This is the dormitory room you share with your three closest friends. There is a bed to the north, a wardrobe to the east, a bookshelf to the south, a food storage area to the west and a desk in the northwest corner.

Below the Desk
You can see sunlight above you. The rest of the room is southeast.

>throw rope.take rope.throw rope at shuriken
Dropped.

Taken.

You tap the shuriken with the length of yarn. Nothing happens.

>throw rope n
I only understood you as far as wanting to throw the length of yarn.

>throw rope at sunlight
You can't seem to throw the yarn that high. Maybe if you tied it to something?

>make grappling hook.throw rope at sunlight
You tie the yarn to the shuriken, creating a grappling hook.

(first taking the length of yarn)
You untie the yarn from the shuriken.

You can't seem to throw the yarn that high. Maybe if you tied it to something?

* * *

The talent show is tonight, and you promised to emcee. But first you need to find your hat.

The Legend of the Missing Hat
A tiny adventure by Adri
Release 1 / Serial number 140106 / Inform 7 build 6G60 (I6/v6.32 lib 6/12N) SD

Under the Bed
This is where you live. The rest of the room is south, and there's a particularly dusty looking corner to the east.

>cheat.make grappling hook.s.nw
You tie the yarn to the shuriken, creating a grappling hook.

Bedroom
This is the dormitory room you share with your three closest friends. There is a bed to the north, a wardrobe to the east, a bookshelf to the south, a food storage area to the west and a desk in the northwest corner.

Below the Desk
You can see sunlight above you. The rest of the room is southeast.

>throw hook at window
You throw the grappling hook at the desk. It catches in the wood. You scramble up the length of yarn.

On the Desk
Sunlight streams in through the window. There is a pot here containing tiny purple flowers.

You can see a grappling hook here.

>throw hook at window
(first taking the grappling hook)
You should leave that where it is. You'll need it to climb back down.

>push pot
You try with all your might, but it barely moves.

>push flowers
You try with all your might, but it barely moves.

>take flowers
You pick a handful of flowers. Taken.

>push flowers
(the bouquet of flowers)
Nothing obvious happens.

>untie hook
You untie the yarn from the shuriken.

>down
It's a far way down. Maybe there's another way.

>take hook
You can't see any such thing.

* * *

>cheat.make grappling hook.s.nw
You tie the yarn to the shuriken, creating a grappling hook.

Bedroom
This is the dormitory room you share with your three closest friends. There is a bed to the north, a wardrobe to the east, a bookshelf to the south, a food storage area to the west and a desk in the northwest corner.

Below the Desk
You can see sunlight above you. The rest of the room is southeast.

>throw shuriken
Maybe you should try throwing it at something.

>take rope.throw rope
You untie the yarn from the shuriken.

Dropped.

>take rope.throw rope at window
Taken.

You can't seem to throw the yarn that high. Maybe if you tied it to something?

* * *

The talent show is tonight, and you promised to emcee. But first you need to find your hat.

The Legend of the Missing Hat
A tiny adventure by Adri
Release 1 / Serial number 140106 / Inform 7 build 6G60 (I6/v6.32 lib 6/12N) SD

Under the Bed
This is where you live. The rest of the room is south, and there's a particularly dusty looking corner to the east.

>cheat.make grappling hook.s.nw.throw hook at sunlight
You tie the yarn to the shuriken, creating a grappling hook.

Bedroom
This is the dormitory room you share with your three closest friends. There is a bed to the north, a wardrobe to the east, a bookshelf to the south, a food storage area to the west and a desk in the northwest corner.

Below the Desk
You can see sunlight above you. The rest of the room is southeast.

You throw the grappling hook at the desk. It catches in the wood. You scramble up the length of yarn.

On the Desk
Sunlight streams in through the window. There is a pot here containing tiny purple flowers.

You can see a grappling hook here.

>untie hook
You should leave that where it is. You'll need it to climb back down.

>n
You pause to retrieve your shuriken. You should leave that where it is. You'll need it to climb back down.

You can't go that way.

* * *

The talent show is tonight, and you promised to emcee. But first you need to find your hat.

The Legend of the Missing Hat
A tiny adventure by Adri
Release 1 / Serial number 140106 / Inform 7 build 6G60 (I6/v6.32 lib 6/12N) SD

Under the Bed
This is where you live. The rest of the room is south, and there's a particularly dusty looking corner to the east.

>cheat.make shuriken.throw rope at bed
I didn't understand that sentence.

* * *

>make grapling hook
I didn't understand that sentence.

>make grappling hook
You tie the yarn to the shuriken, creating a grappling hook.

>throw rope at bed
(first taking the length of yarn)
You untie the yarn from the shuriken.

It's not nice to throw things.

* * *

The talent show is tonight, and you promised to emcee. But first you need to find your hat.

The Legend of the Missing Hat
A tiny adventure by Adri
Release 1 / Serial number 140106 / Inform 7 build 6G60 (I6/v6.32 lib 6/12N) SD

Under the Bed
This is where you live. The rest of the room is south, and there's a particularly dusty looking corner to the east.

>cheat.make grappling hook.throw rope at bed
You tie the yarn to the shuriken, creating a grappling hook.

You shouldn't throw that around unless you need to.

>s.nw.throw rope at sunlight
Bedroom
This is the dormitory room you share with your three closest friends. There is a bed to the north, a wardrobe to the east, a bookshelf to the south, a food storage area to the west and a desk in the northwest corner.

Below the Desk
You can see sunlight above you. The rest of the room is southeast.

You throw the grappling hook at the desk. It catches in the wood. You scramble up the length of yarn.

On the Desk
Sunlight streams in through the window. There is a pot here containing tiny purple flowers.

You can see a grappling hook here.

>take shuriken
You should leave that where it is. You'll need it to climb back down.

>take rope
You should leave that where it is. You'll need it to climb back down.

>untie rope
You would achieve nothing by this.

* * *

The talent show is tonight, and you promised to emcee. But first you need to find your hat.

The Legend of the Missing Hat
A tiny adventure by Adri
Release 1 / Serial number 140106 / Inform 7 build 6G60 (I6/v6.32 lib 6/12N) SD

Under the Bed
This is where you live. The rest of the room is south, and there's a particularly dusty looking corner to the east.

>cheat.untie rope.make grappling hook.untie rope
You would achieve nothing by this.

You tie the yarn to the shuriken, creating a grappling hook.

You untie the yarn from the shuriken.

>down.ne
You can't go that way.

You can't go that way.

>x glint
You can't see any such thing.

>restart
Are you sure you want to restart?

>y
The talent show is tonight, and you promised to emcee. But first you need to find your hat.

Ninjas!
A tiny adventure by Adri
Release 1 / Serial number 120605 / Inform 7 build 6G60 (I6/v6.32 lib 6/12N) SD

Under the Bed
This is where you live. The rest of the room is south, and there's a particularly dusty looking corner to the east.

>e
Far Corner of the Bed
This corner doesn't seem to get cleaned often. There is a rather large spider web stretched between the foot of the bed and the wall. Thankfully its inhabitant is nowhere to be found. The rest of the room is southwest.

* * *

>x glint
It's a pearl earring in a silver setting. It's about the size of your head.

>take it
It's stuck in the web. Maybe you have something you can throw at it?

>x something
It's a pearl earring in a silver setting. It's about the size of your head.

* * *

The talent show is tonight, and you promised to emcee. But first you need to find your hat.

The Legend of the Missing Hat
A tiny adventure by Adri
Release 1 / Serial number 140106 / Inform 7 build 6G60 (I6/v6.32 lib 6/12N) SD

Under the Bed
This is where you live. The rest of the room is south, and there's a particularly dusty looking corner to the east.

>drop shuriken
It's very sharp. You really shouldn't throw it around like that.

>i
You are carrying:
  your shuriken

>throw shuriken
It's very sharp. You really shouldn't throw it around like that.

>s.e
Bedroom
This is the dormitory room you share with your three closest friends. There is a bed to the north, a wardrobe to the east, a bookshelf to the south, a food storage area to the west and a desk in the northwest corner.

You knock on the door of the wardrobe, and the blue ninja peeks his head out. 

Outside the Wardrobe
The rest of the room is west.

The tiny blue ninja stands in the doorway. He doesn't seem eager to invite you inside.

>throw shuriken at wardrobe
It's very sharp. You really shouldn't throw it around like that.

It's not nice to throw things.

* * *

>i
You are carrying:
  your shuriken

>e
Far Corner of the Bed
This corner doesn't seem to get cleaned often. There is a rather large spider web stretched between the foot of the bed and the wall. Thankfully its inhabitant is nowhere to be found. The rest of the room is southwest.

* * *

>throw shuriken
Maybe you should try throwing it at something.

>throw shuriken at glint
Why don't you look more closely at the web before you destroy it?

>destroy web
You don't want to touch that with your bare hands.

* * *

>drop shuriken
It's very sharp. You really shouldn't throw it around like that.

>e
Far Corner of the Bed
This corner doesn't seem to get cleaned often. There is a rather large spider web stretched between the foot of the bed and the wall. Thankfully its inhabitant is nowhere to be found. The rest of the room is southwest.

>throw shuriken at x glint.cut web
You can't see any such thing.

>x glint.cut web
It's a pearl earring in a silver setting. It's about the size of your head.

(with the shuriken)
You throw the shuriken at the web, slicing easily through the sticky material. The pearl drops to the ground.

>e
You pause to retrieve your shuriken.

You can't go that way.

* * *

The talent show is tonight, and you promised to emcee. But first you need to find your hat.

The Legend of the Missing Hat
A tiny adventure by Adri
Release 1 / Serial number 140106 / Inform 7 build 6G60 (I6/v6.32 lib 6/12N) SD

Under the Bed
This is where you live. The rest of the room is south, and there's a particularly dusty looking corner to the east.

>s.e
Bedroom
This is the dormitory room you share with your three closest friends. There is a bed to the north, a wardrobe to the east, a bookshelf to the south, a food storage area to the west and a desk in the northwest corner.

You knock on the door of the wardrobe, and the blue ninja peeks his head out. 

Outside the Wardrobe
The rest of the room is west.

The tiny blue ninja stands in the doorway. He doesn't seem eager to invite you inside.

>throw shuriken at wardrobe
It's very sharp. You really shouldn't throw it around like that.

>throw shuriken at me
Your juggling act needs some work.

* * *

>throw yarn
Dropped.

>undo
Outside the Wardrobe
[Previous turn undone.]

>throw yarn at ninja
That might be construed as an attack.

>throw yarn at wardrobe
It's not nice to throw things.

>w.nw
Bedroom
This is the dormitory room you share with your three closest friends. There is a bed to the north, a wardrobe to the east, a bookshelf to the south, a food storage area to the west and a desk in the northwest corner.

Below the Desk
You can see sunlight above you. The rest of the room is southeast.

>throw shuriken at desk
You won't be able to retrieve that. Maybe if you tied something to it?

It's not nice to throw things.

* * *

>s.e
Bedroom
This is the dormitory room you share with your three closest friends. There is a bed to the north, a wardrobe to the east, a bookshelf to the south, a food storage area to the west and a desk in the northwest corner.

You knock on the door of the wardrobe, and the blue ninja peeks his head out. 

Outside the Wardrobe
The rest of the room is west.

The tiny blue ninja stands in the doorway. He doesn't seem eager to invite you inside.

>e
The blue ninja doesn't want you to come inside.

>enter wardrobe
The blue ninja doesn't want you to come inside.

>in
You can't go that way.

>rules
Rules tracing now switched on. Type "rules off" to switch it off again, or "rules all" to include even rules which do not apply.

>in
[Rule "standard set going variables rule" applies.]
[Rule "Before going" applies.]
[Rule "can't travel in what's not a vehicle rule" applies.]
[Rule "can't go through undescribed doors rule" applies.]
[Rule "can't go through closed doors rule" applies.]
[Rule "determine map connection rule" applies.]
[Rule "can't go that way rule" applies.]
You can't go that way.

* * *

>l
Inside the Wardrobe
The rest of the room is west.

The tiny blue ninja is sitting calmly, enjoying his new flowers.

>e
You are already in the wardrobe.

>out
Bedroom
This is the dormitory room you share with your three closest friends. There is a bed to the north, a wardrobe to the east, a bookshelf to the south, a food storage area to the west and a desk in the northwest corner.

>throw shuriken up
I only understood you as far as wanting to throw the shuriken.

>rules
Rules tracing now switched on. Type "rules off" to switch it off again, or "rules all" to include even rules which do not apply.

>throw shuriken up
I only understood you as far as wanting to throw the shuriken.

>throw shuriken e
I only understood you as far as wanting to throw the shuriken.

* * *

>s.e
Bedroom
This is the dormitory room you share with your three closest friends. There is a bed to the north, a wardrobe to the east, a bookshelf to the south, a food storage area to the west and a desk in the northwest corner.

You knock on the door of the wardrobe, and the blue ninja peeks his head out. 

Outside the Wardrobe
The rest of the room is west.

The tiny blue ninja stands in the doorway. He doesn't seem eager to invite you inside.

>in
(the wardrobe)
The blue ninja doesn't want you to come inside.

* * *

>s.e
Bedroom
This is the dormitory room you share with your three closest friends. There is a bed to the north, a wardrobe to the east, a bookshelf to the south, a food storage area to the west and a desk in the northwest corner.

You knock on the door of the wardrobe, and the blue ninja peeks his head out. 

Outside the Wardrobe
The rest of the room is west.

The tiny blue ninja stands in the doorway. He doesn't seem eager to invite you inside.

>hello, ninja
(ninja, hello)
The blue ninja sniffles. He says, "I think you ought to know I'm feeling very depressed."

>ninja, hello
You are already talking to the blue ninja.

* * *

The talent show is tonight, and you promised to emcee. But first you need to find your hat.

The Legend of the Missing Hat
A tiny adventure by Adri
Release 1 / Serial number 140106 / Inform 7 build 6G60 (I6/v6.32 lib 6/12N) SD

Under the Bed
This is where you live. The rest of the room is south, and there's a particularly dusty looking corner to the east.

>throw shruiken
You can't see any such thing.

>throw star
It's very sharp. You really shouldn't throw it around like that.

* * *

>s.e
Bedroom
This is the dormitory room you share with your three closest friends. There is a bed to the north, a wardrobe to the east, a bookshelf to the south, a food storage area to the west and a desk in the northwest corner.

You knock on the door of the wardrobe, and the blue ninja peeks his head out. 

Outside the Wardrobe
The rest of the room is west.

The tiny blue ninja stands in the doorway. He doesn't seem eager to invite you inside.

>throw yarn at ninja
It's not nice to throw things.

* * *

The talent show is tonight, and you promised to emcee. But first you need to find your hat.

The Legend of the Missing Hat
A tiny adventure by Adri
Release 1 / Serial number 140106 / Inform 7 build 6G60 (I6/v6.32 lib 6/12N) SD

Under the Bed
This is where you live. The rest of the room is south, and there's a particularly dusty looking corner to the east.

>drop star
It's very sharp. You really shouldn't throw it around like that.

>throw star at me
Your juggling act needs some work.

* * *

>throw star at yarn
That's an awkward thing to do.

>throw yarn at star
That's an awkward thing to do.

>throw yarn at me
Your juggling act needs some work.

>s.e
Bedroom
This is the dormitory room you share with your three closest friends. There is a bed to the north, a wardrobe to the east, a bookshelf to the south, a food storage area to the west and a desk in the northwest corner.

You knock on the door of the wardrobe, and the blue ninja peeks his head out. 

Outside the Wardrobe
The rest of the room is west.

The tiny blue ninja stands in the doorway. He doesn't seem eager to invite you inside.

* * *

>throw star at ninja.throw yarn at ninja
That might be construed as an attack.

That might be construed as an attack.

>throw yarn at wardrobe.throw star at wardrobe.
It's not nice to throw things.

It's very sharp. You really shouldn't throw it around like that.

>n.e
You can't go that way.

You can't go that way.

>w.ne
Bedroom
This is the dormitory room you share with your three closest friends. There is a bed to the north, a wardrobe to the east, a bookshelf to the south, a food storage area to the west and a desk in the northwest corner.

Far Corner of the Bed
This corner doesn't seem to get cleaned often. There is a rather large spider web stretched between the foot of the bed and the wall. Thankfully its inhabitant is nowhere to be found. The rest of the room is southwest.

>throw yarn at web
It might get stuck. Maybe you have something else you can use?

>throw star at web
Why don't you look more closely at the web before you destroy it?

>throw yarn at spider.throw star at spider
It's not nice to throw things.

Maybe you should try throwing it at something.

>x glint.throw star at web.take pearl
It's a pearl earring in a silver setting. It's about the size of your head.

You throw the shuriken at the web, slicing easily through the sticky material. The pearl drops to the ground.

As you stoop to pick up the pearl, the spider sneaks in and fixes its web. Taken.

>cut web
(with the shuriken)
You throw the shuriken at the web, slicing easily through the sticky material.

The spider comes out, shakes several fists at you, and repairs the web. It slips off again.

* * *

>cut web
(with the shuriken)
You throw the shuriken at the web, slicing easily through the sticky material.

*** The spider bites you. You die. ***

Not really. But knock it off.

>x spider
It's a common house spider. It's not very large, but it looks like it won't hesitate to kill you if you try to destroy its web again.

>throw yarn at spider
It's not nice to throw things.

>cut web
(with the shuriken)
The spider bares its fangs at you. You decide to leave it alone.

* * *

The talent show is tonight, and you promised to emcee. But first you need to find your hat.

The Legend of the Missing Hat
A tiny adventure by Adri
Release 1 / Serial number 140106 / Inform 7 build 6G60 (I6/v6.32 lib 6/12N) SD

Under the Bed
This is where you live. The rest of the room is south, and there's a particularly dusty looking corner to the east.

>s.e.e
Bedroom
This is the dormitory room you share with your three closest friends. There is a bed to the north, a wardrobe to the east, a bookshelf to the south, a food storage area to the west and a desk in the northwest corner.

You knock on the door of the wardrobe, and the blue ninja peeks his head out. 

Outside the Wardrobe
The rest of the room is west.

The tiny blue ninja stands in the doorway. He doesn't seem eager to invite you inside.

You can't go that way.

>enter wardrobe
The blue ninja doesn't want you to come inside.

* * *

The talent show is tonight, and you promised to emcee. But first you need to find your hat.

The Legend of the Missing Hat
A tiny adventure by Adri
Release 1 / Serial number 140106 / Inform 7 build 6G60 (I6/v6.32 lib 6/12N) SD

Under the Bed
This is where you live. The rest of the room is south, and there's a particularly dusty looking corner to the east.

>in
I didn't understand that sentence.

>s.e
Bedroom
This is the dormitory room you share with your three closest friends. There is a bed to the north, a wardrobe to the east, a bookshelf to the south, a food storage area to the west and a desk in the northwest corner.

You knock on the door of the wardrobe, and the blue ninja peeks his head out. 

Outside the Wardrobe
The rest of the room is west.

The tiny blue ninja stands in the doorway. He doesn't seem eager to invite you inside.

* * *

The talent show is tonight, and you promised to emcee. But first you need to find your hat.

The Legend of the Missing Hat
A tiny adventure by Adri
Release 1 / Serial number 140106 / Inform 7 build 6G60 (I6/v6.32 lib 6/12N) SD

Under the Bed
This is where you live. The rest of the room is south, and there's a particularly dusty looking corner to the east.

>s.nw
Bedroom
This is the dormitory room you share with your three closest friends. There is a bed to the north, a wardrobe to the east, a bookshelf to the south, a food storage area to the west and a desk in the northwest corner.

Below the Desk
You can see sunlight above you. The rest of the room is southeast.

>x uplook up
You can't see any such thing.

>look up
Sunlight streams in through the window.

* * *

The talent show is tonight, and you promised to emcee. But first you need to find your hat.

The Legend of the Missing Hat
A tiny adventure by Adri
Release 1 / Serial number 140106 / Inform 7 build 6G60 (I6/v6.32 lib 6/12N) SD

Under the Bed
This is where you live. The rest of the room is south, and there's a particularly dusty looking corner to the east.

>look up.look down.s.nw
You don't see anything in that direction.

You don't see anything in that direction.

Bedroom
This is the dormitory room you share with your three closest friends. There is a bed to the north, a wardrobe to the east, a bookshelf to the south, a food storage area to the west and a desk in the northwest corner.

Below the Desk
You can see sunlight above you. The rest of the room is southeast.

>look up
The top of the desk is in that direction.

>cheat
On the Desk
Sunlight streams in through the window. There is a pot here containing tiny purple flowers.

>look dx desk
You can't see any such thing.

>x desk
The desk is covered in papers and books. None of it is particularly interesting.

>look down
The floor is in that direction.

* * *

The talent show is tonight, and you promised to emcee. But first you need to find your hat.

The Legend of the Missing Hat
A tiny adventure by Adri
Release 1 / Serial number 140106 / Inform 7 build 6G60 (I6/v6.32 lib 6/12N) SD

Under the Bed
This is where you live. The rest of the room is south, and there's a particularly dusty looking corner to the east.

>hurl shuriken at bed
It's very sharp. You really shouldn't throw it around like that.

>hurl shuriken
(at the shuriken)
That's an awkward thing to do.

* * *

The talent show is tonight, and you promised to emcee. But first you need to find your hat.

The Legend of the Missing Hat
A tiny adventure by Adri
Release 1 / Serial number 140106 / Inform 7 build 6G60 (I6/v6.32 lib 6/12N) SD

Under the Bed
This is where you live. The rest of the room is south, and there's a particularly dusty looking corner to the east.

>hurl shuriken
It's very sharp. You really shouldn't throw it around like that.

* * *

The talent show is tonight, and you promised to emcee. But first you need to find your hat.

The Legend of the Missing Hat
A tiny adventure by Adri
Release 1 / Serial number 140106 / Inform 7 build 6G60 (I6/v6.32 lib 6/12N) SD

Under the Bed
This is where you live. The rest of the room is south, and there's a particularly dusty looking corner to the east.

>juggle
You toss the shuriken into the air. You panic as it comes back down and duck out of the way.

>juggle
You have nothing to juggle with. That's probably a good thing.

* * *

>take shuriken
Taken.

>juggle
You toss the shuriken, the hat, and the bow tie into the air. You panic as the hat comes back down and duck out of the way.
 You drop everything.

* * *

The talent show is tonight, and you promised to emcee. But first you need to find your hat.

The Legend of the Missing Hat
A tiny adventure by Adri
Release 1 / Serial number 140106 / Inform 7 build 6G60 (I6/v6.32 lib 6/12N) SD

Under the Bed
This is where you live. The rest of the room is south, and there's a particularly dusty looking corner to the east.

>drop all
(the shuriken)
It's very sharp. You really shouldn't throw it around like that.

>juggle
You toss the shuriken into the air. You panic as the shuriken comes back down and duck out of the way.

>juggle
You have nothing to juggle with. That's probably a good thing.

* * *

The talent show is tonight, and you promised to emcee. But first you need to find your hat.

The Legend of the Missing Hat
A tiny adventure by Adri
Release 1 / Serial number 140106 / Inform 7 build 6G60 (I6/v6.32 lib 6/12N) SD

Under the Bed
This is where you live. The rest of the room is south, and there's a particularly dusty looking corner to the east.

>juggle.juggle.cheat
You toss the shuriken into the air. You panic as it comes back down and duck out of the way. 

You have nothing to juggle with. That's probably a good thing.

>juggle
You toss the hat and the bow tie into the air. You panic as the bow tie comes back down and duck out of the way. You drop everything.

>dance
There's no time for that!

* * *

The talent show is tonight, and you promised to emcee. But first you need to find your hat.

The Legend of the Missing Hat
A tiny adventure by Adri
Release 1 / Serial number 140106 / Inform 7 build 6G60 (I6/v6.32 lib 6/12N) SD

Under the Bed
This is where you live. The rest of the room is south, and there's a particularly dusty looking corner to the east.

>sing
You only sing in the shower.

* * *

The talent show is tonight, and you promised to emcee. But first you need to find your hat.

The Legend of the Missing Hat
A tiny adventure by Adri
Release 1 / Serial number 140106 / Inform 7 build 6G60 (I6/v6.32 lib 6/12N) SD

Under the Bed
This is where you live. The rest of the room is south, and there's a particularly dusty looking corner to the east.

>read shuriken
You don't see any text on that.

* * *

The talent show is tonight, and you promised to emcee. But first you need to find your hat.

The Legend of the Missing Hat
A tiny adventure by Adri
Release 1 / Serial number 140106 / Inform 7 build 6G60 (I6/v6.32 lib 6/12N) SD

Under the Bed
This is where you live. The rest of the room is south, and there's a particularly dusty looking corner to the east.

>s.w.cheat
Bedroom
This is the dormitory room you share with your three closest friends. There is a bed to the north, a wardrobe to the east, a bookshelf to the south, a food storage area to the west and a desk in the northwest corner.

Behind the Mini Fridge
The rest of the room is east.

The tiny red ninja is here, nibbling anxiously on a cookie. He seems angry.

>read notebook.x notebook.open notebook
It's blank inside.

It's a matchbook-sized notebook. The cover is studded with colorful rhinestones.

It's blank inside.

>give notebook to red
The red ninja takes the notebook and looks at it for a moment. Then he pulls out a pencil and starts scribbling away. His mood seems to lighten as he fills the pages with his thoughts. Eventually he glances up at you, smiling. "Thank you. I needed that." He hands you the half-eaten cookie. "Would you like a cookie?"

[Your score has just gone up by twenty-five points.]

>red notebook.x notebook
That's not a verb I recognize.

>read notebook.x notebook
It's full of messy handwriting you're unable to decipher.

It's a matchbook-sized notebook. The cover is studded with colorful rhinestones.

* * *

The talent show is tonight, and you promised to emcee. But first you need to find your hat.

The Legend of the Missing Hat
A tiny adventure by Adri
Release 1 / Serial number 140106 / Inform 7 build 6G60 (I6/v6.32 lib 6/12N) SD

Under the Bed
This is where you live. The rest of the room is south, and there's a particularly dusty looking corner to the east.

>e.x glint.throw shuriken at web
Far Corner of the Bed
This corner doesn't seem to get cleaned often. There is a rather large spider web stretched between the foot of the bed and the wall. Thankfully its inhabitant is nowhere to be found. The rest of the room is southwest.

It's a pearl earring in a silver setting. It's about the size of your head.

You throw the shuriken at the web, slicing easily through the sticky material. The pearl drops to the ground.

>take pearl
As you stoop to pick up the pearl, the spider sneaks in and fixes its web.

>i
You are carrying:
  a pearl

* * *

The talent show is tonight, and you promised to emcee. But first you need to find your hat.

The Legend of the Missing Hat
A tiny adventure by Adri
Release 1 / Serial number 140106 / Inform 7 build 6G60 (I6/v6.32 lib 6/12N) SD

Under the Bed
This is where you live. The rest of the room is south, and there's a particularly dusty looking corner to the east.

>tie rope to me
You can't see any such thing.

* * *

>tie rope to me
You would achieve nothing by this.

* * *

The talent show is tonight, and you promised to emcee. But first you need to find your hat.

The Legend of the Missing Hat
A tiny adventure by Adri
Release 1 / Serial number 140106 / Inform 7 build 6G60 (I6/v6.32 lib 6/12N) SD

Under the Bed
This is where you live. The rest of the room is south, and there's a particularly dusty looking corner to the east.

>verbs
That's not a verb I recognize.

>lie
That's not a verb I recognize.

>s.e
Bedroom
This is the dormitory room you share with your three closest friends. There is a bed to the north, a wardrobe to the east, a bookshelf to the south, a food storage area to the west and a desk in the northwest corner.

You knock on the door of the wardrobe, and the blue ninja peeks his head out. 

Outside the Wardrobe
The rest of the room is west.

The tiny blue ninja stands in the doorway. He doesn't seem eager to invite you inside.

>ninja, hello
The blue ninja sniffles. He says, "I think you ought to know I'm feeling very depressed."

>hello, ninja
You are already talking to the blue ninja.

That's not a verb I recognize.

* * *

The talent show is tonight, and you promised to emcee. But first you need to find your hat.

The Legend of the Missing Hat
A tiny adventure by Adri
Release 1 / Serial number 140106 / Inform 7 build 6G60 (I6/v6.32 lib 6/12N) SD

Under the Bed
This is where you live. The rest of the room is south, and there's a particularly dusty looking corner to the east.

>s.e.x blue
Bedroom
This is the dormitory room you share with your three closest friends. There is a bed to the north, a wardrobe to the east, a bookshelf to the south, a food storage area to the west and a desk in the northwest corner.

You knock on the door of the wardrobe, and the blue ninja peeks his head out. 

Outside the Wardrobe
The rest of the room is west.

The tiny blue ninja stands in the doorway. He doesn't seem eager to invite you inside.

This ninja is dressed in blue and carries a kama. He looks like he's been crying.

>x kama
It's a kama.

>take kama
That seems to belong to the blue ninja.

* * *

The talent show is tonight, and you promised to emcee. But first you need to find your hat.

The Legend of the Missing Hat
A tiny adventure by Adri
Release 1 / Serial number 140106 / Inform 7 build 6G60 (I6/v6.32 lib 6/12N) SD

Under the Bed
This is where you live. The rest of the room is south, and there's a particularly dusty looking corner to the east.

>s.e.x ninja.x sai
Bedroom
This is the dormitory room you share with your three closest friends. There is a bed to the north, a wardrobe to the east, a bookshelf to the south, a food storage area to the west and a desk in the northwest corner.

You knock on the door of the wardrobe, and the blue ninja peeks his head out. 

Outside the Wardrobe
The rest of the room is west.

The tiny blue ninja stands in the doorway. He doesn't seem eager to invite you inside.

This ninja is dressed in blue and carries a kama. He looks like he's been crying.

You can't see any such thing.

>x nunchaku
You can't see any such thing.

>x kama
It's a tiny curved blade with a wooden handle.

>take kama.ask permission
You should never touch another ninja's weapon without permission.

Maybe he'll let you play with it later. Right now you need to find your hat.

>ask ninja for permission
Maybe he'll let you play with it later. Right now you need to find your hat.

>w.s.x ninja.x sticks.take sticks
Bedroom
This is the dormitory room you share with your three closest friends. There is a bed to the north, a wardrobe to the east, a bookshelf to the south, a food storage area to the west and a desk in the northwest corner.

As you approach the bookshelf, you notice a mouse hole to the left of it, in the southeast corner of the room.

On the Bookshelf
The rest of the room is north.

The tiny green ninja is pacing back and forth.

This ninja is wearing green and carries a set of nunchaku. He seems anxious.

It's a set of tiny sticks connected with a chain.

You should never touch another ninja's weapon without permission.

>n.w.x ninja.x sai.take sai.ask permission
Bedroom
This is the dormitory room you share with your three closest friends. There is a bed to the north, a wardrobe to the east, a bookshelf to the south, a food storage area to the west and a desk in the northwest corner.

Behind the Mini Fridge
The rest of the room is east.

The tiny red ninja is here, nibbling anxiously on a cookie. He seems angry.

This ninja is dressed all in red and carries a pair of sai. He is scowling.

It's a set of tiny three-pronged daggers.

You should never touch another ninja's weapon without permission.

Maybe he'll let you play with it later. Right now you need to find your hat.

>throw shuriken upwards
I only understood you as far as wanting to throw the shuriken.

>throw shuriken w
I only understood you as far as wanting to throw the shuriken.

* * *

The talent show is tonight, and you promised to emcee. But first you need to find your hat.

The Legend of the Missing Hat
A tiny adventure by Adri
Release 1 / Serial number 140106 / Inform 7 build 6G60 (I6/v6.32 lib 6/12N) SD

Under the Bed
This is where you live. The rest of the room is south, and there's a particularly dusty looking corner to the east.

>throw shuriken up
I only understood you as far as wanting to throw the shuriken.

* * *

>i
You are carrying:
  a hat
  your shuriken

>throw hat up
You can't see any such thing.

>e.x glint.cut web
Far Corner of the Bed
This corner doesn't seem to get cleaned often. There is a rather large spider web stretched between the foot of the bed and the wall. Thankfully its inhabitant is nowhere to be found. The rest of the room is southwest.

It's a pearl earring in a silver setting. It's about the size of your head.

(with the shuriken)
You throw the shuriken at the web, slicing easily through the sticky material. The pearl drops to the ground.

>take pearl.throw pearl up
As you stoop to pick up the pearl, the spider sneaks in and fixes its web.

You can't see any such thing.

>trhrthrow pearl
That's not a verb I recognize.

>throw pearl
Dropped.

>w.s.nw
You pause to retrieve your shuriken.

Under the Bed
This is where you live. The rest of the room is south, and there's a particularly dusty looking corner to the east.

Bedroom
This is the dormitory room you share with your three closest friends. There is a bed to the north, a wardrobe to the east, a bookshelf to the south, a food storage area to the west and a desk in the northwest corner.

Below the Desk
You can see sunlight above you. The rest of the room is southeast.

>throw shuriken up
You won't be able to retrieve that. Maybe if you tied something to it?

* * *

The talent show is tonight, and you promised to emcee. But first you need to find your hat.

The Legend of the Missing Hat
A tiny adventure by Adri
Release 1 / Serial number 140106 / Inform 7 build 6G60 (I6/v6.32 lib 6/12N) SD

Under the Bed
This is where you live. The rest of the room is south, and there's a particularly dusty looking corner to the east.

>s.nw.put star on desk
Bedroom
This is the dormitory room you share with your three closest friends. There is a bed to the north, a wardrobe to the east, a bookshelf to the south, a food storage area to the west and a desk in the northwest corner.

Below the Desk
You can see sunlight above you. The rest of the room is southeast.

You won't be able to retrieve that. Maybe if you tied something to it?

>put star on ledge
You won't be able to retrieve that. Maybe if you tied something to it?

>upcheat
That's not a verb I recognize.

>cheat
On the Desk
Sunlight streams in through the window. There is a pot here containing tiny purple flowers.

>put star on desk
You won't be able to retrieve that. Maybe if you tied something to it?

* * *

The talent show is tonight, and you promised to emcee. But first you need to find your hat.

The Legend of the Missing Hat
A tiny adventure by Adri
Release 1 / Serial number 140106 / Inform 7 build 6G60 (I6/v6.32 lib 6/12N) SD

Under the Bed
This is where you live. The rest of the room is south, and there's a particularly dusty looking corner to the east.

>s.nw.put star on desk.put star on ledge
Bedroom
This is the dormitory room you share with your three closest friends. There is a bed to the north, a wardrobe to the east, a bookshelf to the south, a food storage area to the west and a desk in the northwest corner.

Below the Desk
You can see sunlight above you. The rest of the room is southeast.

You won't be able to retrieve that. Maybe if you tied something to it?

You won't be able to retrieve that. Maybe if you tied something to it?

>cheat
On the Desk
Sunlight streams in through the window. There is a pot here containing tiny purple flowers.

>put star on desk.put star on ledge
Putting things on the ledge would achieve nothing.

Putting things on the ledge would achieve nothing.

* * *

The talent show is tonight, and you promised to emcee. But first you need to find your hat.

The Legend of the Missing Hat
A tiny adventure by Adri
Release 1 / Serial number 140106 / Inform 7 build 6G60 (I6/v6.32 lib 6/12N) SD

Under the Bed
This is where you live. The rest of the room is south, and there's a particularly dusty looking corner to the east.

>s.nw.cheat
Bedroom
This is the dormitory room you share with your three closest friends. There is a bed to the north, a wardrobe to the east, a bookshelf to the south, a food storage area to the west and a desk in the northwest corner.

Below the Desk
You can see sunlight above you. The rest of the room is southeast.

>put star on desk.put star on ledge.put rope on desk.put rope on ledge.put pearl on desk.put pearl on ledge.
You won't be able to retrieve that. Maybe if you tied something to it?

You won't be able to retrieve that. Maybe if you tied something to it?

You can't seem to throw the yarn that high. Maybe if you tied it to something?

You can't seem to throw the yarn that high. Maybe if you tied it to something?

It's not nice to throw things.

It's not nice to throw things.

>make grappling hook
You tie the yarn to the shuriken, creating a grappling hook.

>put star on desk
You throw the grappling hook at the desk. It catches in the wood. You scramble up the length of yarn.

On the Desk
Sunlight streams in through the window. There is a pot here containing tiny purple flowers.

You can see a grappling hook here.

>put hook on desk.put hook on ledge.put pearl on desk.put pearl on ledge
(first taking the grappling hook)

You should leave that where it is. You'll need it to climb back down.
You need to be holding the grappling hook before you can put it on top of something else.

(first taking the grappling hook)

You should leave that where it is. You'll need it to climb back down.
You need to be holding the grappling hook before you can put it on top of something else.

Putting things on the ledge would achieve nothing.

Putting things on the ledge would achieve nothing.

>down
You slide down the length of yarn. You give the yarn a good yank and the grappling hook returns to you.

Below the Desk
You can see sunlight above you. The rest of the room is southeast.

>throw hook up
You throw the grappling hook at the desk. It catches in the wood. You scramble up the length of yarn.

On the Desk
Sunlight streams in through the window. There is a pot here containing tiny purple flowers.

You can see a grappling hook here.

>break window
Violence isn't the answer to this one.

* * *

The talent show is tonight, and you promised to emcee. But first you need to find your hat.

The Legend of the Missing Hat
A tiny adventure by Adri
Release 1 / Serial number 140106 / Inform 7 build 6G60 (I6/v6.32 lib 6/12N) SD

Under the Bed
This is where you live. The rest of the room is south, and there's a particularly dusty looking corner to the east.

>s.e.attack ninja.attack me.w.se.attack mouse
Bedroom
This is the dormitory room you share with your three closest friends. There is a bed to the north, a wardrobe to the east, a bookshelf to the south, a food storage area to the west and a desk in the northwest corner.

You knock on the door of the wardrobe, and the blue ninja peeks his head out. 

Outside the Wardrobe
The rest of the room is west.

The tiny blue ninja stands in the doorway. He doesn't seem eager to invite you inside.

He's your friend. You have no reason to attack him.

He's your friend. You have no reason to attack him.

Bedroom
This is the dormitory room you share with your three closest friends. There is a bed to the north, a wardrobe to the east, a bookshelf to the south, a food storage area to the west and a desk in the northwest corner.

Inside the Mouse Hole
The rest of the room is back to the northwest.

There is a mouse here, lazing around in its nest.

Surely there's a better way to resolve this.

* * *

The talent show is tonight, and you promised to emcee. But first you need to find your hat.

The Legend of the Missing Hat
A tiny adventure by Adri
Release 1 / Serial number 140106 / Inform 7 build 6G60 (I6/v6.32 lib 6/12N) SD

Under the Bed
This is where you live. The rest of the room is south, and there's a particularly dusty looking corner to the east.

>attack me.e.x glint.attack web.attack web with star
Violence isn't the answer to this one.

Far Corner of the Bed
This corner doesn't seem to get cleaned often. There is a rather large spider web stretched between the foot of the bed and the wall. Thankfully its inhabitant is nowhere to be found. The rest of the room is southwest.

It's a pearl earring in a silver setting. It's about the size of your head.

You don't want to touch that with your bare hands.

You throw the shuriken at the web, slicing easily through the sticky material. The pearl drops to the ground.

>attack spider.take pearl.attack spider.
You can't see that here. Thankfully.

As you stoop to pick up the pearl, the spider sneaks in and fixes its web.

The spider seems to have vanished again.

>attack web with star.g
You throw the shuriken at the web, slicing easily through the sticky material.

The spider comes out, shakes several tiny fists at you, and repairs the web. It slips off again.

You throw the shuriken at the web, slicing easily through the sticky material.

*** The spider bites you. You die. ***

Not really. But knock it off.

>attack spider.attack web.attack web with star
The spider bares its fangs at you. You decide to leave it alone.

You don't want to touch that with your bare hands.

The spider bares its fangs at you. You decide to leave it alone.

>sw.e.attack ninja.attack wardrobe
You pause to retrieve your shuriken.

Bedroom
This is the dormitory room you share with your three closest friends. There is a bed to the north, a wardrobe to the east, a bookshelf to the south, a food storage area to the west and a desk in the northwest corner.

You knock on the door of the wardrobe, and the blue ninja peeks his head out. 

Outside the Wardrobe
The rest of the room is west.

The tiny blue ninja stands in the doorway. He doesn't seem eager to invite you inside.

Violence isn't the answer to this one.

Violence isn't the answer to this one.

* * *

The talent show is tonight, and you promised to emcee. But first you need to find your hat.

The Legend of the Missing Hat
A tiny adventure by Adri
Release 1 / Serial number 140106 / Inform 7 build 6G60 (I6/v6.32 lib 6/12N) SD

Under the Bed
This is where you live. The rest of the room is south, and there's a particularly dusty looking corner to the east.

>attack me
You're not that upset about the hat, are you?

>attack star.attack bed
Violence isn't the answer to this one.

Violence isn't the answer to this one.

* * *

The talent show is tonight, and you promised to emcee. But first you need to find your hat.

The Legend of the Missing Hat
A tiny adventure by Adri
Release 1 / Serial number 140106 / Inform 7 build 6G60 (I6/v6.32 lib 6/12N) SD

Under the Bed
This is where you live. The rest of the room is south, and there's a particularly dusty looking corner to the east.

>attack me.attack star.attack bed
You're not that upset about the hat, are you?

There's no need to be so destructive.

There's no need to be so destructive.

* * *

The talent show is tonight, and you promised to emcee. But first you need to find your hat.

The Legend of the Missing Hat
A tiny adventure by Adri
Release 1 / Serial number 140106 / Inform 7 build 6G60 (I6/v6.32 lib 6/12N) SD

Under the Bed
This is where you live. The rest of the room is south, and there's a particularly dusty looking corner to the east.

>attack me with star
You're not that upset about the hat, are you?

>e.attack web with star
Far Corner of the Bed
This corner doesn't seem to get cleaned often. There is a rather large spider web stretched between the foot of the bed and the wall. Thankfully its inhabitant is nowhere to be found. The rest of the room is southwest.

Why don't you look more closely at the web before you destroy it?

>sw.e.attack ninja.attack wardrobe
Bedroom
This is the dormitory room you share with your three closest friends. There is a bed to the north, a wardrobe to the east, a bookshelf to the south, a food storage area to the west and a desk in the northwest corner.

You knock on the door of the wardrobe, and the blue ninja peeks his head out. 

Outside the Wardrobe
The rest of the room is west.

The tiny blue ninja stands in the doorway. He doesn't seem eager to invite you inside.

He's your friend. You have no reason to attack him.

There's no need to be so destructive.

>attack hat
You can't see any such thing.

>w.se.attack nest.attack mouse
Bedroom
This is the dormitory room you share with your three closest friends. There is a bed to the north, a wardrobe to the east, a bookshelf to the south, a food storage area to the west and a desk in the northwest corner.

Inside the Mouse Hole
The rest of the room is back to the northwest.

There is a mouse here, lazing around in its nest.

There's no need to be so destructive.

Surely there's a better way to resolve this.

>attack mouse with star.attack nest with star
Surely there's a better way to resolve this.

There's no need to be so destructive.

>cut mouse with star
Surely there's a better way to resolve this.

* * *

The talent show is tonight, and you promised to emcee. But first you need to find your hat.

The Legend of the Missing Hat
A tiny adventure by Adri
Release 1 / Serial number 140106 / Inform 7 build 6G60 (I6/v6.32 lib 6/12N) SD

Under the Bed
This is where you live. The rest of the room is south, and there's a particularly dusty looking corner to the east.

>cut me with shuriken.cut star with star.cut bed with star
You're not that upset about the hat, are you?

There's no need to be so destructive.

There's no need to be so destructive.

* * *

>cut rope with star.cut hat with star
That's a terrible idea.

You can't see any such thing.

>cut pearl with star
There's no need to be so destructive.

>e.cut web with star.x glint.cut web with star
Far Corner of the Bed
This corner doesn't seem to get cleaned often. There is a rather large spider web stretched between the foot of the bed and the wall. Thankfully its inhabitant is nowhere to be found. The rest of the room is southwest.

Why don't you look more closely at the web before you destroy it?

It's a pearl earring in a silver setting. It's about the size of your head.

You throw the shuriken at the web, slicing easily through the sticky material. The pearl drops to the ground.

>s.e.cut ninja with star.w.se.cut mouse with star
You pause to retrieve your shuriken.

You can't go that way.

You can't go that way.

You can't see any such thing.

>sw.e.cut ninja with star.w.se.cut mouse with star
Bedroom
This is the dormitory room you share with your three closest friends. There is a bed to the north, a wardrobe to the east, a bookshelf to the south, a food storage area to the west and a desk in the northwest corner.

You knock on the door of the wardrobe, and the blue ninja peeks his head out. 

Outside the Wardrobe
The rest of the room is west.

The tiny blue ninja stands in the doorway. He doesn't seem eager to invite you inside.

He's your friend. You have no reason to attack him.

Bedroom
This is the dormitory room you share with your three closest friends. There is a bed to the north, a wardrobe to the east, a bookshelf to the south, a food storage area to the west and a desk in the northwest corner.

Inside the Mouse Hole
The rest of the room is back to the northwest.

There is a mouse here, lazing around in its nest.

Surely there's a better way to resolve this.

* * *

The talent show is tonight, and you promised to emcee. But first you need to find your hat.

The Legend of the Missing Hat
A tiny adventure by Adri
Release 1 / Serial number 140106 / Inform 7 build 6G60 (I6/v6.32 lib 6/12N) SD

Under the Bed
This is where you live. The rest of the room is south, and there's a particularly dusty looking corner to the east.

>s.w.take cookie.cheat
Bedroom
This is the dormitory room you share with your three closest friends. There is a bed to the north, a wardrobe to the east, a bookshelf to the south, a food storage area to the west and a desk in the northwest corner.

Behind the Mini Fridge
The rest of the room is east.

The tiny red ninja is here, nibbling anxiously on a cookie. He seems angry.

The red ninja pulls the cookie away. "Mine!"

>take cookie.drop cookie.take cookie
You already have that.

Dropped.

Taken.

>e.se.give cookie to mouse.take cookie
Bedroom
This is the dormitory room you share with your three closest friends. There is a bed to the north, a wardrobe to the east, a bookshelf to the south, a food storage area to the west and a desk in the northwest corner.

Inside the Mouse Hole
The rest of the room is back to the northwest.

There is a mouse here, lazing around in its nest.

You give the cookie to the mouse. It grabs it out of your hands and retreats to the corner with it.

The mouse doesn't seem eager to give it back.

* * *

>s.w.take cookie.cheat
Bedroom
This is the dormitory room you share with your three closest friends. There is a bed to the north, a wardrobe to the east, a bookshelf to the south, a food storage area to the west and a desk in the northwest corner.

Behind the Mini Fridge
The rest of the room is east.

The tiny red ninja is here, nibbling anxiously on a cookie. He seems angry.

The red ninja pulls the cookie away. "Mine!"

>take cookie
You already have that.

>drop cookie.take cookie
Dropped.

Taken.

* * *

The talent show is tonight, and you promised to emcee. But first you need to find your hat.

The Legend of the Missing Hat
A tiny adventure by Adri
Release 1 / Serial number 140106 / Inform 7 build 6G60 (I6/v6.32 lib 6/12N) SD

Under the Bed
This is where you live. The rest of the room is south, and there's a particularly dusty looking corner to the east.

>s.e.x glint.cut web with shuriken.take pearl.sw.e
Bedroom
This is the dormitory room you share with your three closest friends. There is a bed to the north, a wardrobe to the east, a bookshelf to the south, a food storage area to the west and a desk in the northwest corner.

You knock on the door of the wardrobe, and the blue ninja peeks his head out. 

Outside the Wardrobe
The rest of the room is west.

The tiny blue ninja stands in the doorway. He doesn't seem eager to invite you inside.

You can't see any such thing.

>w.n
Bedroom
This is the dormitory room you share with your three closest friends. There is a bed to the north, a wardrobe to the east, a bookshelf to the south, a food storage area to the west and a desk in the northwest corner.

Under the Bed
This is where you live. The rest of the room is south, and there's a particularly dusty looking corner to the east.

>e.x glint.cut web with shuriken.take pearl.sw.e
Far Corner of the Bed
This corner doesn't seem to get cleaned often. There is a rather large spider web stretched between the foot of the bed and the wall. Thankfully its inhabitant is nowhere to be found. The rest of the room is southwest.

It's a pearl earring in a silver setting. It's about the size of your head.

You throw the shuriken at the web, slicing easily through the sticky material. The pearl drops to the ground.

As you stoop to pick up the pearl, the spider sneaks in and fixes its web.

You pause to retrieve your shuriken.

Bedroom
This is the dormitory room you share with your three closest friends. There is a bed to the north, a wardrobe to the east, a bookshelf to the south, a food storage area to the west and a desk in the northwest corner.

You knock on the door of the wardrobe, and the blue ninja peeks his head out. 

Outside the Wardrobe
The rest of the room is west.

The tiny blue ninja stands in the doorway. He doesn't seem eager to invite you inside.

>take hat.take tie
You can't see any such thing.

>w.s.take notebook.give pearl to green
Bedroom
This is the dormitory room you share with your three closest friends. There is a bed to the north, a wardrobe to the east, a bookshelf to the south, a food storage area to the west and a desk in the northwest corner.

As you approach the bookshelf, you notice a mouse hole to the left of it, in the southeast corner of the room.

On the Bookshelf
The rest of the room is north.

The tiny green ninja is pacing back and forth.

The green ninja shoves you away. "That belongs to me."

The green ninja oohs and ahhs over the pearl. He gives you a notebook. "Here. I don't need this anymore. It's just cheap junk."

[Your score has just gone up by twenty-five points.]

>drop notebook.take notebook.take pearl
Dropped.

Taken.

That seems like a terrible idea.

>n.w.take cookie.take pencil.give notebook to ninja
Bedroom
This is the dormitory room you share with your three closest friends. There is a bed to the north, a wardrobe to the east, a bookshelf to the south, a food storage area to the west and a desk in the northwest corner.

Behind the Mini Fridge
The rest of the room is east.

The tiny red ninja is here, nibbling anxiously on a cookie. He seems angry.

The red ninja pulls the cookie away. "Mine!"

The red ninja seems to be using that.

The red ninja takes the notebook and looks at it for a moment. Then he pulls out a pencil and starts scribbling away. His mood seems to lighten as he fills the pages with his thoughts. Eventually he glances up at you, smiling. "Thank you. I needed that." He hands you the half-eaten cookie. "Would you like a cookie?"

[Your score has just gone up by twenty-five points.]

>drop cookie.take cookie.take pencil.take notebook
Dropped.

Taken.

The red ninja seems to be using that.

That belongs to the red ninja now.

* * *

>e.se.give cookie to mouse.take cookie
Bedroom
This is the dormitory room you share with your three closest friends. There is a bed to the north, a wardrobe to the east, a bookshelf to the south, a food storage area to the west and a desk in the northwest corner.

Inside the Mouse Hole
The rest of the room is back to the northwest.

There is a mouse here, lazing around in its nest.

You give the cookie to the mouse. It grabs it out of your hands and retreats to the corner with it.

The mouse doesn't seem eager to give it back.

>nw.e.give flowers to blue
You scurry off before the mouse can ask for a glass of milk.

Bedroom
This is the dormitory room you share with your three closest friends. There is a bed to the north, a wardrobe to the east, a bookshelf to the south, a food storage area to the west and a desk in the northwest corner. There is a mouse hole in the southeast corner of the room, next to the bookshelf.

You knock on the door of the wardrobe, and the blue ninja peeks his head out. 

Outside the Wardrobe
The rest of the room is west.

The tiny blue ninja stands in the doorway. He doesn't seem eager to invite you inside.

The blue ninja stares at you for a moment. Finally he accepts the bouquet, and smells the flowers, inhaling deeply. He looks at you, smiling. "Thank you. That is very sweet of you. Let me go find your hat. Would you like to come in?" He invites you inside the wardrobe while he digs around in piles of stuff. "Here is your hat. And would you like this bow tie as well?" He hands both items to you.

[Your score has just gone up by twenty-five points.]

>take flowers
You can't take those back! It would be very mean.

* * *

The talent show is tonight, and you promised to emcee. But first you need to find your hat.

The Legend of the Missing Hat
A tiny adventure by Adri
Release 1 / Serial number 140106 / Inform 7 build 6G60 (I6/v6.32 lib 6/12N) SD

Under the Bed
This is where you live. The rest of the room is south, and there's a particularly dusty looking corner to the east.

>s.w.x pencil.take pencil
Bedroom
This is the dormitory room you share with your three closest friends. There is a bed to the north, a wardrobe to the east, a bookshelf to the south, a food storage area to the west and a desk in the northwest corner.

Behind the Mini Fridge
The rest of the room is east.

The tiny red ninja is here, nibbling anxiously on a cookie. He seems angry.

It's a tiny pencil.

That seems to belong to the red ninja.

* * *

The talent show is tonight, and you promised to emcee. But first you need to find your hat.

The Legend of the Missing Hat
A tiny adventure by Adri
Release 1 / Serial number 140106 / Inform 7 build 6G60 (I6/v6.32 lib 6/12N) SD

Under the Bed
This is where you live. The rest of the room is south, and there's a particularly dusty looking corner to the east.

>s.w.x pencil.take pencil.cheat
Bedroom
This is the dormitory room you share with your three closest friends. There is a bed to the north, a wardrobe to the east, a bookshelf to the south, a food storage area to the west and a desk in the northwest corner.

Behind the Mini Fridge
The rest of the room is east.

The tiny red ninja is here, nibbling anxiously on a cookie. He seems angry.

You can't see any such thing.

* * *

>ask ninja about pencil
The red ninja shrugs. "I always carry a pencil with me."

>give notebook to ninja.take notebook.take pencil
The red ninja takes the notebook and looks at it for a moment. Then he pulls out a pencil and starts scribbling away. His mood seems to lighten as he fills the pages with his thoughts. Eventually he glances up at you, smiling. "Thank you. I needed that." He hands you the half-eaten cookie. "Would you like a cookie?"

[Your score has just gone up by twenty-five points.]

Maybe he'll let you see it when he's finished.

The red ninja seems to be using that.

* * *

The talent show is tonight, and you promised to emcee. But first you need to find your hat.

The Legend of the Missing Hat
A tiny adventure by Adri
Release 1 / Serial number 140106 / Inform 7 build 6G60 (I6/v6.32 lib 6/12N) SD

Under the Bed
This is where you live. The rest of the room is south, and there's a particularly dusty looking corner to the east.

>throw star up.throw rope up
I only understood you as far as wanting to throw the shuriken.

You can't see any such thing.

* * *

>s.nw.throw rope up.throw star up
Bedroom
This is the dormitory room you share with your three closest friends. There is a bed to the north, a wardrobe to the east, a bookshelf to the south, a food storage area to the west and a desk in the northwest corner.

Below the Desk
You can see sunlight above you. The rest of the room is southeast.

You can't seem to throw the yarn that high. Maybe if you tied it to something?

You won't be able to retrieve that. Maybe if you tied something to it?

>make grappling hook.throw rope up
You tie the yarn to the shuriken, creating a grappling hook.

You throw the grappling hook at the desk. It catches in the wood. You scramble up the length of yarn.

On the Desk
Sunlight streams in through the window. There is a pot here containing tiny purple flowers.

You can see a grappling hook here.

>quit
Are you sure you want to quit?

* * *

The talent show is tonight, and you promised to emcee. But first you need to find your hat.

The Legend of the Missing Hat
A tiny adventure by Adri
Release 1 / Serial number 140106 / Inform 7 build 6G60 (I6/v6.32 lib 6/12N) SD

Under the Bed
This is where you live. The rest of the room is south, and there's a particularly dusty looking corner to the east.

>ask red about anger
You can't see any such thing.

* * *

>x red
This ninja is dressed all in red and carries a pair of sai. He is scowling.

>x anger
You see nothing special about Anger.

>take anger
There's no way you could lift that. Nor do you have any reason to.

>ask red about anger
The red ninja shakes his head. "I don't know anything about that."

* * *

The talent show is tonight, and you promised to emcee. But first you need to find your hat.

The Legend of the Missing Hat
A tiny adventure by Adri
Release 1 / Serial number 140106 / Inform 7 build 6G60 (I6/v6.32 lib 6/12N) SD

Under the Bed
This is where you live. The rest of the room is south, and there's a particularly dusty looking corner to the east.

>x sfw
You can't see any such thing.

>ask about anger
There's no one here to talk to.

* * *

The talent show is tonight, and you promised to emcee. But first you need to find your hat.

The Legend of the Missing Hat
A tiny adventure by Adri
Release 1 / Serial number 140106 / Inform 7 build 6G60 (I6/v6.32 lib 6/12N) SD

Under the Bed
This is where you live. The rest of the room is south, and there's a particularly dusty looking corner to the east.

>cheat.ask red about anger
There is no reply.

>ask red about anger
There is no reply.

>ask red about foobarbaz
The red ninja shakes his head. "I don't know anything about that."

* * *

The talent show is tonight, and you promised to emcee. But first you need to find your hat.

The Legend of the Missing Hat
A tiny adventure by Adri
Release 1 / Serial number 140106 / Inform 7 build 6G60 (I6/v6.32 lib 6/12N) SD

Under the Bed
This is where you live. The rest of the room is south, and there's a particularly dusty looking corner to the east.

>x anger
You can't see any such thing.

>cheat.ask red about anger
There is no reply.

>talk to red
There is no reply.

>talk to red ninja
There is no reply.

>l
Under the Bed
This is where you live. The rest of the room is south, and there's a particularly dusty looking corner to the east.

The tiny green ninja is pacing back and forth.

The tiny red ninja is here, nibbling anxiously on a cookie. He seems angry.

The tiny blue ninja stands in the doorway. He doesn't seem eager to invite you inside.

>restart
Are you sure you want to restart?

>y
The talent show is tonight, and you promised to emcee. But first you need to find your hat.

Ninjas!
A tiny adventure by Adri
Release 1 / Serial number 120609 / Inform 7 build 6G60 (I6/v6.32 lib 6/12N) SD

Under the Bed
This is where you live. The rest of the room is south, and there's a particularly dusty looking corner to the east.

>s.w.talk to red
Bedroom
This is the dormitory room you share with your three closest friends. There is a bed to the north, a wardrobe to the east, a bookshelf to the south, a food storage area to the west and a desk in the northwest corner.

Behind the Mini Fridge
The rest of the room is east.

The tiny red ninja is here, nibbling anxiously on a cookie. He seems angry.

The red ninja grumbles. He says, "Leave me alone. I hate everyone."

>ask red about anger
The red ninja grumbles. He says, "Leave me alone. I hate everyone."

* * *

The talent show is tonight, and you promised to emcee. But first you need to find your hat.

The Legend of the Missing Hat
A tiny adventure by Adri
Release 1 / Serial number 140106 / Inform 7 build 6G60 (I6/v6.32 lib 6/12N) SD

Under the Bed
This is where you live. The rest of the room is south, and there's a particularly dusty looking corner to the east.

>s.e.ask blue about sadness.ask blue about depression
Bedroom
This is the dormitory room you share with your three closest friends. There is a bed to the north, a wardrobe to the east, a bookshelf to the south, a food storage area to the west and a desk in the northwest corner.

You knock on the door of the wardrobe, and the blue ninja peeks his head out. 

Outside the Wardrobe
The rest of the room is west.

The tiny blue ninja stands in the doorway. He doesn't seem eager to invite you inside.

The blue ninja shrugs.

>w.w.ask red about anger
Bedroom
This is the dormitory room you share with your three closest friends. There is a bed to the north, a wardrobe to the east, a bookshelf to the south, a food storage area to the west and a desk in the northwest corner.

Behind the Mini Fridge
The rest of the room is east.

The tiny red ninja is here, nibbling anxiously on a cookie. He seems angry.

The red ninja grumbles. He says, "Leave me alone. I hate everyone."

* * *

The talent show is tonight, and you promised to emcee. But first you need to find your hat.

The Legend of the Missing Hat
A tiny adventure by Adri
Release 1 / Serial number 140106 / Inform 7 build 6G60 (I6/v6.32 lib 6/12N) SD

Under the Bed
This is where you live. The rest of the room is south, and there's a particularly dusty looking corner to the east.

>s.e.ask ninja about sadness
Bedroom
This is the dormitory room you share with your three closest friends. There is a bed to the north, a wardrobe to the east, a bookshelf to the south, a food storage area to the west and a desk in the northwest corner.

You knock on the door of the wardrobe, and the blue ninja peeks his head out. 

Outside the Wardrobe
The rest of the room is west.

The tiny blue ninja stands in the doorway. He doesn't seem eager to invite you inside.

The blue ninja sniffles. He says, "I think you ought to know I'm feeling very depressed."

* * *

The talent show is tonight, and you promised to emcee. But first you need to find your hat.

The Legend of the Missing Hat
A tiny adventure by Adri
Release 1 / Serial number 140106 / Inform 7 build 6G60 (I6/v6.32 lib 6/12N) SD

Under the Bed
This is where you live. The rest of the room is south, and there's a particularly dusty looking corner to the east.

>s.e.ask about pencil.w.s.ask about pencil.n.w.ask about pencil
Bedroom
This is the dormitory room you share with your three closest friends. There is a bed to the north, a wardrobe to the east, a bookshelf to the south, a food storage area to the west and a desk in the northwest corner.

You knock on the door of the wardrobe, and the blue ninja peeks his head out. 

Outside the Wardrobe
The rest of the room is west.

The tiny blue ninja stands in the doorway. He doesn't seem eager to invite you inside.

(addressing the blue ninja)
The red ninja shakes his head. "I might have one, somewhere in this mess. But I'm not going to look for it."

Bedroom
This is the dormitory room you share with your three closest friends. There is a bed to the north, a wardrobe to the east, a bookshelf to the south, a food storage area to the west and a desk in the northwest corner.

As you approach the bookshelf, you notice a mouse hole to the left of it, in the southeast corner of the room.

On the Bookshelf
The rest of the room is north.

The tiny green ninja is pacing back and forth.

(addressing the green ninja)
The green ninja shakes his head. "I don't have one. Sorry."

Bedroom
This is the dormitory room you share with your three closest friends. There is a bed to the north, a wardrobe to the east, a bookshelf to the south, a food storage area to the west and a desk in the northwest corner.

Behind the Mini Fridge
The rest of the room is east.

The tiny red ninja is here, nibbling anxiously on a cookie. He seems angry.

(addressing the red ninja)
The red ninja shrugs. "I always carry a pencil with me."

* * *

The talent show is tonight, and you promised to emcee. But first you need to find your hat.

The Legend of the Missing Hat
A tiny adventure by Adri
Release 1 / Serial number 140106 / Inform 7 build 6G60 (I6/v6.32 lib 6/12N) SD

Under the Bed
This is where you live. The rest of the room is south, and there's a particularly dusty looking corner to the east.

>dance
You somehow manage to trip. You stand up and brush yourself off.

* * *

The talent show is tonight, and you promised to emcee. But first you need to find your hat.

The Legend of the Missing Hat
A tiny adventure by Adri
Release 1 / Serial number 140106 / Inform 7 build 6G60 (I6/v6.32 lib 6/12N) SD

Under the Bed
This is where you live. The rest of the room is south, and there's a particularly dusty looking corner to the east.

>cheat.s.se.show hat to mouse.give hat to mouse
Bedroom
This is the dormitory room you share with your three closest friends. There is a bed to the north, a wardrobe to the east, a bookshelf to the south, a food storage area to the west and a desk in the northwest corner.

Inside the Mouse Hole
The rest of the room is back to the northwest.

There is a mouse here, lazing around in its nest.

The mouse seems quietly impressed by your hat.

The mouse nibbles a bit on the brim. You pull the hat away.

* * *

The talent show is tonight, and you promised to emcee. But first you need to find your hat.

The Legend of the Missing Hat
A tiny adventure by Adri
Release 1 / Serial number 140106 / Inform 7 build 6G60 (I6/v6.32 lib 6/12N) SD

Under the Bed
This is where you live. The rest of the room is south, and there's a particularly dusty looking corner to the east.

>cheat.s.e.show bow tie to blue
Bedroom
This is the dormitory room you share with your three closest friends. There is a bed to the north, a wardrobe to the east, a bookshelf to the south, a food storage area to the west and a desk in the northwest corner.

You knock on the door of the wardrobe, and the blue ninja peeks his head out. 

Outside the Wardrobe
The rest of the room is west.

The tiny blue ninja stands in the doorway. He doesn't seem eager to invite you inside.

The blue ninja smiles. "It's rather silly. But I think it suits you."

>w.s.show bow tie to green
Bedroom
This is the dormitory room you share with your three closest friends. There is a bed to the north, a wardrobe to the east, a bookshelf to the south, a food storage area to the west and a desk in the northwest corner.

As you approach the bookshelf, you notice a mouse hole to the left of it, in the southeast corner of the room.

On the Bookshelf
The rest of the room is north.

The tiny green ninja is pacing back and forth.

The green ninja says, "That is a ridiculous bow tie."

>n.w.show bow tie to red
Bedroom
This is the dormitory room you share with your three closest friends. There is a bed to the north, a wardrobe to the east, a bookshelf to the south, a food storage area to the west and a desk in the northwest corner.

Behind the Mini Fridge
The rest of the room is east.

The tiny red ninja is here, nibbling anxiously on a cookie. He seems angry.

The red ninja smirks. "Nice tie."

>talk to red about life
I only understood you as far as wanting to talk to the red ninja.

* * *

The talent show is tonight, and you promised to emcee. But first you need to find your hat.

The Legend of the Missing Hat
A tiny adventure by Adri
Release 1 / Serial number 140106 / Inform 7 build 6G60 (I6/v6.32 lib 6/12N) SD

Under the Bed
This is where you live. The rest of the room is south, and there's a particularly dusty looking corner to the east.

>s.e.ask about kama.w.s.ask about nunchaku.n.w.ask about sai
Bedroom
This is the dormitory room you share with your three closest friends. There is a bed to the north, a wardrobe to the east, a bookshelf to the south, a food storage area to the west and a desk in the northwest corner.

You knock on the door of the wardrobe, and the blue ninja peeks his head out. 

Outside the Wardrobe
The rest of the room is west.

The tiny blue ninja stands in the doorway. He doesn't seem eager to invite you inside.

(addressing the blue ninja)
The blue ninja says, "It's kind of a useless weapon, isn't it?"

Bedroom
This is the dormitory room you share with your three closest friends. There is a bed to the north, a wardrobe to the east, a bookshelf to the south, a food storage area to the west and a desk in the northwest corner.

As you approach the bookshelf, you notice a mouse hole to the left of it, in the southeast corner of the room.

On the Bookshelf
The rest of the room is north.

The tiny green ninja is pacing back and forth.

(addressing the green ninja)
The green ninja says, "They're much nicer than your shuriken."

Bedroom
This is the dormitory room you share with your three closest friends. There is a bed to the north, a wardrobe to the east, a bookshelf to the south, a food storage area to the west and a desk in the northwest corner.

Behind the Mini Fridge
The rest of the room is east.

The tiny red ninja is here, nibbling anxiously on a cookie. He seems angry.

(addressing the red ninja)
The red ninja says, "They're mine. That's all you need to know."

* * *

The talent show is tonight, and you promised to emcee. But first you need to find your hat.

The Legend of the Missing Hat
A tiny adventure by Adri
Release 1 / Serial number 140106 / Inform 7 build 6G60 (I6/v6.32 lib 6/12N) SD

Under the Bed
This is where you live. The rest of the room is south, and there's a particularly dusty looking corner to the east.

>s.e.ask green about kama
Bedroom
This is the dormitory room you share with your three closest friends. There is a bed to the north, a wardrobe to the east, a bookshelf to the south, a food storage area to the west and a desk in the northwest corner.

You knock on the door of the wardrobe, and the blue ninja peeks his head out. 

Outside the Wardrobe
The rest of the room is west.

The tiny blue ninja stands in the doorway. He doesn't seem eager to invite you inside.

You can't see any such thing.

>ask about kama
(addressing the blue ninja)
The blue ninja says, "It's kind of a useless weapon, isn't it?"

>w.s.ask about nunchaku.n.w.ask about sai
Bedroom
This is the dormitory room you share with your three closest friends. There is a bed to the north, a wardrobe to the east, a bookshelf to the south, a food storage area to the west and a desk in the northwest corner.

As you approach the bookshelf, you notice a mouse hole to the left of it, in the southeast corner of the room.

On the Bookshelf
The rest of the room is north.

The tiny green ninja is pacing back and forth.

(addressing the green ninja)
The green ninja says, "They're much nicer than your shuriken."

Bedroom
This is the dormitory room you share with your three closest friends. There is a bed to the north, a wardrobe to the east, a bookshelf to the south, a food storage area to the west and a desk in the northwest corner.

Behind the Mini Fridge
The rest of the room is east.

The tiny red ninja is here, nibbling anxiously on a cookie. He seems angry.

(addressing the red ninja)
The red ninja says, "They're mine. That's all you need to know."

* * *

The talent show is tonight, and you promised to emcee. But first you need to find your hat.

The Legend of the Missing Hat
A tiny adventure by Adri
Release 1 / Serial number 140106 / Inform 7 build 6G60 (I6/v6.32 lib 6/12N) SD

Under the Bed
This is where you live. The rest of the room is south, and there's a particularly dusty looking corner to the east.

>cheat.s.w.ask about sai
Bedroom
This is the dormitory room you share with your three closest friends. There is a bed to the north, a wardrobe to the east, a bookshelf to the south, a food storage area to the west and a desk in the northwest corner.

Behind the Mini Fridge
The rest of the room is east.

The tiny red ninja is here, writing in his new notebook. He seems happy.

(addressing the red ninja)
The red ninja says, "I always wanted to be like Raphael when I grew up."

>e.e.ask about kama.
Bedroom
This is the dormitory room you share with your three closest friends. There is a bed to the north, a wardrobe to the east, a bookshelf to the south, a food storage area to the west and a desk in the northwest corner.

You knock on the door of the wardrobe, and the blue ninja peeks his head out. He invites you inside.

Inside the Wardrobe
The rest of the room is west.

The tiny blue ninja is sitting calmly, enjoying his new flowers.

(addressing the blue ninja)
The blue ninja says, "I really like my kama."

* * *

The talent show is tonight, and you promised to emcee. But first you need to find your hat.

The Legend of the Missing Hat
A tiny adventure by Adri
Release 1 / Serial number 140106 / Inform 7 build 6G60 (I6/v6.32 lib 6/12N) SD

Under the Bed
This is where you live. The rest of the room is south, and there's a particularly dusty looking corner to the east.

>s.s.ask for pencil
Bedroom
This is the dormitory room you share with your three closest friends. There is a bed to the north, a wardrobe to the east, a bookshelf to the south, a food storage area to the west and a desk in the northwest corner.

As you approach the bookshelf, you notice a mouse hole to the left of it, in the southeast corner of the room.

On the Bookshelf
The rest of the room is north.

The tiny green ninja is pacing back and forth.

(addressing the green ninja)
The green ninja shakes his head. "I don't have one. Sorry."

* * *

The talent show is tonight, and you promised to emcee. But first you need to find your hat.

The Legend of the Missing Hat
A tiny adventure by Adri
Release 1 / Serial number 140106 / Inform 7 build 6G60 (I6/v6.32 lib 6/12N) SD

Under the Bed
This is where you live. The rest of the room is south, and there's a particularly dusty looking corner to the east.

>s.se.hug mouse
Bedroom
This is the dormitory room you share with your three closest friends. There is a bed to the north, a wardrobe to the east, a bookshelf to the south, a food storage area to the west and a desk in the northwest corner.

Inside the Mouse Hole
The rest of the room is back to the northwest.

There is a mouse here, lazing around in its nest.

The mouse snaps at you.