Bureaucrocy
A frustrating tale about paperwork by Adri
Release 4 / Serial number 140601 / Inform 7 build 6G60 (I6/v6.32 lib 6/12N) SD

What is your name?

I don't know how to pronounce that. Your name will be Alexandra.

Gregarious Grange Subway Station
This is the subway station below Gregarious Grange, Groddle Meadow. A flight of stairs leads up to the street.

You can see a ticket dispenser here.

>up
Gregarious Grange
The entrance to the subway is down a flight of stairs. You can also go inside Bureaucratic Hall.

>in
Bureaucratic Hall
A sign proclaims this room to be the "Department of Administrative Affairs - Ministry of Departments". To the left is a waiting area with a water cooler and a bunch of hard, plastic orange chairs. To the right is a counter, behind which is a Bureaucroc. Another sign reads "Please approach the counter for assistance."

>approach counter
The bureaucroc says, "Go away. We don't have time to waste on people who have not learned any Bureaucratic Arts."

>z
Time passes.

>z
Time passes.

>sit
(on the chair)
You take a seat on one of their uncomfortable plastic chairs.

>up
You can't do anything while waiting. Just wait.

>z
Time passes.

>z
Time passes.

A bureaucroc calls out, "Alexandra! You're up!"

>z
Time passes.

The bureaucroc calls out again, "Did you hear me, Alexandra? Come take your turn, or lose your turn. Your choice."

>WAIT
Time passes.

The bureaucroc calls out again, "Did you want something, Alexandra? Now is your chance. Use it or lose it."

* * *

>in
Bureaucratic Hall
A sign proclaims this room to be the "Department of Administrative Affairs - Ministry of Departments". To the left is a waiting area with a water cooler and a bunch of hard, plastic orange chairs. To the right is a counter, behind which is a Bureaucroc. Another sign reads "Please approach the counter for assistance."

>approach
(the counter)
The bureaucroc says, "Go away. We don't have time to waste on people who have not learned any Bureaucratic Arts."

>sit
(on the chair)
You would rather not sit in one of those chairs unless you absolutely have to.

>stand
You are already standing.

>z
Time passes.

>WAIT
Time passes.

>WAIT
Time passes.

>z
Time passes.

>restart
Are you sure you want to restart?

>y
Bureaucrocy
A boring tale about paperwork by Adri
Release 1 / Serial number 140327 / Inform 7 build 6G60 (I6/v6.32 lib 6/12N) SD

What is your name?

>test intro
I don't know how to pronounce that. Your name will be Alexandra.

Bureaucrocy
A boring tale about paperwork by Adri
Release 1 / Serial number 140327 / Inform 7 build 6G60 (I6/v6.32 lib 6/12N) SD

Subway Station
This is the subway station below Gregarious Grange, Groddle Meadow. A flight of stairs leads up to the street.

You can see a ticket dispenser here.

>test wait
(Testing.)

>[1] sit
(on the 200 currants)
That's not something you can sit down on.

>[2] z
Time passes.

>[3] z
Time passes.

>[4] z
Time passes.

>[5] z
Time passes.

>[6] approach
If you can see an object, you can usually just interact with it directly without worrying about your position. Try a command like EXAMINE TICKET DISPENSER for a closer look at something, LOOK to get a new description of this location, or a direction like UP (or U) to move to a different location.

To stop these messages entirely, type NOVICE OFF.

>[7] z
Time passes.

>[8] y
That was a rhetorical question.

>[9] 1
That's not a verb I recognize.

>WAIT
Time passes.

>restart
Are you sure you want to restart?

* * *

>y
Bureaucrocy
A boring tale about paperwork by Adri
Release 1 / Serial number 140327 / Inform 7 build 6G60 (I6/v6.32 lib 6/12N) SD

What is your name?

I don't know how to pronounce that. Your name will be Alexandra.

Bureaucrocy
A boring tale about paperwork by Adri
Release 1 / Serial number 140327 / Inform 7 build 6G60 (I6/v6.32 lib 6/12N) SD

Subway Station
This is the subway station below Gregarious Grange, Groddle Meadow. A flight of stairs leads up to the street.

You can see a ticket dispenser here.

>test intro
(Testing.)

>[1] up

Gregarious Grange
The entrance to the subway is down a flight of stairs. You can also go inside Bureaucratic Hall.

>[2] down

Subway Station
This is the subway station below Gregarious Grange, Groddle Meadow. A flight of stairs leads up to the street.

You can see a ticket dispenser here.

>[3] up

Gregarious Grange
The entrance to the subway is down a flight of stairs. You can also go inside Bureaucratic Hall.

>[4] down
As you make your way back down to the Subway Station, a Bureaucroc corners you on the stairs. He whispers, "Psssst. Here'sss the deal. Getting your Card Carrying Qualification is the first step in the Bureaucratic Artsss. Yesss, and once you have it, you are on your way to being able to obtain Your Papersss (and all sorts of licenses and permits). It used to be you could acquire the bureaucratic documentsss directly from a friend--Oh, it'sss perfectly legal, mind you--but seemsss like you're the only one around. You'll have to go the official route and deal with the red tape. Head over to the Bureaucratic Hall on Gregariousss Grange and talk to one of my friendsss there. You'll get what you need." And then he disappears as quickly as he appeared.

That was weird.

Subway Station
This is the subway station below Gregarious Grange, Groddle Meadow. A flight of stairs leads up to the street.

You can see a ticket dispenser here.

>[5] up

Gregarious Grange
The entrance to the subway is down a flight of stairs. You can also go inside Bureaucratic Hall.

>[6] in

Bureaucratic Hall
A sign proclaims this room to be the "Department of Administrative Affairs - Ministry of Departments". To the left is a waiting area with a water cooler and a bunch of hard, plastic orange chairs. To the right is a counter, behind which is a Bureaucroc. A sign reads "Please approach the counter for assistance."

>[7] approach
(the counter)
A bureaucroc says, "We will be with you as soon as possible. Now please sit down and wait." He then proceeds to ignore you.

>test wait
(Testing.)

>[1] sit
(on the chair)
You take a seat on one of their uncomfortable plastic chairs.

>[2] z
Time passes.

>[3] z
Time passes.

>[4] z
Time passes.

>[5] z
Time passes.

A bureaucroc calls out, "Alexandra! You're up!"

>[6] approach
(the counter)
The bureaucroc says, "Alexandra, as I understand, you are requesting a Card-Carrying Qualification. You will have to speak to Probost Tummyford about that. Please wait a moment." Then he turns and shuffles away.

>[7] z
Another bureaucroc, presumably Probost Tummyford, approaches the counter. "I'm led to believe you're interested in receiving a Card-Carrying Qualification, is that correct?" He stares intently at you.

Y/N? >[8] y
The bureaucroc says, "I imagine we can help. Quick question first, though. Is it ever too late?"
1 - Yes
2 - No

1/2?>[9] 1
The bureaucroc nods and says, "Very well. In that case, the fee is 50 currants, and we only take cash."

You count out a pile of currants, and The bureaucroc hands over a Card-Carrying Qualification.

"Thank you for your business. To conduct another transaction, you must exit and re-enter the Hall."

>test qual
(Testing.)

>[1] out

Gregarious Grange
The entrance to the subway is down a flight of stairs. You can also go inside Bureaucratic Hall.

>[2] activate
(the Card-Carrying Qualification)
Congratulations! You have taken the first step toward Bureaucratic officialdom. As with all first steps, there is a second, a third... Once you learn Bureaucratic Arts, then get and complete your Papers, you'll be able to use public transportation.

>[3] learn
(Bureaucratic Arts)
Well done: you can now obtain papers with only the requisite amount of hassle and annoyance.

>[4] in

Bureaucratic Hall
A sign proclaims this room to be the "Department of Administrative Affairs - Ministry of Departments". To the left is a waiting area with a water cooler and a bunch of hard, plastic orange chairs. To the right is a counter, behind which is a Bureaucroc. A sign reads "Please approach the counter for assistance."

>[5] approach
(the counter)
A bureaucroc says, "We will be with you as soon as possible. Now please sit down and wait." He then proceeds to ignore you.

>test paper
(Testing.)

>[1] take pen
You cast a nervous look around you before yanking the pen hard enough to snap the chain. A bureaucroc looks up at the sound, and you panic.

Gregarious Grange
The entrance to the subway is down a flight of stairs. You can also go inside Bureaucratic Hall.

>[2] complete
You can't see any such thing.

>[3] down

Subway Station
This is the subway station below Gregarious Grange, Groddle Meadow. A flight of stairs leads up to the street.

You can see a ticket dispenser here.

>[4] buy ticket
(the subway ticket)
The ticket dispenser says, "You can get your Papers at Bureaucratic Hall."

>i
You are carrying:
  a pen
  a Card-Carrying Qualification
  a 150 currants

>test intro
(Testing.)

>[1] up

Gregarious Grange
The entrance to the subway is down a flight of stairs. You can also go inside Bureaucratic Hall.

>[2] down

Subway Station
This is the subway station below Gregarious Grange, Groddle Meadow. A flight of stairs leads up to the street.

You can see a ticket dispenser here.

>[3] up

Gregarious Grange
The entrance to the subway is down a flight of stairs. You can also go inside Bureaucratic Hall.

>[4] down

Subway Station
This is the subway station below Gregarious Grange, Groddle Meadow. A flight of stairs leads up to the street.

You can see a ticket dispenser here.

>[5] up

Gregarious Grange
The entrance to the subway is down a flight of stairs. You can also go inside Bureaucratic Hall.

>[6] in

Bureaucratic Hall
A sign proclaims this room to be the "Department of Administrative Affairs - Ministry of Departments". To the left is a waiting area with a water cooler and a bunch of hard, plastic orange chairs. To the right is a counter, behind which is a Bureaucroc. A sign reads "Please approach the counter for assistance."

>[7] approach
(the counter)
A bureaucroc says, "We will be with you as soon as possible. Now please sit down and wait." He then proceeds to ignore you.

>test wait
(Testing.)

>[1] sit
(on the chair)
You take a seat on one of their uncomfortable plastic chairs.

>[2] z
Time passes.

>[3] z
Time passes.

>[4] z
Time passes.

>[5] z
Time passes.

A bureaucroc calls out, "Alexandra! Your turn!"

>[6] approach
(the counter)
The bureaucroc says, "I understand you're hoping to attain Papers, Alexandra. That's a matter for Associate Nuter. Let me find out if they're in the office this week." Then he turns and shuffles away.

>[7] z
Another bureaucroc, presumably Associate Nuter, approaches the counter. "Right then, let's see... You're here hoping to procure Papers, are you?" He stares intently at you.

Y/N? >[8] y
The bureaucroc says, "I don't see why not. First, however, answer me this. What time is love?"
1 - 2pm
2 - Before lunch

1/2?>[9] 1
The bureaucroc nods and says, "I'll take that. The fee is 100 currants, and I'll take that, as well. In cash."

You count out a pile of currants, and The bureaucroc hands over Papers.

"Thank you for your business. To conduct another transaction, you must exit and re-enter the Hall."

>test paper
(Testing.)

>[1] take pen
You cast a nervous look around you before yanking the pen hard enough to snap the chain. A bureaucroc looks up at the sound, and you panic.

Gregarious Grange
The entrance to the subway is down a flight of stairs. You can also go inside Bureaucratic Hall.

>[2] complete
(Papers)
You cross your "i's and dot your "t's. Or maybe it's the other way around. In any case, you manage to complete your Papers without too much trouble.
Well done. Now go ride a subway!

>[3] down

Subway Station
This is the subway station below Gregarious Grange, Groddle Meadow. A flight of stairs leads up to the street.

You can see a ticket dispenser here.

>[4] buy ticket
(the subway ticket)
The ticket dispenser says, "Train tickets cost 50C. Which line would you like to ride?"

    *** You won the game! ***

Would you like to RESTART, RESTORE a saved game, QUIT, or UNDO the last command?

* * *

>in
Bureaucratic Hall
A sign proclaims this room to be the "Department of Administrative Affairs - Ministry of Departments". To the left is a waiting area with a water cooler and a bunch of hard, plastic orange chairs. To the right is a counter, behind which is a Bureaucroc. Another sign reads "Please approach the counter for assistance."

>down
You can't go that way.

>out
Gregarious Grange
The entrance to the subway is down a flight of stairs. You can also go inside Bureaucratic Hall.

>down
As you make your way back down to the Subway Station, a Bureaucroc corners you on the stairs. He whispers, "Psssst. Here'sss the deal. Getting your Card Carrying Qualification is the first step in the Bureaucratic Artsss. Yesss, and once you have it, you are on your way to being able to obtain Your Papersss (and all sorts of licenses and permits). It used to be you could acquire the bureaucratic documentsss directly from a friend--Oh, it'sss perfectly legal, mind you--but seemsss like you're the only one around. You'll have to go the official route and deal with the red tape. Head over to the Bureaucratic Hall on Gregariousss Grange and talk to one of my friendsss there. You'll get what you need." And then he disappears as quickly as he appeared.

That was weird.

Subway Station
This is the subway station below Gregarious Grange, Groddle Meadow. A flight of stairs leads up to the street.

You can see a ticket dispenser here.

* * *

>in
Bureaucratic Hall
A sign proclaims this room to be the "Department of Administrative Affairs - Ministry of Departments". To the left is a waiting area with a water cooler and a bunch of hard, plastic orange chairs. To the right is a counter, behind which is a Bureaucroc. Another sign reads "Please approach the counter for assistance."

>x hall
Bureaucratic Hall
A sign proclaims this room to be the "Department of Administrative Affairs - Ministry of Departments". To the left is a waiting area with a water cooler and a bunch of hard, plastic orange chairs. To the right is a counter, behind which is a Bureaucroc. A sign reads "Please approach the counter for assistance."

>out
Gregarious Grange
The entrance to the subway is down a flight of stairs. You can also go inside Bureaucratic Hall.

>enter
You must supply a noun.

>enter hall
Bureaucratic Hall
A sign proclaims this room to be the "Department of Administrative Affairs - Ministry of Departments". To the left is a waiting area with a water cooler and a bunch of hard, plastic orange chairs. To the right is a counter, behind which is a Bureaucroc. A sign reads "Please approach the counter for assistance."

* * *

>in
Bureaucratic Hall
A sign proclaims this room to be the "Department of Administrative Affairs - Ministry of Departments". To the left is a waiting area with a water cooler and a bunch of hard, plastic orange chairs. To the right is a counter, behind which is a Bureaucroc. Another sign reads "Please approach the counter for assistance."

>x trash can
It's just a trash can. It's not important.

>take trash can
It's just a trash can. It's not important.

>dispense water
A tiny conical cup of water cooler water is duly dispensed.

>drink water
You imbibe the plain water from the generic cone-cup. Ewww. That water tastes really... bureaucratic-y. You file the cup in the trash can.

* * *

>in
Bureaucratic Hall
A sign proclaims this room to be the "Department of Administrative Affairs - Ministry of Departments". To the left is a waiting area with a water cooler and a bunch of hard, plastic orange chairs. To the right is a counter, behind which is a Bureaucroc. Another sign reads "Please approach the counter for assistance."

>drink water
A tiny conical cup of water cooler water is duly dispensed.

You imbibe the plain water from the generic cone-cup. Ewww. That water tastes really... bureaucratic-y. You file the cup in the trash can.

>drop water
A tiny conical cup of water cooler water is duly dispensed.

You spill the cup of water, splashing water all over the rug. It is soaked up immediately.

>throw water
A tiny conical cup of water cooler water is duly dispensed.

You spill the cup of water, splashing water all over the rug. It is soaked up immediately.

>take pen
You cast a nervous look around you before yanking the pen hard enough to snap the chain. A bureaucroc looks up at the sound, and you panic.

Gregarious Grange
The entrance to the subway is down a flight of stairs. You can also go inside Bureaucratic Hall.

* * *

>in
Bureaucratic Hall
A sign proclaims this room to be the "Department of Administrative Affairs - Ministry of Departments". To the left is a waiting area with a water cooler and a bunch of hard, plastic orange chairs. To the right is a counter, behind which is a Bureaucroc. Another sign reads "Please approach the counter for assistance."

>take pen
You cast a nervous look around you before yanking the pen hard enough to snap the chain. A bureaucroc looks up at the sound, and you panic. You find yourself outside Bureaucratic Hall.

Gregarious Grange
The entrance to the subway is down a flight of stairs. You can also go inside Bureaucratic Hall.

>write
You fiddle with the pen, and it leaks ink all over you.

>write on me
I only understood you as far as wanting to write.

* * *

>up
Gregarious Grange
The entrance to the subway is down a flight of stairs. You can also go inside Bureaucratic Hall.

>x hall
It's a small squat building where the Bureaucrocs work.

>in
(first opening the BHDoor)

Bureaucratic Hall
A sign proclaims this room to be the "Department of Administrative Affairs - Ministry of Departments". To the left is a waiting area with a water cooler and a bunch of hard, plastic orange chairs. To the right is a counter, behind which is a Bureaucroc. A sign reads "Please approach the counter for assistance."

* * *

>up
Gregarious Grange
The entrance to the subway is down a flight of stairs. You can also go inside Bureaucratic Hall.

>enter hall
Bureaucratic Hall
A sign proclaims this room to be the "Department of Administrative Affairs - Ministry of Departments". To the left is a waiting area with a water cooler and a bunch of hard, plastic orange chairs. To the right is a counter, behind which is a Bureaucroc. A sign reads "Please approach the counter for assistance."

>out
Gregarious Grange
The entrance to the subway is down a flight of stairs. You can also go inside Bureaucratic Hall.

>go bureaucratic
(the Bureaucratic Hall)

Bureaucratic Hall
A sign proclaims this room to be the "Department of Administrative Affairs - Ministry of Departments". To the left is a waiting area with a water cooler and a bunch of hard, plastic orange chairs. To the right is a counter, behind which is a Bureaucroc. A sign reads "Please approach the counter for assistance."

>out
Gregarious Grange
The entrance to the subway is down a flight of stairs. You can also go inside Bureaucratic Hall.

>go hall
Bureaucratic Hall
A sign proclaims this room to be the "Department of Administrative Affairs - Ministry of Departments". To the left is a waiting area with a water cooler and a bunch of hard, plastic orange chairs. To the right is a counter, behind which is a Bureaucroc. A sign reads "Please approach the counter for assistance."

>out
Gregarious Grange
The entrance to the subway is down a flight of stairs. You can also go inside Bureaucratic Hall.

>go in hall
Bureaucratic Hall
A sign proclaims this room to be the "Department of Administrative Affairs - Ministry of Departments". To the left is a waiting area with a water cooler and a bunch of hard, plastic orange chairs. To the right is a counter, behind which is a Bureaucroc. A sign reads "Please approach the counter for assistance."

>out
Gregarious Grange
The entrance to the subway is down a flight of stairs. You can also go inside Bureaucratic Hall.

>go into hall
Bureaucratic Hall
A sign proclaims this room to be the "Department of Administrative Affairs - Ministry of Departments". To the left is a waiting area with a water cooler and a bunch of hard, plastic orange chairs. To the right is a counter, behind which is a Bureaucroc. A sign reads "Please approach the counter for assistance."

* * *

>up
Gregarious Grange
The entrance to the subway is down a flight of stairs. You can also go inside Bureaucratic Hall.

>down
As you make your way back down to the Subway Station, a Bureaucroc corners you on the stairs. He whispers, "Psssst. Here'sss the deal. Getting your Card Carrying Qualification is the first step in the Bureaucratic Artsss. Yesss, and once you have it, you are on your way to being able to obtain Your Papersss (and all sorts of licenses and permits). It used to be you could acquire the bureaucratic documentsss directly from a friend--Oh, it'sss perfectly legal, mind you--but seemsss like you're the only one around. You'll have to go the official route and deal with the red tape. Head over to the Bureaucratic Hall on Gregariousss Grange and talk to one of my friendsss there. You'll get what you need." And then he disappears as quickly as he appeared.

That was weird.

Subway Station
This is the subway station below Gregarious Grange, Groddle Meadow. A flight of stairs leads up to the street.

You can see a ticket dispenser here.

* * *

I don't know how to pronounce that. Your name will be Alexandra.

Gregarious Grange Subway Station
This is the subway station below Gregarious Grange, Groddle Meadow. A flight of stairs leads up to the street.

You can see a ticket dispenser here.

>test intro
(Testing.)

>[1] up

Gregarious Grange
The entrance to the subway is down a flight of stairs. You can also go inside Bureaucratic Hall.

>[2] down
As you make your way back down to the Subway Station, a crocodile in a suit and a bad toupee corners you on the stairs.

He whispers, "Psssst. Here'sss the deal. Getting your Card Carrying Qualification is the first step in the Bureaucratic Artsss. Yesss, and once you have it, you are on your way to being able to obtain Your Papersss (and all sorts of licenses and permits). It used to be you could acquire the bureaucratic documentsss directly from a friend--Oh, it'sss perfectly legal, mind you--but seemsss like you're the only one around. You'll have to go the official route and deal with the red tape. Head over to the Bureaucratic Hall on Gregariousss Grange and talk to one of my friendsss there. You'll get what you need." And then he disappears as quickly as he appeared.

That was weird.

Gregarious Grange Subway Station
This is the subway station below Gregarious Grange, Groddle Meadow. A flight of stairs leads up to the street.

You can see a ticket dispenser here.

>[3] up

Gregarious Grange
The entrance to the subway is down a flight of stairs. You can also go inside Bureaucratic Hall.

>[4] in

Bureaucratic Hall
A sign proclaims this room to be the "Department of Administrative Affairs - Ministry of Departments". A table and a water cooler are under the sign. To the left is a waiting area with a bunch of hard, plastic orange chairs. To the right is a counter, behind which is a Bureaucroc. Another sign reads "Please approach the counter for assistance."

>[5] approach
(the counter)
A bureaucroc says, "We will be with you as soon as possible. Now please sit down and wait." He then proceeds to ignore you.

>restart
Are you sure you want to restart?

>y
Bureaucrocy
A boring tale about paperwork by Adri
Release 1 / Serial number 140328 / Inform 7 build 6G60 (I6/v6.32 lib 6/12N) SD

What is your name?

I don't know how to pronounce that. Your name will be Alexandra.

Bureaucrocy
A boring tale about paperwork by Adri
Release 1 / Serial number 140328 / Inform 7 build 6G60 (I6/v6.32 lib 6/12N) SD

Subway Station
This is the subway station below Gregarious Grange, Groddle Meadow. A flight of stairs leads up to the street.

You can see a ticket dispenser here.

>test intro
(Testing.)

>[1] up

Gregarious Grange
The entrance to the subway is down a flight of stairs. You can also go inside Bureaucratic Hall.

>[2] in

Bureaucratic Hall
A sign proclaims this room to be the "Department of Administrative Affairs - Ministry of Departments". To the left is a waiting area with a water cooler and a bunch of hard, plastic orange chairs. To the right is a counter, behind which is a Bureaucroc. A sign reads "Please approach the counter for assistance."

>[3] down
You can't go that way.

>[4] up
You can't go that way.

>[5] in
You can't go that way.

>[6] approach
(the counter)
The bureaucroc says, "Go away. We don't have time to waste on people who have not learned any Bureaucratic Arts."

* * *

>test wait
(Testing.)

>[1] sit
(on the chair)
You take a seat on one of their uncomfortable plastic chairs.

>[2] z
Time passes.

>[3] z
Time passes.

>[4] z
Time passes.

>[5] z
Time passes.

A bureaucroc calls out, "NEXT, Alexandra!"

>[6] approach
(the counter)
The bureaucroc says, "I understand you're hoping to attain Card-Carrying Qualification, Alexandra. That's a matter for Prefect Smithe. Let me find out if they're in the office this week." Then he turns and shuffles away.

>[7] z
Another bureaucroc, presumably Prefect Smithe, approaches the counter. "I'm led to believe you're interested in receiving Card-Carrying Qualification, is that correct?" He stares intently at you.

Y/N? >[8] y
The bureaucroc says, "I can probably deal with your application. But first, quick question: which number is better?"
1 - 631
2 - 11

1/2?>[9] 1
The bureaucroc nods and says, "Acceptable. The fee is 50 currants. Cash up front, please."

You count out a pile of currants, and the bureaucroc hands over Card-Carrying Qualification.

"Thank you for your business. To conduct another transaction, you must exit and re-enter the Hall."

>out
Don't move. Just wait.

>z
Another bureaucroc, presumably Probost Nuter, approaches the counter. "I understand you're here to procure yourself a Card-Carrying Qualification, is that right?" He stares intently at you.

Y/N?

>y
The bureaucroc says, "I can probably deal with your application. One thing: Your favorite fruit?"
1 - Apples
2 - Tomatoes

1/2?

>2
The bureaucroc nods and says, "Very well. In that case, the fee is 50 currants, and we only take cash."

You count out a pile of currants, and The bureaucroc hands over a Card-Carrying Qualification.

"Thank you for your business. To conduct another transaction, you must exit and re-enter the Hall."

>i
You are carrying:
  a Card-Carrying Qualification
  a 150 currants

>test qual
(Testing.)

>[1] out

Gregarious Grange
The entrance to the subway is down a flight of stairs. You can also go inside Bureaucratic Hall.

>[2] activate
(the Card-Carrying Qualification)
Congratulations! You have taken the first step toward Bureaucratic officialdom. As with all first steps, there is a second, a third... Once you learn Bureaucratic Arts, then get and complete your Papers, you'll be able to use public transportation.

>[3] learn
(Bureaucratic Arts)
Well done: you can now obtain papers with only the requisite amount of hassle and annoyance.

>[4] in

Bureaucratic Hall
A sign proclaims this room to be the "Department of Administrative Affairs - Ministry of Departments". To the left is a waiting area with a water cooler and a bunch of hard, plastic orange chairs. To the right is a counter, behind which is a Bureaucroc. A sign reads "Please approach the counter for assistance."

>[5] approach
(the counter)
A bureaucroc says, "We will be with you as soon as possible. Now please sit down and wait." He then proceeds to ignore you.

>test wait
(Testing.)

>[1] sit
(on the chair)
You take a seat on one of their uncomfortable plastic chairs.

>[2] z
Time passes.

>[3] z
Time passes.

>[4] z
Time passes.

>[5] z
Time passes.

A bureaucroc calls out, "Alexandra! Your turn!"

>[6] approach
(the counter)
The bureaucroc says, "So you're requesting Papers are you, Alexandra? Manager Snifflenose is the official you need to speak to. Please bear with me a moment." Then he turns and shuffles away.

>[7] z
Another bureaucroc, presumably Manager Snifflenose, approaches the counter. "What's this, then? You're hoping to acquire Papers, correct?" He stares intently at you.

Y/N? >[8] y
The bureaucroc says, "I don't see why not. First, however, one question:"
1 - Innie?
2 - Outie?

1/2?>[9] 1
The bureaucroc nods and says, "Excellent. The bureau charges 100 currants. Cash only, I'm afraid."

You count out a pile of currants, and The bureaucroc hands over Papers.

"Thank you for your business. To conduct another transaction, you must exit and re-enter the Hall."

>i
You are carrying:
  Papers
  a Card-Carrying Qualification
  a 50 currants

* * *

>i
You are carrying:
  Card-Carrying Qualification
  a 150 currants

* * *

>test qual
(Testing.)

>[1] out

Gregarious Grange
The entrance to the subway is down a flight of stairs. You can also go inside Bureaucratic Hall.

>[2] activate
(Card-Carrying Qualification)
Congratulations! You have taken the first step toward Bureaucratic officialdom. As with all first steps, there is a second, a third... Once you learn Bureaucratic Arts, then get and complete your Papers, you'll be able to use public transportation.

>[3] learn
(Bureaucratic Arts)
Well done: you can now obtain papers with only the requisite amount of hassle and annoyance.

>[4] in

Bureaucratic Hall
A sign proclaims this room to be the "Department of Administrative Affairs - Ministry of Departments". A table and a water cooler are under the sign. To the left is a waiting area with a bunch of hard, plastic orange chairs. To the right is a counter, behind which is a Bureaucroc. Another sign reads "Please approach the counter for assistance."

>[5] approach
(the counter)
A bureaucroc says, "We will be with you as soon as possible. Now please sit down and wait." He then proceeds to ignore you.

>test wait
(Testing.)

>[1] sit
(on the chair)
You take a seat on one of their uncomfortable plastic chairs.

>[2] z
Time passes.

>[3] z
Time passes.

>[4] z
Time passes.

>[5] z
Time passes.

A bureaucroc calls out, "Alexandra! Your turn!"

>[6] approach
(the counter)
The bureaucroc says, "Alexandra? If you are seeking Papers, you must speak to Secretary Naraiwaddleappali. Please wait while I see if they're taking appointments today." Then he turns and shuffles away.

>[7] z
Another bureaucroc, presumably Secretary Naraiwaddleappali, approaches the counter. "Let's see here. You are interested in obtaining Papers, correct?" He stares intently at you.

Y/N? >[8] y
The bureaucroc says, "Sounds reasonable. Before we proceed, I must ask, which shelf-height do you prefer?"
1 - High shelves
2 - Ankle-height shelves

1/2?>[9] 1
The bureaucroc nods and says, "Excellent. The bureau charges 100 currants. Cash only, I'm afraid."

You count out a pile of currants, and the bureaucroc hands over Papers.

"Thank you for your business. To conduct another transaction, you must exit and re-enter the Hall."

>i
You are carrying Papers, Card-Carrying Qualification, and 50 currants.

>out
Gregarious Grange
The entrance to the subway is down a flight of stairs. You can also go inside Bureaucratic Hall.

>down
Gregarious Grange Subway Station
This is the subway station below Gregarious Grange, Groddle Meadow. A flight of stairs leads up to the street.

You can see a ticket dispenser here.

>ride subway
You can't see any such thing.

>x subway
You can't see any such thing. Because you haven't purchased a ticket yet.

* * *

>get papers
You already have your papers. Now you need to complete them.

>complete papers
You will need a pen in order to fill out your Papers.

>get pen
You cast a nervous look around you before yanking the pen hard enough to snap the chain. A bureaucroc looks up at the sound, and you panic. You find yourself outside Bureaucratic Hall.

Gregarious Grange
The entrance to the subway is down a flight of stairs. You can also go inside Bureaucratic Hall.

>complete papers
You cross your "i's and dot your "t's. Or maybe it's the other way around. In any case, you manage to complete your Papers without too much trouble.
Well done. Now go ride a subway!

>get papers
You have already completed your Papers.

>ride subway
You can't see any such thing.

>down
Subway Station
This is the subway station below Gregarious Grange, Groddle Meadow. A flight of stairs leads up to the street.

You can see a ticket dispenser here.

>ride subway
The ticket dispenser says, "Train tickets cost 50C. Which line would you like to ride?"

    *** You won the game! ***

Would you like to RESTART, RESTORE a saved game, or QUIT?

>restart
Bureaucrocy
A boring tale about paperwork by Adri
Release 1 / Serial number 140401 / Inform 7 build 6G60 (I6/v6.32 lib 6/12N) SD

What is your name?

>y
I don't know how to pronounce that. Your name will be Alexandra.

Bureaucrocy
A boring tale about paperwork by Adri
Release 1 / Serial number 140401 / Inform 7 build 6G60 (I6/v6.32 lib 6/12N) SD

Subway Station
This is the subway station below Gregarious Grange, Groddle Meadow. A flight of stairs leads up to the street.

You can see a ticket dispenser here.

>x gate
There is a gate here blocking your way. It will open once you buy a ticket.

>x dispenser
This machine dispenses subway tickets in exchange for 50 currants. Press the button to buy a ticket.

* * *

>restart
Are you sure you want to restart?

>y
Bureaucrocy
A boring tale about paperwork by Adri
Release 1 / Serial number 140401 / Inform 7 build 6G60 (I6/v6.32 lib 6/12N) SD

What is your name?

I don't know how to pronounce that. Your name will be Alexandra.

Bureaucrocy
A boring tale about paperwork by Adri
Release 1 / Serial number 140401 / Inform 7 build 6G60 (I6/v6.32 lib 6/12N) SD

Subway Station
This is the subway station below Gregarious Grange, Groddle Meadow. A flight of stairs leads up to the street.

You can see a ticket dispenser here.

>test intro
(Testing.)

>[1] up

Gregarious Grange
The entrance to the subway is down a flight of stairs. You can also go inside Bureaucratic Hall.

>[2] down
As you make your way back down to the Subway Station, a Bureaucroc corners you on the stairs. He whispers, "Psssst. Here'sss the deal. Getting your Card Carrying Qualification is the first step in the Bureaucratic Artsss. Yesss, and once you have it, you are on your way to being able to obtain Your Papersss (and all sorts of licenses and permits). It used to be you could acquire the bureaucratic documentsss directly from a friend--Oh, it'sss perfectly legal, mind you--but seemsss like you're the only one around. You'll have to go the official route and deal with the red tape. Head over to the Bureaucratic Hall on Gregariousss Grange and talk to one of my friendsss there. You'll get what you need." And then he disappears as quickly as he appeared.

That was weird.

Subway Station
This is the subway station below Gregarious Grange, Groddle Meadow. A flight of stairs leads up to the street.

You can see a ticket dispenser here.

>[3] up

Gregarious Grange
The entrance to the subway is down a flight of stairs. You can also go inside Bureaucratic Hall.

>[4] in

Bureaucratic Hall
A sign proclaims this room to be the "Department of Administrative Affairs - Ministry of Departments". To the left is a waiting area with a water cooler and a bunch of hard, plastic orange chairs. To the right is a counter, behind which is a Bureaucroc. Another sign reads "Please approach the counter for assistance."

>[5] approach
(the counter)
A bureaucroc says, "We will be with you as soon as possible. Now please sit down and wait." He then proceeds to ignore you.

>test wait
(Testing.)

>[1] sit
(on the chair)
You would rather not sit in one of those chairs unless you absolutely have to.

>[2] z
Time passes.

>[3] z
Time passes.

>[4] z
Time passes.

>[5] z
Time passes.

>[6] approach
(the counter)
A bureaucroc says, "We will be with you as soon as possible. Now please sit down and wait." He then proceeds to ignore you.

>[7] z
Time passes.

>[8] y
That was a rhetorical question.

>[9] 1
That's not a verb I recognize.

* * *

>activate qual
You can't see any such thing.

>activate qualification
Congratulations! You have taken the first step toward Bureaucratic officialdom. As with all first steps, there is a second, a third... Once you learn Bureaucratic Arts, then get and complete your Papers, you'll be able to use public transportation.

>out
Gregarious Grange
The entrance to the subway is down a flight of stairs. You can also go inside Bureaucratic Hall.

>in
Bureaucratic Hall
A sign proclaims this room to be the "Department of Administrative Affairs - Ministry of Departments". To the left is a waiting area with a water cooler and a bunch of hard, plastic orange chairs. To the right is a counter, behind which is a Bureaucroc. Another sign reads "Please approach the counter for assistance."

>sit
(on the chair)
You would rather not sit in one of those chairs unless you absolutely have to.

>approach counter
The bureaucroc says, "Go away. We don't have time to waste on people who have not learned any Bureaucratic Arts."

>sit
(on the chair)
You would rather not sit in one of those chairs unless you absolutely have to.

* * *

>z
Another bureaucroc, presumably Representative Snifflenose, approaches the counter. "I'm led to believe you're interested in receiving Card-Carrying Qualification, is that correct?" He stares intently at you.

Y/N?

>y
The bureaucroc says, "I should be able to rubber stamp this. Before that, though, your favorite color?"
1 - Beige
2 - Not Beige

1/2?

>2
The bureaucroc nods and says, "I'll take that. The fee is 50 currants, and I'll take that, as well. In cash."

You count out a pile of currants, and the bureaucroc hands over Card-Carrying Qualification.

"Thank you for your business. To conduct another transaction, you must exit and re-enter the Hall."

>out
Gregarious Grange
The entrance to the subway is down a flight of stairs. You can also go inside Bureaucratic Hall.

* * *

>sit
(on the chair)
You would rather not sit in one of those chairs unless you absolutely have to.

>sit
(on the chair)
You would rather not sit in one of those chairs unless you absolutely have to.

>learn arts
You cannot learn the Bureaucratic Arts until you have obtained and activated the Card-Carrying Qualification. You can obtain the Card-Carrying Qualification at Bureaucratic Hall.

>activate qualification
Congratulations! You have taken the first step toward Bureaucratic officialdom. As with all first steps, there is a second, a third... Once you learn Bureaucratic Arts, then get and complete your Papers, you'll be able to use public transportation.

>sit
(on the chair)
You would rather not sit in one of those chairs unless you absolutely have to.

>learn arts
Well done: you can now obtain papers with only the requisite amount of hassle and annoyance.

>sit
(on the chair)
You would rather not sit in one of those chairs unless you absolutely have to.

>approach
(the counter)
A bureaucroc says, "We will be with you as soon as possible. Now please sit down and wait." He then proceeds to ignore you.

>sit
(on the chair)
You take a seat on one of their uncomfortable plastic chairs.

>wait
Time passes.

>test wait
(Testing.)

>[1] sit
(on the chair)
You can't do anything while waiting. Just wait.

>[2] z
Time passes.

>[3] z
Time passes.

>[4] z
Time passes.

>[5] z
Time passes.

A bureaucroc calls out, "NEXT, Alexandra!"

>[6] approach
(the counter)
The bureaucroc says, "I understand you're hoping to attain Papers, Alexandra. That's a matter for Deputy Wigglesbottom. Let me find out if they're in the office this week." Then he turns and shuffles away.

>[7] z
Another bureaucroc, presumably Deputy Wigglesbottom, approaches the counter. "Right then, let's see... You're here hoping to procure Papers, are you?" He stares intently at you.

Y/N? >[8] y
The bureaucroc says, "I should be able to help with that. One question first. Which came first?"
1 - The Chicken
2 - The Grain

1/2?>[9] 1
The bureaucroc nods and says, "That will do. Your fee is 100 currants. Cash only."

You count out a pile of currants, and the bureaucroc hands over Papers.

"Thank you for your business. To conduct another transaction, you must exit and re-enter the Hall."

* * *

>test intro
(Testing.)

>[1] up
You can't go that way.

>[2] in
You can't go that way.

>[3] out

Gregarious Grange
The entrance to the subway is down a flight of stairs. You can also go inside Bureaucratic Hall.

>[4] down
As you make your way back down to the Subway Station, a Bureaucroc corners you on the stairs. He whispers, "Psssst. Here'sss the deal. Getting your Card Carrying Qualification is the first step in the Bureaucratic Artsss. Yesss, and once you have it, you are on your way to being able to obtain Your Papersss (and all sorts of licenses and permits). It used to be you could acquire the bureaucratic documentsss directly from a friend--Oh, it'sss perfectly legal, mind you--but seemsss like you're the only one around. You'll have to go the official route and deal with the red tape. Head over to the Bureaucratic Hall on Gregariousss Grange and talk to one of my friendsss there. You'll get what you need." And then he disappears as quickly as he appeared.

That was weird.

Subway Station
This is the subway station below Gregarious Grange, Groddle Meadow. A flight of stairs leads up to the street.

You can see a ticket dispenser here.

>[5] up

Gregarious Grange
The entrance to the subway is down a flight of stairs. You can also go inside Bureaucratic Hall.

>[6] in

Bureaucratic Hall
A sign proclaims this room to be the "Department of Administrative Affairs - Ministry of Departments". To the left is a waiting area with a water cooler and a bunch of hard, plastic orange chairs. To the right is a counter, behind which is a Bureaucroc. A sign reads "Please approach the counter for assistance."

>[7] approach
(the counter)
A bureaucroc says, "We will be with you as soon as possible. Now please sit down and wait." He then proceeds to ignore you.

* * *

>dispense water
A tiny conical cup of water cooler water is duly dispensed.

>drink water
You imbibe the plain water from the generic cone-cup. Ewww. That water tastes really... bureaucratic-y.

>approach counter
A bureaucroc says, "We will be with you as soon as possible. Now please sit down and wait." He then proceeds to ignore you.

* * *

I don't know how to pronounce that. Your name will be Alexandra.

Gregarious Grange Subway Station
This is the subway station below Gregarious Grange, Groddle Meadow. A flight of stairs leads up to the street.

You can see a ticket dispenser here.

>i
You are carrying:
  200 currants

>test intro
(Testing.)

>[1] up

Gregarious Grange
The entrance to the subway is down a flight of stairs. You can also go inside Bureaucratic Hall.

>[2] in

Bureaucratic Hall
A sign proclaims this room to be the "Department of Administrative Affairs - Ministry of Departments". To the left is a waiting area with a water cooler and a bunch of hard, plastic orange chairs. To the right is a counter, behind which is a Bureaucroc. A sign reads "Please approach the counter for assistance."

>[3] out

Gregarious Grange
The entrance to the subway is down a flight of stairs. You can also go inside Bureaucratic Hall.

>[4] down
As you make your way back down to the Subway Station, a Bureaucroc corners you on the stairs. He whispers, "Psssst. Here'sss the deal. Getting your Card Carrying Qualification is the first step in the Bureaucratic Artsss. Yesss, and once you have it, you are on your way to being able to obtain Your Papersss (and all sorts of licenses and permits). It used to be you could acquire the bureaucratic documentsss directly from a friend--Oh, it'sss perfectly legal, mind you--but seemsss like you're the only one around. You'll have to go the official route and deal with the red tape. Head over to the Bureaucratic Hall on Gregariousss Grange and talk to one of my friendsss there. You'll get what you need." And then he disappears as quickly as he appeared.

That was weird.

Subway Station
This is the subway station below Gregarious Grange, Groddle Meadow. A flight of stairs leads up to the street.

You can see a ticket dispenser here.

>[5] up

Gregarious Grange
The entrance to the subway is down a flight of stairs. You can also go inside Bureaucratic Hall.

>[6] in

Bureaucratic Hall
A sign proclaims this room to be the "Department of Administrative Affairs - Ministry of Departments". To the left is a waiting area with a water cooler and a bunch of hard, plastic orange chairs. To the right is a counter, behind which is a Bureaucroc. A sign reads "Please approach the counter for assistance."

>[7] approach
(the counter)
A bureaucroc says, "We will be with you as soon as possible. Now please sit down and wait." He then proceeds to ignore you.

>test wait
(Testing.)

>[1] sit
(on the chair)
You take a seat on one of their uncomfortable plastic chairs.

>[2] z
Time passes.

>[3] z
Time passes.

>[4] z
Time passes.

>[5] z
Time passes.

A bureaucroc calls out, "Ready for you now, Alexandra!"

>[6] approach
(the counter)
The bureaucroc says, "Alexandra, your request for Card-Carrying Qualification will have to be passed along to the correct department. Please wait while I ascertain the availability of Associate Tummyford." Then he turns and shuffles away.

>[7] z
Another bureaucroc, presumably Associate Tummyford, approaches the counter. "What do we have here, then? I see. So, it's Card-Carrying Qualification you're after, is it?" He stares intently at you.

Y/N? >[8] y
The bureaucroc says, "I may be able to help you with that. But first, which cloud is better?"
1 - Cirrus
2 - Cumulonimbus

1/2?>[9] 1
The bureaucroc says, "Interesting. I believe the department you're looking for is that of Chamberlain Naraiwaddleappali. Good day." The bureaucroc walks away without another word.

>WAIT
Another bureaucroc, presumably Chamberlain Naraiwaddleappali, approaches the counter. "I'm led to believe you're interested in receiving Card-Carrying Qualification, is that correct?" He stares intently at you.

Y/N?

>y
The bureaucroc says, "I might be able to sign this off. One question first. Which came first?"
1 - The Chicken
2 - The Grain

1/2?

>2
The bureaucroc nods and says, "That will do. Your fee is 50 currants. Cash only."

You count out a pile of currants, and the bureaucroc hands over Card-Carrying Qualification.

"Thank you for your business. To conduct another transaction, you must exit and re-enter the Hall."

>i
You are carrying:
  Card-Carrying Qualification
  150 currants

>test qual
(Testing.)

>[1] out

Gregarious Grange
The entrance to the subway is down a flight of stairs. You can also go inside Bureaucratic Hall.

>[2] activate
(Card-Carrying Qualification)
Congratulations! You have taken the first step toward Bureaucratic officialdom. As with all first steps, there is a second, a third... Once you learn Bureaucratic Arts, then get and complete your Papers, you'll be able to use public transportation.

>[3] learn
(Bureaucratic Arts)
Well done: you can now obtain papers with only the requisite amount of hassle and annoyance.

>[4] in

Bureaucratic Hall
A sign proclaims this room to be the "Department of Administrative Affairs - Ministry of Departments". To the left is a waiting area with a water cooler and a bunch of hard, plastic orange chairs. To the right is a counter, behind which is a Bureaucroc. A sign reads "Please approach the counter for assistance."

>[5] approach
(the counter)
A bureaucroc says, "We will be with you as soon as possible. Now please sit down and wait." He then proceeds to ignore you.

>test wait
(Testing.)

>[1] sit
(on the chair)
You take a seat on one of their uncomfortable plastic chairs.

>[2] z
Time passes.

>[3] z
Time passes.

>[4] z
Time passes.

>[5] z
Time passes.

A bureaucroc calls out, "Alexandra! Come forward!"

>[6] approach
(the counter)
The bureaucroc says, "Alexandra? If you are seeking Papers, you must speak to Magister Wigglesbottom. Please wait while I see if they're taking appointments today." Then he turns and shuffles away.

>[7] z
Another bureaucroc, presumably Magister Wigglesbottom, approaches the counter. "What's this, then? You're hoping to acquire Papers, correct?" He stares intently at you.

Y/N? >[8] y
The bureaucroc says, "I imagine we can help. But first, please choose between the following:"
1 - Pirates
2 - Ninjas

1/2?>[9] 1
The bureaucroc nods and says, "Very well. In that case, the fee is 100 currants, and we only take cash."

You count out a pile of currants, and the bureaucroc hands over Papers.

"Thank you for your business. To conduct another transaction, you must exit and re-enter the Hall."

>i
You are carrying:
  Papers
  Card-Carrying Qualification
  50 currants

>test papers
>--> The following tests are available:
'test intro'
'test wait'
'test qual'
'test paper'

>test paper
(Testing.)

>[1] take pen
You cast a nervous look around you before yanking the pen hard enough to snap the chain. A bureaucroc looks up at the sound, and you panic.

Gregarious Grange
The entrance to the subway is down a flight of stairs. You can also go inside Bureaucratic Hall.

>[2] complete
(Papers)
You cross your "i's and dot your "t's. Or maybe it's the other way around. In any case, you manage to complete your Papers without too much trouble.
Well done. Now go ride a subway!

>[3] down
As you make your way back down to the Subway Station, a Bureaucroc corners you on the stairs. He whispers, "Psssst. Here'sss the deal. Getting your Card Carrying Qualification is the first step in the Bureaucratic Artsss. Yesss, and once you have it, you are on your way to being able to obtain Your Papersss (and all sorts of licenses and permits). It used to be you could acquire the bureaucratic documentsss directly from a friend--Oh, it'sss perfectly legal, mind you--but seemsss like you're the only one around. You'll have to go the official route and deal with the red tape. Head over to the Bureaucratic Hall on Gregariousss Grange and talk to one of my friendsss there. You'll get what you need." And then he disappears as quickly as he appeared.

That was weird.

Subway Station
This is the subway station below Gregarious Grange, Groddle Meadow. A flight of stairs leads up to the street.

You can see a ticket dispenser here.

>[4] buy ticket
(the subway ticket)
The ticket dispenser says, "Train tickets cost 50C. Which line would you like to ride?"

    *** You won the game! ***

Would you like to RESTART, RESTORE a saved game, QUIT, or UNDO the last command?

* * *

>i
You are carrying:
  200 currants

>take all
There are none at all available!

>take dispenser
That's fixed in place.

>take ticket
The ticket dispenser says, "Without Papers, you may not use public transportation. You can get your Papers at Bureaucratic Hall."

>take gate
That's hardly portable.

>up
Gregarious Grange
The entrance to the subway is down a flight of stairs. You can also go inside Bureaucratic Hall.

>in
Bureaucratic Hall
A sign proclaims this room to be the "Department of Administrative Affairs - Ministry of Departments". To the left is a waiting area with a water cooler and a bunch of hard, plastic orange chairs. To the right is a counter, behind which is a Bureaucroc. A sign reads "Please approach the counter for assistance."

>x cooler
Water dispensing devices do not get more generic than this. It is as plain as could be. Were it possible for water to be beige, beige this water would be.

>x chairs
This is the perfect chair for those who like the idea of sitting briefly and with utmost caution.

>take chair
That's hardly portable.

>take cooler
The water cooler appears to be cemented into place. You get the impression you're not the first person to try this.

>x counter
It's a standard counter. You don't see anything special about it. There is a pen here, secured to the counter with a length of ball chain.

>x pen
This generic pen will let you write messages and notes.

>x chain
Which do you mean, the counter or the pen?

* * *

I don't know how to pronounce that. Your name will be Alexandra.

Gregarious Grange Subway Station
This is the subway station below Gregarious Grange, Groddle Meadow. A flight of stairs leads up to the street.

You can see a ticket dispenser here.

>x subway
There is a train waiting at the station. You could be on the train, if only you had a ticket.

>x ticket
You can't see any such thing. Because you haven't purchased a ticket yet.

>buy ticket
(the subway ticket)
The ticket dispenser says, "Without Papers, you may not use public transportation. You can get your Papers at Bureaucratic Hall."

>up
Gregarious Grange
The entrance to the subway is down a flight of stairs. You can also go inside Bureaucratic Hall.

>x subway
It's the entrance to the Gregarious Grange Subway Station.

>enter subway
Subway Station
This is the subway station below Gregarious Grange, Groddle Meadow. A flight of stairs leads up to the street.

You can see a ticket dispenser here.

* * *

>x ticket
You can't see any such thing. Because you haven't purchased a ticket yet.

>ride subway
The ticket dispenser says, "Without Papers, you may not use public transportation. You can get your Papers at Bureaucratic Hall."

* * *

>x subway
There is a train waiting at the station. You could be on the train, if only you had a ticket.

>ride subway
The ticket dispenser says, "Without Papers, you may not use public transportation. You can get your Papers at Bureaucratic Hall."

>buy ticket
The ticket dispenser says, "Without Papers, you may not use public transportation. You can get your Papers at Bureaucratic Hall."

* * *

>x subway
There is a train waiting at the station. You could be on the train, if only you had a ticket.

>x train
There is a train waiting at the station. You could be on the train, if only you had a ticket.

* * *

I don't know how to pronounce that. Your name will be Alexandra.

Gregarious Grange Subway Station
This is the subway station below Gregarious Grange, Groddle Meadow. A flight of stairs leads up to the street.

You can see a ticket dispenser here.

>x ssdoor
Subway Station
This is the subway station below Gregarious Grange, Groddle Meadow. A flight of stairs leads up to the street.

You can see a ticket dispenser here.

>x subway
You can't see any such thing. Because you haven't purchased a ticket yet.

>x station
You can't see any such thing.

* * *

I don't know how to pronounce that. Your name will be Alexandra.

Gregarious Grange Subway Station
This is the subway station below Gregarious Grange, Groddle Meadow. A flight of stairs leads up to the street.

You can see a ticket dispenser here.

>x station
You can't see any such thing.

>l
Subway Station
This is the subway station below Gregarious Grange, Groddle Meadow. A flight of stairs leads up to the street.

You can see a ticket dispenser here.

>out
But you aren't in anything at the moment.

>up
Gregarious Grange
The entrance to the subway is down a flight of stairs. You can also go inside Bureaucratic Hall.

>dow
That's not a verb I recognize.

>down
Subway Station
This is the subway station below Gregarious Grange, Groddle Meadow. A flight of stairs leads up to the street.

You can see a ticket dispenser here.

>up
Gregarious Grange
The entrance to the subway is down a flight of stairs. You can also go inside Bureaucratic Hall.

* * *

>x subway
It's the entrance to the Gregarious Grange Subway Station.

>x station
It's the entrance to the Gregarious Grange Subway Station.

>enter station
As you make your way back down to the Subway Station, a Bureaucroc corners you on the stairs. He whispers, "Psssst. Here'sss the deal. Getting your Card Carrying Qualification is the first step in the Bureaucratic Artsss. Yesss, and once you have it, you are on your way to being able to obtain Your Papersss (and all sorts of licenses and permits). It used to be you could acquire the bureaucratic documentsss directly from a friend--Oh, it'sss perfectly legal, mind you--but seemsss like you're the only one around. You'll have to go the official route and deal with the red tape. Head over to the Bureaucratic Hall on Gregariousss Grange and talk to one of my friendsss there. You'll get what you need." And then he disappears as quickly as he appeared.

That was weird.

Subway Station
This is the subway station below Gregarious Grange, Groddle Meadow. A flight of stairs leads up to the street.

You can see a ticket dispenser here.

>up
Gregarious Grange
The entrance to the subway is down a flight of stairs. You can also go inside Bureaucratic Hall.

* * *

>out
Gregarious Grange
The entrance to the subway is down a flight of stairs. You can also go inside Bureaucratic Hall.

>enter bureaucratic
(the BHDoor)

Bureaucratic Hall
A sign proclaims this room to be the "Department of Administrative Affairs - Ministry of Departments". To the left is a waiting area with a water cooler and a bunch of hard, plastic orange chairs. To the right is a counter, behind which is a Bureaucroc. A sign reads "Please approach the counter for assistance."

>out
Gregarious Grange
The entrance to the subway is down a flight of stairs. You can also go inside Bureaucratic Hall.

* * *

I don't know how to pronounce that. Your name will be Alexandra.

Gregarious Grange Subway Station
This is the subway station below Gregarious Grange, Groddle Meadow. A flight of stairs leads up to the street.

You can see a ticket dispenser here.

>about
The author can be contacted at genericgeekgirl@gmail.com. Thank you to my beta-testers: Andrew Plotkin, Beth Skwarecki, and @dazyndara. And, of course, to Tiny Speck, for allowing me to make this game! The scene was taken directly from their game Glitch, a wonderful MMO that shut down in 2012.

* * *

I don't know how to pronounce that. Your name will be Alexandra.

Gregarious Grange Subway Station
This is the subway station below Gregarious Grange, Groddle Meadow. A flight of stairs leads up to the street.

You can see a ticket dispenser here.

>jump over gate
You attempt to jump over the gate. You not only trip and fall on your face, but the de-imaginators show up and cart you off to Abbasid Jail.

    *** You are here because you were bad. Knock it off. ***

Would you like to RESTART, RESTORE a saved game, or QUIT?

>restart
Bureaucrocy
A boring tale about paperwork by Adri
Release 1 / Serial number 140329 / Inform 7 build 6G60 (I6/v6.32 lib 6/12N) SD

What is your name?

I don't know how to pronounce that. Your name will be Alexandra.

Bureaucrocy
A boring tale about paperwork by Adri
Release 1 / Serial number 140329 / Inform 7 build 6G60 (I6/v6.32 lib 6/12N) SD

Subway Station
This is the subway station below Gregarious Grange, Groddle Meadow. A flight of stairs leads up to the street.

You can see a ticket dispenser here.

>jump turnstile
You attempt to jump over the gate. You not only trip and fall on your face, but the de-imaginators show up and cart you off to Abbasid Jail.

    *** You are here because you were bad. Knock it off. ***

Would you like to RESTART, RESTORE a saved game, or QUIT?

>restore
Restore failed.

Would you like to RESTART, RESTORE a saved game, or QUIT?

>restart
Bureaucrocy
A boring tale about paperwork by Adri
Release 1 / Serial number 140329 / Inform 7 build 6G60 (I6/v6.32 lib 6/12N) SD

What is your name?

>break through
I don't know how to pronounce that. Your name will be Alexandra.

Bureaucrocy
A boring tale about paperwork by Adri
Release 1 / Serial number 140329 / Inform 7 build 6G60 (I6/v6.32 lib 6/12N) SD

Subway Station
This is the subway station below Gregarious Grange, Groddle Meadow. A flight of stairs leads up to the street.

You can see a ticket dispenser here.

>break through turnstile
You attempt to jump over the gate. You not only trip and fall on your face, but the de-imaginators show up and cart you off to Abbasid Jail.

    *** You are here because you were bad. Knock it off. ***

Would you like to RESTART, RESTORE a saved game, or QUIT?

* * *

I don't know how to pronounce that. Your name will be Alexandra.

Gregarious Grange Subway Station
This is the subway station below Gregarious Grange, Groddle Meadow. A flight of stairs leads up to the street.

You can see a ticket dispenser here.

>break turnstile
You attempt to jump over the gate. You not only trip and fall on your face, but the de-imaginators show up and cart you off to Abbasid Jail.

    *** You are here because you were bad. Knock it off. ***

Would you like to RESTART, RESTORE a saved game, or QUIT?

>restart
Bureaucrocy
A boring tale about paperwork by Adri
Release 1 / Serial number 140329 / Inform 7 build 6G60 (I6/v6.32 lib 6/12N) SD

What is your name?

* * *

I don't know how to pronounce that. Your name will be Alexandra.

Bureaucrocy
A boring tale about paperwork by Adri
Release 1 / Serial number 140329 / Inform 7 build 6G60 (I6/v6.32 lib 6/12N) SD

Subway Station
This is the subway station below Gregarious Grange, Groddle Meadow. A flight of stairs leads up to the street.

You can see a ticket dispenser here.

>up
Gregarious Grange
The entrance to the subway is down a flight of stairs. You can also go inside Bureaucratic Hall.

* * *

>in
Bureaucratic Hall
A sign proclaims this room to be the "Department of Administrative Affairs - Ministry of Departments". To the left is a waiting area with a water cooler and a bunch of hard, plastic orange chairs. To the right is a counter, behind which is a Bureaucroc. A sign reads "Please approach the counter for assistance."

>approach
(the counter)
The bureaucroc says, "Go away. We don't have time to waste on people who have not learned any Bureaucratic Arts."

>g
(the counter)
The bureaucroc says, "Go away. We don't have time to waste on people who have not learned any Bureaucratic Arts."

>g
(the counter)
The bureaucroc says, "Go away. We don't have time to waste on people who have not learned any Bureaucratic Arts."

>sit
(on the chair)
You would rather not sit in one of those chairs unless you absolutely have to.

* * *

>z
Time passes.

>sit
(on the chair)
You would rather not sit in one of those chairs unless you absolutely have to.

>z
Time passes.

* * *

>WAIT
Time passes.

>stand
You are already standing.

* * *

>WAIT
Time passes.

>talk to croc
The bureaucroc says, "Go away. We don't have time to waste on people who have not learned any Bureaucratic Arts."

>g
The bureaucroc says, "Go away. We don't have time to waste on people who have not learned any Bureaucratic Arts."

>g
The bureaucroc says, "Go away. We don't have time to waste on people who have not learned any Bureaucratic Arts."

>WAIT
Time passes.

>learn arts
You cannot learn the Bureaucratic Arts until you have obtained and activated the Card-Carrying Qualification. You can obtain the Card-Carrying Qualification at Bureaucratic Hall.

>talk to croc
The bureaucroc says, "Go away. We don't have time to waste on people who have not learned any Bureaucratic Arts."

>z
Time passes.

* * *

>WAIT
Time passes.

>wait
Time passes.

>z
Time passes.

* * *

>WAIT
Time passes.

>bribe croc
That's not a verb I recognize.

>i
You are carrying:
  200 currants

>drop currants
Dropped.

>take currants
Taken.

* * *

I don't know how to pronounce that. Your name will be Alexandra.

Gregarious Grange Subway Station
This is the subway station below Gregarious Grange, Groddle Meadow. A flight of stairs leads up to the street.

You can see a ticket dispenser here.

>take ticket
That's hardly portable.

* * *

I don't know how to pronounce that. Your name will be Alexandra.

Gregarious Grange Subway Station
This is the subway station below Gregarious Grange, Groddle Meadow. A flight of stairs leads up to the street.

You can see a ticket dispenser here.

>bribe
You can't see any such thing.

>up
Gregarious Grange
The entrance to the subway is down a flight of stairs. You can also go inside Bureaucratic Hall.

* * *

>in
Bureaucratic Hall
A sign proclaims this room to be the "Department of Administrative Affairs - Ministry of Departments". To the left is a waiting area with a water cooler and a bunch of hard, plastic orange chairs. To the right is a counter, behind which is a Bureaucroc. A sign reads "Please approach the counter for assistance."

>bribe
(the bureaucroc)
You attempt to bribe a government official. He seems tempted, but before you can seal the deal, the de-imaginators show up and cart you off to Abbasid Jail.

    *** You are here because you were bad. Knock it off. ***

Would you like to RESTART, RESTORE a saved game, or QUIT?

* * *

I don't know how to pronounce that. Your name will be Alexandra.

Gregarious Grange Subway Station
This is the subway station below Gregarious Grange, Groddle Meadow. A flight of stairs leads up to the street.

You can see a ticket dispenser here.

>obtain qualificaiton
You will need to go to Bureaucratic Hall to do that.

>obtain qualification
You can't see any such thing.

* * *

>obtain qualificaiton
You will need to go to Bureaucratic Hall to do that.

>activate qualificaiton
You can't see any such thing.

>activate qualification
You can't see any such thing.

>test intro
(Testing.)

>[1] up

Gregarious Grange
The entrance to the subway is down a flight of stairs. You can also go inside Bureaucratic Hall.

>[2] in

Bureaucratic Hall
A sign proclaims this room to be the "Department of Administrative Affairs - Ministry of Departments". To the left is a waiting area with a water cooler and a bunch of hard, plastic orange chairs. To the right is a counter, behind which is a Bureaucroc. A sign reads "Please approach the counter for assistance."

>[3] out

Gregarious Grange
The entrance to the subway is down a flight of stairs. You can also go inside Bureaucratic Hall.

>[4] down

Subway Station
This is the subway station below Gregarious Grange, Groddle Meadow. A flight of stairs leads up to the street.

You can see a ticket dispenser here.

>[5] up

Gregarious Grange
The entrance to the subway is down a flight of stairs. You can also go inside Bureaucratic Hall.

>[6] in

Bureaucratic Hall
A sign proclaims this room to be the "Department of Administrative Affairs - Ministry of Departments". To the left is a waiting area with a water cooler and a bunch of hard, plastic orange chairs. To the right is a counter, behind which is a Bureaucroc. A sign reads "Please approach the counter for assistance."

>[7] approach
(the counter)
The bureaucroc says, "Go away. We don't have time to waste on people who have not learned any Bureaucratic Arts."

>test intro
(Testing.)

>[1] up
You can't go that way.

>[2] in
You can't go that way.

>[3] out

Gregarious Grange
The entrance to the subway is down a flight of stairs. You can also go inside Bureaucratic Hall.

>[4] down
As you make your way back down to the Subway Station, a Bureaucroc corners you on the stairs. He whispers, "Psssst. Here'sss the deal. Getting your Card Carrying Qualification is the first step in the Bureaucratic Artsss. Yesss, and once you have it, you are on your way to being able to obtain Your Papersss (and all sorts of licenses and permits). It used to be you could acquire the bureaucratic documentsss directly from a friend--Oh, it'sss perfectly legal, mind you--but seemsss like you're the only one around. You'll have to go the official route and deal with the red tape. Head over to the Bureaucratic Hall on Gregariousss Grange and talk to one of my friendsss there. You'll get what you need." And then he disappears as quickly as he appeared.

That was weird.

Subway Station
This is the subway station below Gregarious Grange, Groddle Meadow. A flight of stairs leads up to the street.

You can see a ticket dispenser here.

>[5] up

Gregarious Grange
The entrance to the subway is down a flight of stairs. You can also go inside Bureaucratic Hall.

>[6] in

Bureaucratic Hall
A sign proclaims this room to be the "Department of Administrative Affairs - Ministry of Departments". To the left is a waiting area with a water cooler and a bunch of hard, plastic orange chairs. To the right is a counter, behind which is a Bureaucroc. A sign reads "Please approach the counter for assistance."

>[7] approach
(the counter)
A bureaucroc says, "We will be with you as soon as possible. Now please sit down and wait." He then proceeds to ignore you.

>test wait
(Testing.)

>[1] sit
(on the chair)
You take a seat on one of their uncomfortable plastic chairs.

>[2] z
Time passes.

>[3] z
Time passes.

>[4] z
Time passes.

>[5] z
Time passes.

A bureaucroc calls out, "Alexandra! Come forward!"

>[6] approach
(the counter)
The bureaucroc says, "So you're requesting Card-Carrying Qualification are you, Alexandra? Probost Nuter is the official you need to speak to. Please bear with me a moment." Then he turns and shuffles away.

>[7] z
Another bureaucroc, presumably Probost Nuter, approaches the counter. "I understand you're here to procure yourself Card-Carrying Qualification, is that right?" He stares intently at you.

Y/N? >[8] y
The bureaucroc says, "I imagine we can help. First, however, one question:"
1 - Innie?
2 - Outie?

1/2?>[9] 1
The bureaucroc nods and says, "Acceptable. The fee is 50 currants. Cash up front, please."

You count out a pile of currants, and the bureaucroc hands over Card-Carrying Qualification.

"Thank you for your business. To conduct another transaction, you must exit and re-enter the Hall."

>obtain qualification
You already have the qualification. Now you need to activate it.

>activate qualification
Congratulations! You have taken the first step toward Bureaucratic officialdom. As with all first steps, there is a second, a third... Once you learn Bureaucratic Arts, then get and complete your Papers, you'll be able to use public transportation.

>obtain qualification
You have already qualified yourself to carry cards.

>activate qualification
You have already qualified yourself to carry cards.

* * *

I don't know how to pronounce that. Your name will be Alexandra.

Gregarious Grange Subway Station
This is the subway station below Gregarious Grange, Groddle Meadow. A flight of stairs leads up to the street.

You can see a ticket dispenser here.

>activate qualification
You can't see any such thing.

>obtain qualification
You must supply a noun.

* * *

I don't know how to pronounce that. Your name will be Alexandra.

Gregarious Grange Subway Station
This is the subway station below Gregarious Grange, Groddle Meadow. A flight of stairs leads up to the street.

You can see a ticket dispenser here.

>learn arts
You cannot learn the Bureaucratic Arts until you have obtained and activated the Card-Carrying Qualification. You can obtain the Card-Carrying Qualification at Bureaucratic Hall.

>obtain qualification
You will need to go to Bureaucratic Hall to do that.

>test intro
(Testing.)

>[1] up

Gregarious Grange
The entrance to the subway is down a flight of stairs. You can also go inside Bureaucratic Hall.

>[2] in

Bureaucratic Hall
A sign proclaims this room to be the "Department of Administrative Affairs - Ministry of Departments". To the left is a waiting area with a water cooler and a bunch of hard, plastic orange chairs. To the right is a counter, behind which is a Bureaucroc. A sign reads "Please approach the counter for assistance."

>[3] out

Gregarious Grange
The entrance to the subway is down a flight of stairs. You can also go inside Bureaucratic Hall.

>[4] down

Subway Station
This is the subway station below Gregarious Grange, Groddle Meadow. A flight of stairs leads up to the street.

You can see a ticket dispenser here.

>[5] up

Gregarious Grange
The entrance to the subway is down a flight of stairs. You can also go inside Bureaucratic Hall.

>[6] in

Bureaucratic Hall
A sign proclaims this room to be the "Department of Administrative Affairs - Ministry of Departments". To the left is a waiting area with a water cooler and a bunch of hard, plastic orange chairs. To the right is a counter, behind which is a Bureaucroc. A sign reads "Please approach the counter for assistance."

>[7] approach
(the counter)
The bureaucroc says, "Go away. We don't have time to waste on people who have not learned any Bureaucratic Arts."

>test wait
(Testing.)

>[1] sit
(on the chair)
You would rather not sit in one of those chairs unless you absolutely have to.

>[2] z
Time passes.

>[3] z
Time passes.

>[4] z
Time passes.

>[5] z
Time passes.

>[6] approach
(the counter)
The bureaucroc says, "Go away. We don't have time to waste on people who have not learned any Bureaucratic Arts."

>[7] z
Time passes.

>[8] y
That was a rhetorical question.

>[9] 1
That's not a verb I recognize.

>test intro
(Testing.)

>[1] up
You can't go that way.

>[2] in
You can't go that way.

>[3] out

Gregarious Grange
The entrance to the subway is down a flight of stairs. You can also go inside Bureaucratic Hall.

>[4] down
As you make your way back down to the Subway Station, a Bureaucroc corners you on the stairs. He whispers, "Psssst. Here'sss the deal. Getting your Card Carrying Qualification is the first step in the Bureaucratic Artsss. Yesss, and once you have it, you are on your way to being able to obtain Your Papersss (and all sorts of licenses and permits). It used to be you could acquire the bureaucratic documentsss directly from a friend--Oh, it'sss perfectly legal, mind you--but seemsss like you're the only one around. You'll have to go the official route and deal with the red tape. Head over to the Bureaucratic Hall on Gregariousss Grange and talk to one of my friendsss there. You'll get what you need." And then he disappears as quickly as he appeared.

That was weird.

Subway Station
This is the subway station below Gregarious Grange, Groddle Meadow. A flight of stairs leads up to the street.

You can see a ticket dispenser here.

>[5] up

Gregarious Grange
The entrance to the subway is down a flight of stairs. You can also go inside Bureaucratic Hall.

>[6] in

Bureaucratic Hall
A sign proclaims this room to be the "Department of Administrative Affairs - Ministry of Departments". To the left is a waiting area with a water cooler and a bunch of hard, plastic orange chairs. To the right is a counter, behind which is a Bureaucroc. A sign reads "Please approach the counter for assistance."

>[7] approach
(the counter)
A bureaucroc says, "We will be with you as soon as possible. Now please sit down and wait." He then proceeds to ignore you.

>test wait
(Testing.)

>[1] sit
(on the chair)
You take a seat on one of their uncomfortable plastic chairs.

>[2] z
Time passes.

>[3] z
Time passes.

>[4] z
Time passes.

>[5] z
Time passes.

A bureaucroc calls out, "Alexandra! Ready for you now!"

>[6] approach
(the counter)
The bureaucroc says, "Alexandra, as I understand, you are requesting Card-Carrying Qualification. You will have to speak to Secretary Sharpburger about that. Please wait a moment." Then he turns and shuffles away.

>[7] z
Another bureaucroc, presumably Secretary Sharpburger, approaches the counter. "What's this, then? You're hoping to acquire Card-Carrying Qualification, correct?" He stares intently at you.

Y/N? >[8] y
The bureaucroc says, "I don't see why not. But first, which cloud is better?"
1 - Cirrus
2 - Cumulonimbus

1/2?>[9] 1
The bureaucroc nods and says, "That will do. Your fee is 50 currants. Cash only."

You count out a pile of currants, and the bureaucroc hands over Card-Carrying Qualification.

"Thank you for your business. To conduct another transaction, you must exit and re-enter the Hall."

>obtain qualification
You will need to go to Bureaucratic Hall to do that.

* * *

I don't know how to pronounce that. Your name will be Alexandra.

Gregarious Grange Subway Station
This is the subway station below Gregarious Grange, Groddle Meadow. A flight of stairs leads up to the street.

You can see a ticket dispenser here.

>obtain qualification
You will need to go to Bureaucratic Hall to do that.

* * *

>test wait
(Testing.)

>[1] sit
(on the chair)
You take a seat on one of their uncomfortable plastic chairs.

>[2] z
Time passes.

>[3] z
Time passes.

>[4] z
Time passes.

>[5] z
Time passes.

A bureaucroc calls out, "Alexandra! You're up!"

>[6] approach
(the counter)
The bureaucroc says, "I understand you're hoping to attain Card-Carrying Qualification, Alexandra. That's a matter for Manager Earwick. Let me find out if they're in the office this week." Then he turns and shuffles away.

>[7] z
Another bureaucroc, presumably Manager Earwick, approaches the counter. "Right then, let's see... You're here hoping to procure Card-Carrying Qualification, are you?" He stares intently at you.

Y/N? >[8] y
The bureaucroc says, "That should be possible. First, however, one question:"
1 - Innie?
2 - Outie?

1/2?>[9] 1
The bureaucroc nods and says, "Very well. The fee is 50 currants. We only accept cash."

You count out a pile of currants, and the bureaucroc hands over Card-Carrying Qualification.

"Thank you for your business. To conduct another transaction, you must exit and re-enter the Hall."

>obtain qualification
You already have the qualification. Now you need to activate it.

* * *

>activate qualification
Congratulations! You have taken the first step toward Bureaucratic officialdom. As with all first steps, there is a second, a third... Once you learn Bureaucratic Arts, then get and complete your Papers, you'll be able to use public transportation.

>obtain qualificaiton
You have already qualified yourself to carry cards.

>activate qualification
You have already qualified yourself to carry cards.

Congratulations! You have taken the first step toward Bureaucratic officialdom. As with all first steps, there is a second, a third... Once you learn Bureaucratic Arts, then get and complete your Papers, you'll be able to use public transportation.

* * *

I don't know how to pronounce that. Your name will be Alexandra.

Gregarious Grange Subway Station
This is the subway station below Gregarious Grange, Groddle Meadow. A flight of stairs leads up to the street.

You can see a ticket dispenser here.

>ride subway
You must supply a noun.

* * *

I don't know how to pronounce that. Your name will be Alexandra.

Gregarious Grange Subway Station
This is the subway station below Gregarious Grange, Groddle Meadow. A flight of stairs leads up to the street.

You can see a ticket dispenser here.

>talk
You can't see any such thing.

>ask
I didn't understand that sentence.

>up
Gregarious Grange
The entrance to the subway is down a flight of stairs. You can also go inside Bureaucratic Hall.

>test intro
(Testing.)

>[1] up
You can't go that way.

>[2] in

Bureaucratic Hall
A sign proclaims this room to be the "Department of Administrative Affairs - Ministry of Departments". To the left is a waiting area with a water cooler and a bunch of hard, plastic orange chairs. To the right is a counter, behind which is a Bureaucroc. A sign reads "Please approach the counter for assistance."

>[3] out

Gregarious Grange
The entrance to the subway is down a flight of stairs. You can also go inside Bureaucratic Hall.

>[4] down
As you make your way back down to the Subway Station, a Bureaucroc corners you on the stairs. He whispers, "Psssst. Here'sss the deal. Getting your Card Carrying Qualification is the first step in the Bureaucratic Artsss. Yesss, and once you have it, you are on your way to being able to obtain Your Papersss (and all sorts of licenses and permits). It used to be you could acquire the bureaucratic documentsss directly from a friend--Oh, it'sss perfectly legal, mind you--but seemsss like you're the only one around. You'll have to go the official route and deal with the red tape. Head over to the Bureaucratic Hall on Gregariousss Grange and talk to one of my friendsss there. You'll get what you need." And then he disappears as quickly as he appeared.

That was weird.

Subway Station
This is the subway station below Gregarious Grange, Groddle Meadow. A flight of stairs leads up to the street.

You can see a ticket dispenser here.

>[5] up

Gregarious Grange
The entrance to the subway is down a flight of stairs. You can also go inside Bureaucratic Hall.

>[6] in

Bureaucratic Hall
A sign proclaims this room to be the "Department of Administrative Affairs - Ministry of Departments". To the left is a waiting area with a water cooler and a bunch of hard, plastic orange chairs. To the right is a counter, behind which is a Bureaucroc. A sign reads "Please approach the counter for assistance."

>[7] approach
(the counter)
A bureaucroc says, "We will be with you as soon as possible. Now please sit down and wait." He then proceeds to ignore you.

>undo
The use of UNDO is forbidden in this game.

>restart
Are you sure you want to restart?

>y
Bureaucrocy
A boring tale about paperwork by Adri
Release 1 / Serial number 140331 / Inform 7 build 6G60 (I6/v6.32 lib 6/12N) SD

What is your name?

I don't know how to pronounce that. Your name will be Alexandra.

Bureaucrocy
A boring tale about paperwork by Adri
Release 1 / Serial number 140331 / Inform 7 build 6G60 (I6/v6.32 lib 6/12N) SD

Subway Station
This is the subway station below Gregarious Grange, Groddle Meadow. A flight of stairs leads up to the street.

You can see a ticket dispenser here.

>up
Gregarious Grange
The entrance to the subway is down a flight of stairs. You can also go inside Bureaucratic Hall.

>d
As you make your way back down to the Subway Station, a Bureaucroc corners you on the stairs. He whispers, "Psssst. Here'sss the deal. Getting your Card Carrying Qualification is the first step in the Bureaucratic Artsss. Yesss, and once you have it, you are on your way to being able to obtain Your Papersss (and all sorts of licenses and permits). It used to be you could acquire the bureaucratic documentsss directly from a friend--Oh, it'sss perfectly legal, mind you--but seemsss like you're the only one around. You'll have to go the official route and deal with the red tape. Head over to the Bureaucratic Hall on Gregariousss Grange and talk to one of my friendsss there. You'll get what you need." And then he disappears as quickly as he appeared.

That was weird.

Subway Station
This is the subway station below Gregarious Grange, Groddle Meadow. A flight of stairs leads up to the street.

You can see a ticket dispenser here.

>up
Gregarious Grange
The entrance to the subway is down a flight of stairs. You can also go inside Bureaucratic Hall.

* * *

>in
Bureaucratic Hall
A sign proclaims this room to be the "Department of Administrative Affairs - Ministry of Departments". To the left is a waiting area with a water cooler and a bunch of hard, plastic orange chairs. To the right is a counter, behind which is a Bureaucroc. A sign reads "Please approach the counter for assistance."

>ask bureaucroc about life
try "talk to bureaucrat" instead

>talk to bureaucrat
You can't see any such thing.

* * *

I don't know how to pronounce that. Your name will be Alexandra.

Gregarious Grange Subway Station
This is the subway station below Gregarious Grange, Groddle Meadow. A flight of stairs leads up to the street.

You can see a ticket dispenser here.

>u.d.u.i
Gregarious Grange
The entrance to the subway is down a flight of stairs. You can also go inside Bureaucratic Hall.

As you make your way back down to the Subway Station, a Bureaucroc corners you on the stairs. He whispers, "Psssst. Here'sss the deal. Getting your Card Carrying Qualification is the first step in the Bureaucratic Artsss. Yesss, and once you have it, you are on your way to being able to obtain Your Papersss (and all sorts of licenses and permits). It used to be you could acquire the bureaucratic documentsss directly from a friend--Oh, it'sss perfectly legal, mind you--but seemsss like you're the only one around. You'll have to go the official route and deal with the red tape. Head over to the Bureaucratic Hall on Gregariousss Grange and talk to one of my friendsss there. You'll get what you need." And then he disappears as quickly as he appeared.

That was weird.

Subway Station
This is the subway station below Gregarious Grange, Groddle Meadow. A flight of stairs leads up to the street.

You can see a ticket dispenser here.

Gregarious Grange
The entrance to the subway is down a flight of stairs. You can also go inside Bureaucratic Hall.

You are carrying:
  200 currants

>ask croc about life
try "talk to bureaucroc".

>talk to croc
You can't see any such thing.

>in
Bureaucratic Hall
A sign proclaims this room to be the "Department of Administrative Affairs - Ministry of Departments". To the left is a waiting area with a water cooler and a bunch of hard, plastic orange chairs. To the right is a counter, behind which is a Bureaucroc. A sign reads "Please approach the counter for assistance."

>talk to croc
A bureaucroc says, "We will be with you as soon as possible. Now please sit down and wait." He then proceeds to ignore you.

* * *

I don't know how to pronounce that. Your name will be Alexandra.

Gregarious Grange Subway Station
This is the subway station below Gregarious Grange, Groddle Meadow. A flight of stairs leads up to the street.

You can see a ticket dispenser here.

>talk to subway
You can't see any such thing.

>ask subway about life
To talk to someone, just... "talk to" them.

* * *

I don't know how to pronounce that. Your name will be Alexandra.

Gregarious Grange Subway Station
This is the subway station below Gregarious Grange, Groddle Meadow. A flight of stairs leads up to the street.

You can see a ticket dispenser here.

>up.down.up.in
Gregarious Grange
The entrance to the subway is down a flight of stairs. You can also go inside Bureaucratic Hall.

As you make your way back down to the Subway Station, a Bureaucroc corners you on the stairs. He whispers, "Psssst. Here'sss the deal. Getting your Card Carrying Qualification is the first step in the Bureaucratic Artsss. Yesss, and once you have it, you are on your way to being able to obtain Your Papersss (and all sorts of licenses and permits). It used to be you could acquire the bureaucratic documentsss directly from a friend--Oh, it'sss perfectly legal, mind you--but seemsss like you're the only one around. You'll have to go the official route and deal with the red tape. Head over to the Bureaucratic Hall on Gregariousss Grange and talk to one of my friendsss there. You'll get what you need." And then he disappears as quickly as he appeared.

That was weird.

Subway Station
This is the subway station below Gregarious Grange, Groddle Meadow. A flight of stairs leads up to the street.

You can see a ticket dispenser here.

Gregarious Grange
The entrance to the subway is down a flight of stairs. You can also go inside Bureaucratic Hall.

Bureaucratic Hall
A sign proclaims this room to be the "Department of Administrative Affairs - Ministry of Departments". To the left is a waiting area with a water cooler and a bunch of hard, plastic orange chairs. To the right is a counter, behind which is a Bureaucroc. Another sign reads "Please approach the counter for assistance."

>x sign
This sign reads "Please approach the counter for assistance."

>get papers
You can't see any such thing.

* * *

I don't know how to pronounce that. Your name will be Alexandra.

Gregarious Grange Subway Station
This is the subway station below Gregarious Grange, Groddle Meadow. A flight of stairs leads up to the street.

You can see a ticket dispenser here.

>WAIT
Time passes.

>up
Gregarious Grange
The entrance to the subway is down a flight of stairs. You can also go inside Bureaucratic Hall.

* * *

>in
Bureaucratic Hall
A sign proclaims this room to be the "Department of Administrative Affairs - Ministry of Departments". To the left is a waiting area with a water cooler and a bunch of hard, plastic orange chairs. To the right is a counter, behind which is a Bureaucroc. Another sign reads "Please approach the counter for assistance."

>drink water
You will first need to dispense a cup of water from the water cooler.

* * *

I don't know how to pronounce that. Your name will be Alexandra.

Gregarious Grange Subway Station
This is the subway station below Gregarious Grange, Groddle Meadow. A flight of stairs leads up to the street.

You can see a ticket dispenser here.

>write papers
You don't have anything to write with!

>wrote on me
That's not a verb I recognize.

>write on me
You don't have anything to write with!

>up.in.take pen
Gregarious Grange
The entrance to the subway is down a flight of stairs. You can also go inside Bureaucratic Hall.

Bureaucratic Hall
A sign proclaims this room to be the "Department of Administrative Affairs - Ministry of Departments". To the left is a waiting area with a water cooler and a bunch of hard, plastic orange chairs. To the right is a counter, behind which is a Bureaucroc. Another sign reads "Please approach the counter for assistance."

You cast a nervous look around you before yanking the pen hard enough to snap the chain. A bureaucroc looks up at the sound, and you panic. You find yourself outside Bureaucratic Hall.

Gregarious Grange
The entrance to the subway is down a flight of stairs. You can also go inside Bureaucratic Hall.

>write papers
You fiddle with the pen, and it leaks ink all over you.

>write on me
You fiddle with the pen, and it leaks ink all over you.

* * *

I don't know how to pronounce that. Your name will be Alexandra.

Gregarious Grange Subway Station
This is the subway station below Gregarious Grange, Groddle Meadow. A flight of stairs leads up to the street.

You can see a ticket dispenser here.

>get papers
You will need to go to Bureaucratic Hall to do that.

>test intro
(Testing.)

>[1] up

Gregarious Grange
The entrance to the subway is down a flight of stairs. You can also go inside Bureaucratic Hall.

>[2] down
As you make your way back down to the Subway Station, a Bureaucroc corners you on the stairs. He whispers, "Psssst. Here'sss the deal. Getting your Card Carrying Qualification is the first step in the Bureaucratic Artsss. Yesss, and once you have it, you are on your way to being able to obtain Your Papersss (and all sorts of licenses and permits). It used to be you could acquire the bureaucratic documentsss directly from a friend--Oh, it'sss perfectly legal, mind you--but seemsss like you're the only one around. You'll have to go the official route and deal with the red tape. Head over to the Bureaucratic Hall on Gregariousss Grange and talk to one of my friendsss there. You'll get what you need." And then he disappears as quickly as he appeared.

That was weird.

Subway Station
This is the subway station below Gregarious Grange, Groddle Meadow. A flight of stairs leads up to the street.

You can see a ticket dispenser here.

>[3] up

Gregarious Grange
The entrance to the subway is down a flight of stairs. You can also go inside Bureaucratic Hall.

>[4] in

Bureaucratic Hall
A sign proclaims this room to be the "Department of Administrative Affairs - Ministry of Departments". To the left is a waiting area with a water cooler and a bunch of hard, plastic orange chairs. To the right is a counter, behind which is a Bureaucroc. Another sign reads "Please approach the counter for assistance."

>[5] approach
(the counter)
A bureaucroc says, "We will be with you as soon as possible. Now please sit down and wait." He then proceeds to ignore you.

>test wait
(Testing.)

>[1] sit
(on the chair)
You take a seat on one of their uncomfortable plastic chairs.

>[2] z
Time passes.

>[3] z
Time passes.

>[4] z
Time passes.

>[5] z
Time passes.

A bureaucroc calls out, "NEXT, Alexandra!"

>[6] approach
(the counter)
The bureaucroc says, "So you're requesting Card-Carrying Qualification are you, Alexandra? Chamberlain Piksnixson is the official you need to speak to. Please bear with me a moment." Then he turns and shuffles away.

>[7] z
Another bureaucroc, presumably Chamberlain Piksnixson, approaches the counter. "Let's see here. You are interested in obtaining Card-Carrying Qualification, correct?" He stares intently at you.

Y/N? >[8] y
The bureaucroc says, "That should be possible. Before we proceed, I must ask, which shelf-height do you prefer?"
1 - High shelves
2 - Ankle-height shelves

1/2?>[9] 1
The bureaucroc nods and says, "I'll take that. The fee is 50 currants, and I'll take that, as well. In cash."

You count out a pile of currants, and the bureaucroc hands over Card-Carrying Qualification.

"Thank you for your business. To conduct another transaction, you must exit and re-enter the Hall."

>test qual
(Testing.)

>[1] out

Gregarious Grange
The entrance to the subway is down a flight of stairs. You can also go inside Bureaucratic Hall.

>[2] activate
(Card-Carrying Qualification)
Congratulations! You have taken the first step toward Bureaucratic officialdom. As with all first steps, there is a second, a third... Once you learn Bureaucratic Arts, then get and complete your Papers, you'll be able to use public transportation.

>[3] learn
(Bureaucratic Arts)
Well done: you can now obtain papers with only the requisite amount of hassle and annoyance.

>[4] in

Bureaucratic Hall
A sign proclaims this room to be the "Department of Administrative Affairs - Ministry of Departments". To the left is a waiting area with a water cooler and a bunch of hard, plastic orange chairs. To the right is a counter, behind which is a Bureaucroc. Another sign reads "Please approach the counter for assistance."

>[5] approach
(the counter)
A bureaucroc says, "We will be with you as soon as possible. Now please sit down and wait." He then proceeds to ignore you.

>test wait
(Testing.)

>[1] sit
(on the chair)
You take a seat on one of their uncomfortable plastic chairs.

>[2] z
Time passes.

>[3] z
Time passes.

>[4] z
Time passes.

>[5] z
Time passes.

A bureaucroc calls out, "Alexandra! Step up."

>[6] approach
(the counter)
The bureaucroc says, "I understand you're hoping to attain Papers, Alexandra. That's a matter for Magister Naraiwaddleappali. Let me find out if they're in the office this week." Then he turns and shuffles away.

>[7] z
Another bureaucroc, presumably Magister Naraiwaddleappali, approaches the counter. "Right then, let's see... You're here hoping to procure Papers, are you?" He stares intently at you.

Y/N? >[8] y
The bureaucroc says, "I imagine we can help. But first, which cloud is better?"
1 - Cirrus
2 - Cumulonimbus

1/2?>[9] 1
The bureaucroc nods and says, "Very well. The fee is 100 currants. We only accept cash."

You count out a pile of currants, and the bureaucroc hands over Papers.

"Thank you for your business. To conduct another transaction, you must exit and re-enter the Hall."

>get papers
You will need to go to Bureaucratic Hall to do that.

* * *

I don't know how to pronounce that. Your name will be Alexandra.

Gregarious Grange Subway Station
This is the subway station below Gregarious Grange, Groddle Meadow. A flight of stairs leads up to the street.

You can see a ticket dispenser here.

>u.d.u.in
Gregarious Grange
The entrance to the subway is down a flight of stairs. You can also go inside Bureaucratic Hall.

As you make your way back down to the Subway Station, a Bureaucroc corners you on the stairs. He whispers, "Psssst. Here'sss the deal. Getting your Card Carrying Qualification is the first step in the Bureaucratic Artsss. Yesss, and once you have it, you are on your way to being able to obtain Your Papersss (and all sorts of licenses and permits). It used to be you could acquire the bureaucratic documentsss directly from a friend--Oh, it'sss perfectly legal, mind you--but seemsss like you're the only one around. You'll have to go the official route and deal with the red tape. Head over to the Bureaucratic Hall on Gregariousss Grange and talk to one of my friendsss there. You'll get what you need." And then he disappears as quickly as he appeared.

That was weird.

Subway Station
This is the subway station below Gregarious Grange, Groddle Meadow. A flight of stairs leads up to the street.

You can see a ticket dispenser here.

Gregarious Grange
The entrance to the subway is down a flight of stairs. You can also go inside Bureaucratic Hall.

Bureaucratic Hall
A sign proclaims this room to be the "Department of Administrative Affairs - Ministry of Departments". To the left is a waiting area with a water cooler and a bunch of hard, plastic orange chairs. To the right is a counter, behind which is a Bureaucroc. Another sign reads "Please approach the counter for assistance."

>test wait
(Testing.)

>[1] sit
(on the chair)
You would rather not sit in one of those chairs unless you absolutely have to.

>[2] z
Time passes.

>[3] z
Time passes.

>[4] z
Time passes.

>[5] z
Time passes.

>[6] approach
(the counter)
A bureaucroc says, "We will be with you as soon as possible. Now please sit down and wait." He then proceeds to ignore you.

>[7] z
Time passes.

>[8] y
That was a rhetorical question.

>[9] 1
That's not a verb I recognize.

>test wait
(Testing.)

>[1] sit
(on the chair)
You take a seat on one of their uncomfortable plastic chairs.

>[2] z
Time passes.

>[3] z
Time passes.

>[4] z
Time passes.

>[5] z
Time passes.

A bureaucroc calls out, "Attention, Alexandra! When you're ready?"

>[6] approach
(the counter)
The bureaucroc says, "Alexandra? If you are seeking Card-Carrying Qualification, you must speak to Overseer Nuter. Please wait while I see if they're taking appointments today." Then he turns and shuffles away.

>[7] z
Another bureaucroc, presumably Overseer Nuter, approaches the counter. "I understand you're here to procure yourself Card-Carrying Qualification, is that right?" He stares intently at you.

Y/N? >[8] y
The bureaucroc says, "I may be able to help you with that. But first, which cloud is better?"
1 - Cirrus
2 - Cumulonimbus

1/2?>[9] 1
The bureaucroc nods and says, "I'll take that. The fee is 50 currants, and I'll take that, as well. In cash."

You count out a pile of currants, and the bureaucroc hands over Card-Carrying Qualification.

"Thank you for your business. To conduct another transaction, you must exit and re-enter the Hall."

>activate qual
You can't see any such thing.

>activate qualificiation
You can't see any such thing.

>activate qualification
Congratulations! You have taken the first step toward Bureaucratic officialdom. As with all first steps, there is a second, a third... Once you learn Bureaucratic Arts, then get and complete your Papers, you'll be able to use public transportation.

>in
You can't go that way.

>out.in
Gregarious Grange
The entrance to the subway is down a flight of stairs. You can also go inside Bureaucratic Hall.

Bureaucratic Hall
A sign proclaims this room to be the "Department of Administrative Affairs - Ministry of Departments". To the left is a waiting area with a water cooler and a bunch of hard, plastic orange chairs. To the right is a counter, behind which is a Bureaucroc. Another sign reads "Please approach the counter for assistance."

>sit
(on the chair)
You take a seat on one of their uncomfortable plastic chairs.

* * *

I don't know how to pronounce that. Your name will be Alexandra.

Gregarious Grange Subway Station
This is the subway station below Gregarious Grange, Groddle Meadow. A flight of stairs leads up to the street.

You can see a ticket dispenser here.

>check intro
You can't see any such thing.

>test intro
(Testing.)

>[1] up

Gregarious Grange
The entrance to the subway is down a flight of stairs. You can also go inside Bureaucratic Hall.

>[2] down
As you make your way back down to the Subway Station, a Bureaucroc corners you on the stairs. He whispers, "Psssst. Here'sss the deal. Getting your Card Carrying Qualification is the first step in the Bureaucratic Artsss. Yesss, and once you have it, you are on your way to being able to obtain Your Papersss (and all sorts of licenses and permits). It used to be you could acquire the bureaucratic documentsss directly from a friend--Oh, it'sss perfectly legal, mind you--but seemsss like you're the only one around. You'll have to go the official route and deal with the red tape. Head over to the Bureaucratic Hall on Gregariousss Grange and talk to one of my friendsss there. You'll get what you need." And then he disappears as quickly as he appeared.

That was weird.

Subway Station
This is the subway station below Gregarious Grange, Groddle Meadow. A flight of stairs leads up to the street.

You can see a ticket dispenser here.

>[3] up

Gregarious Grange
The entrance to the subway is down a flight of stairs. You can also go inside Bureaucratic Hall.

>[4] in

Bureaucratic Hall
A sign proclaims this room to be the "Department of Administrative Affairs - Ministry of Departments". To the left is a waiting area with a water cooler and a bunch of hard, plastic orange chairs. To the right is a counter, behind which is a Bureaucroc. Another sign reads "Please approach the counter for assistance."

>[5] approach
(the counter)
A bureaucroc says, "We will be with you as soon as possible. Now please sit down and wait." He then proceeds to ignore you.

>test wait
(Testing.)

>[1] sit
(on the chair)
You take a seat on one of their uncomfortable plastic chairs.

>[2] z
Time passes.

>[3] z
Time passes.

>[4] z
Time passes.

>[5] z
Time passes.

A bureaucroc calls out, "Who's Next? Alexandra? Is Alexandra here?"

>[6] approach
(the counter)
The bureaucroc says, "So you're requesting Card-Carrying Qualification are you, Alexandra? Director Tummyford is the official you need to speak to. Please bear with me a moment." Then he turns and shuffles away.

>[7] z
Another bureaucroc, presumably Director Tummyford, approaches the counter. "Let's see here. You are interested in obtaining Card-Carrying Qualification, correct?" He stares intently at you.

Y/N? >[8] y
The bureaucroc says, "I should be able to rubber stamp this. But first, please choose between the following:"
1 - Pirates
2 - Ninjas

1/2?>[9] 1
The bureaucroc nods and says, "Very well. In that case, the fee is 50 currants, and we only take cash."

You count out a pile of currants, and the bureaucroc hands over Card-Carrying Qualification.

"Thank you for your business. To conduct another transaction, you must exit and re-enter the Hall."

* * *

I don't know how to pronounce that. Your name will be Alexandra.

Gregarious Grange Subway Station
This is the subway station below Gregarious Grange, Groddle Meadow. A flight of stairs leads up to the street.

You can see a ticket dispenser here.

>up.down
Gregarious Grange
The entrance to the subway is down a flight of stairs. You can also go inside Bureaucratic Hall.

As you make your way back down to the Subway Station, a Bureaucroc corners you on the stairs. He whispers, "Psssst. Here'sss the deal. Getting your Card Carrying Qualification is the first step in the Bureaucratic Artsss. Yesss, and once you have it, you are on your way to being able to obtain Your Papersss (and all sorts of licenses and permits). It used to be you could acquire the bureaucratic documentsss directly from a friend--Oh, it'sss perfectly legal, mind you--but seemsss like you're the only one around. You'll have to go the official route and deal with the red tape. Head over to the Bureaucratic Hall on Gregariousss Grange and talk to one of my friendsss there. You'll get what you need." And then he disappears as quickly as he appeared.

That was weird.

Subway Station
This is the subway station below Gregarious Grange, Groddle Meadow. A flight of stairs leads up to the street.

You can see a ticket dispenser here.

>up.in
Gregarious Grange
The entrance to the subway is down a flight of stairs. You can also go inside Bureaucratic Hall.

Bureaucratic Hall
A sign proclaims this room to be the "Department of Administrative Affairs - Ministry of Departments". To the left is a waiting area with a water cooler and a bunch of hard, plastic orange chairs. To the right is a counter, behind which is a Bureaucroc. Another sign reads "Please approach the counter for assistance."

>talk to croc
A bureaucroc says, "We will be with you as soon as possible. Now please sit down and wait." He then proceeds to ignore you.

>sit
(on the chair)
You take a seat on one of their uncomfortable plastic chairs.

>i
You are carrying:
  200 currants

>sit
(on the chair)
You can't do anything while waiting. Just wait.

>sit
(on the chair)
You can't do anything while waiting. Just wait.

* * *

Bureaucrocy
A frustrating tale about paperwork by Adri
Release 4 / Serial number 140601 / Inform 7 build 6G60 (I6/v6.32 lib 6/12N) SD

What is your name?

>up
I don't know how to pronounce that. Your name will be Alexandra.

Bureaucrocy
A boring tale about paperwork by Adri
Release 1 / Serial number 140328 / Inform 7 build 6G60 (I6/v6.32 lib 6/12N) SD

Subway Station
This is the subway station below Gregarious Grange, Groddle Meadow. A flight of stairs leads up to the street.

You can see a ticket dispenser here.

>up
Gregarious Grange
The entrance to the subway is down a flight of stairs. You can also go inside Bureaucratic Hall.

You can see a BHDoor here.

>enter hall
(first opening the BHDoor)

Bureaucratic Hall
A sign proclaims this room to be the "Department of Administrative Affairs - Ministry of Departments". To the left is a waiting area with a water cooler and a bunch of hard, plastic orange chairs. To the right is a counter, behind which is a Bureaucroc. A sign reads "Please approach the counter for assistance."

You can see a BHDoor here.

* * *

Bureaucrocy
A frustrating tale about paperwork by Adri
Release 4 / Serial number 140601 / Inform 7 build 6G60 (I6/v6.32 lib 6/12N) SD

What is your name?

>adri
Bureaucrocy
A frustrating tale about paperwork by Adri
Release 1 / Serial number 140425 / Inform 7 build 6G60 (I6/v6.32 lib 6/12N) SD

Subway Station
This is the subway station below Gregarious Grange, Groddle Meadow. A flight of stairs leads up to the street.

You can see a ticket dispenser here.

>restart
    *** You won the game! ***

Would you like to RESTART, RESTORE a saved game, or QUIT?

Please give one of the answers above.

Would you like to RESTART, RESTORE a saved game, or QUIT?

* * *

>adri
Bureaucrocy
A frustrating tale about paperwork by Adri
Release 1 / Serial number 140425 / Inform 7 build 6G60 (I6/v6.32 lib 6/12N) SD

Subway Station
This is the subway station below Gregarious Grange, Groddle Meadow. A flight of stairs leads up to the street.

You can see a ticket dispenser here.

>x me
You are a Glitch named Alexandra. You were imagined into existence by the eleven Giants of Ur.

>restart
Are you sure you want to restart?

>y
Bureaucrocy
A frustrating tale about paperwork by Adri
Release 1 / Serial number 140425 / Inform 7 build 6G60 (I6/v6.32 lib 6/12N) SD

What is your name?

* * *

Bureaucrocy
A frustrating tale about paperwork by Adri
Release 4 / Serial number 140601 / Inform 7 build 6G60 (I6/v6.32 lib 6/12N) SD

What is your name?

>alexandra
Bureaucrocy
A frustrating tale about paperwork by Adri
Release 3 / Serial number 140504 / Inform 7 build 6G60 (I6/v6.32 lib 6/12N) SD

Subway Station
This is the subway station below Gregarious Grange, Groddle Meadow. A flight of stairs leads up to the street.

You can see a ticket dispenser here.

>up
Gregarious Grange
The entrance to the subway is down a flight of stairs. You can also go inside Bureaucratic Hall.

* * *

>up
Gregarious Grange
The entrance to the subway is down a flight of stairs. You can also go inside Bureaucratic Hall.

* * *

>in
Bureaucratic Hall
A sign proclaims this room to be the "Department of Administrative Affairs - Ministry of Departments". To the left is a waiting area with a water cooler and a bunch of hard, plastic orange chairs. To the right is a counter, behind which is a Bureaucroc. Another sign reads "Please approach the counter for assistance."

>restart
Are you sure you want to restart?

>y
Bureaucrocy
A frustrating tale about paperwork by Adri
Release 3 / Serial number 140504 / Inform 7 build 6G60 (I6/v6.32 lib 6/12N) SD

What is your name?

>test intro
I don't know how to pronounce that. Your name will be Alexandra.

Bureaucrocy
A frustrating tale about paperwork by Adri
Release 3 / Serial number 140504 / Inform 7 build 6G60 (I6/v6.32 lib 6/12N) SD

Subway Station
This is the subway station below Gregarious Grange, Groddle Meadow. A flight of stairs leads up to the street.

You can see a ticket dispenser here.

>test intro
(Testing.)

>[1] up

Gregarious Grange
The entrance to the subway is down a flight of stairs. You can also go inside Bureaucratic Hall.

>[2] down
As you make your way back down to the Subway Station, a Bureaucroc corners you on the stairs. He whispers, "Psssst. Here'sss the deal. Getting your Card Carrying Qualification is the first step in the Bureaucratic Artsss. Yesss, and once you have it, you are on your way to being able to obtain Your Papersss (and all sorts of licenses and permits). It used to be you could acquire the bureaucratic documentsss directly from a friend--Oh, it'sss perfectly legal, mind you--but seemsss like you're the only one around. You'll have to go the official route and deal with the red tape. Head over to the Bureaucratic Hall on Gregariousss Grange and talk to one of my friendsss there. You'll get what you need." And then he disappears as quickly as he appeared.

That was weird.

Subway Station
This is the subway station below Gregarious Grange, Groddle Meadow. A flight of stairs leads up to the street.

You can see a ticket dispenser here.

>[3] up

Gregarious Grange
The entrance to the subway is down a flight of stairs. You can also go inside Bureaucratic Hall.

>[4] in

Bureaucratic Hall
A sign proclaims this room to be the "Department of Administrative Affairs - Ministry of Departments". To the left is a waiting area with a water cooler and a bunch of hard, plastic orange chairs. To the right is a counter, behind which is a Bureaucroc. Another sign reads "Please approach the counter for assistance."

>[5] approach
(the counter)
A bureaucroc says, "We will be with you as soon as possible. Now please sit down and wait." He then proceeds to ignore you.

>test wait
(Testing.)

>[1] sit
(on the chair)
You take a seat on one of their uncomfortable plastic chairs.

>[2] z
Time passes.

>[3] z
Time passes.

>[4] z
Time passes.

>[5] z
Time passes.

A bureaucroc calls out, "Ready for you now, Alexandra!"

>[6] approach
(the counter)
The bureaucroc says, "Alexandra? If you are seeking Card-Carrying Qualification, you must speak to Secretary Smithe. Please wait while I see if they're taking appointments today." Then he turns and shuffles away.

>[7] z
Another bureaucroc, presumably Secretary Smithe, approaches the counter. "I'm led to believe you're interested in receiving Card-Carrying Qualification, is that correct?" He stares intently at you.

Y/N? >[8] y
The bureaucroc says, "I may be able to help with that. One final question, which is optimal?"
1 - Cake
2 - Death

1/2?>[9] 1
The bureaucroc nods and says, "I'll take that. The fee is 50 currants, and I'll take that, as well. In cash."

You count out a pile of currants, and the bureaucroc hands over Card-Carrying Qualification.

"Thank you for your business. To conduct another transaction, you must exit and re-enter the Hall."

>test qual
(Testing.)

>[1] out

Gregarious Grange
The entrance to the subway is down a flight of stairs. You can also go inside Bureaucratic Hall.

>[2] activate
(Card-Carrying Qualification)
Congratulations! You have taken the first step toward Bureaucratic officialdom. As with all first steps, there is a second, a third... Once you learn Bureaucratic Arts, then get and complete your Papers, you'll be able to use public transportation.

>[3] learn
(Bureaucratic Arts)
Well done: you can now obtain papers with only the requisite amount of hassle and annoyance.

>[4] in

Bureaucratic Hall
A sign proclaims this room to be the "Department of Administrative Affairs - Ministry of Departments". To the left is a waiting area with a water cooler and a bunch of hard, plastic orange chairs. To the right is a counter, behind which is a Bureaucroc. Another sign reads "Please approach the counter for assistance."

>[5] approach
(the counter)
A bureaucroc says, "We will be with you as soon as possible. Now please sit down and wait." He then proceeds to ignore you.

>test wait
(Testing.)

>[1] sit
(on the chair)
You take a seat on one of their uncomfortable plastic chairs.

>[2] z
Time passes.

>[3] z
Time passes.

>[4] z
Time passes.

>[5] z
Time passes.

A bureaucroc calls out, "Alexandra! You're up!"

>[6] approach
(the counter)
The bureaucroc says, "Alexandra, your request for Papers will have to be passed along to the correct department. Please wait while I ascertain the availability of Magister Piksnixson." Then he turns and shuffles away.

>[7] z
Another bureaucroc, presumably Magister Piksnixson, approaches the counter. "What do we have here, then? I see. So, it's Papers you're after, is it?" He stares intently at you.

Y/N? >[8] y
The bureaucroc says, "I may be able to help you with that. Before that, though, your favorite color?"
1 - Beige
2 - Not Beige

1/2?>[9] 1
The bureaucroc nods and says, "Very well. In that case, the fee is 100 currants, and we only take cash."

You count out a pile of currants, and the bureaucroc hands over Papers.

"Thank you for your business. To conduct another transaction, you must exit and re-enter the Hall."

>x papers
Here is a full yet incomplete set of all the papers a person might require in order that they may prove, justify or otherwise provide evidence that their papers are in order.

>take pen
You cast a nervous look around you before yanking the pen hard enough to snap the chain. A bureaucroc looks up at the sound, and you panic. You find yourself outside Bureaucratic Hall.

Gregarious Grange
The entrance to the subway is down a flight of stairs. You can also go inside Bureaucratic Hall.

>complete papers
You cross your "i's and dot your "t's. Or maybe it's the other way around. In any case, you manage to complete your Papers without too much trouble.
Well done. Now go ride a subway!

>x papers
Here is a full set of all the papers a person might require in order that they may prove, justify or otherwise provide evidence that their papers are in order.

>d
Subway Station
This is the subway station below Gregarious Grange, Groddle Meadow. A flight of stairs leads up to the street.

You can see a ticket dispenser here.

>buy ticket
The ticket dispenser says, "Train tickets cost 50C. Which line would you like to ride?"

    *** You won the game! ***

Would you like to RESTART, RESTORE a saved game, or QUIT?

Please give one of the answers above.

Would you like to RESTART, RESTORE a saved game, or QUIT?